"","match47","match48","match49","match50","Total"
"cg00001510",2,0,1,0,3
"cg00002590",5,0,0,0,5
"cg00003969",0,0,2,0,2
"cg00004121",0,4,1,0,5
"cg00004192",0,1,0,0,1
"cg00004209",0,2,1,0,3
"cg00004260",0,1,0,0,1
"cg00004771",3,0,0,0,3
"cg00005390",0,1,0,0,1
"cg00005579",1,0,0,0,1
"cg00005986",1,1,0,0,2
"cg00006378",1,0,0,0,1
"cg00007215",0,1,0,0,1
"cg00007810",10,1,0,0,11
"cg00009038",0,1,0,0,1
"cg00009796",0,0,1,0,1
"cg00010242",121,328,6,0,455
"cg00011994",0,0,1,0,1
"cg00013196",1,0,0,0,1
"cg00013540",0,0,1,0,1
"cg00013543",692,197,7,0,896
"cg00014168",0,1,0,0,1
"cg00014561",16,1,0,0,17
"cg00014748",23,8,1,0,32
"cg00015286",207,363,4,0,574
"cg00015572",16,0,0,0,16
"cg00016625",1,1,0,0,2
"cg00016802",0,0,1,0,1
"cg00017221",0,0,1,0,1
"cg00017437",2,0,0,0,2
"cg00019091",3,1,0,0,4
"cg00020893",50,1,0,0,51
"cg00021023",2,0,0,0,2
"cg00021044",20,10,0,0,30
"cg00021837",0,1,0,0,1
"cg00022262",7,2,0,0,9
"cg00022606",2,0,0,0,2
"cg00023750",0,0,1,0,1
"cg00024361",3,0,0,0,3
"cg00025002",1,0,0,0,1
"cg00025185",2,0,0,0,2
"cg00027294",0,0,2,0,2
"cg00027662",0,0,2,0,2
"cg00028232",0,3,0,0,3
"cg00028550",0,0,1,0,1
"cg00029052",215,7,0,0,222
"cg00029163",0,1,0,0,1
"cg00029597",6,0,0,0,6
"cg00029928",1,0,0,0,1
"cg00030125",0,0,1,0,1
"cg00030176",2,1,1,0,4
"cg00031556",0,0,1,0,1
"cg00032458",1,0,0,0,1
"cg00032716",1,1,0,0,2
"cg00033102",11,0,0,0,11
"cg00033127",1,0,0,0,1
"cg00033584",13,3,0,0,16
"cg00034407",3,0,0,0,3
"cg00034468",0,1,1,0,2
"cg00034556",0,1,1,1,3
"cg00034639",1,0,0,0,1
"cg00035357",0,1,0,0,1
"cg00035452",0,0,1,0,1
"cg00035864",1,0,0,0,1
"cg00036614",0,0,1,0,1
"cg00036984",1,0,0,0,1
"cg00037035",0,1,2,0,3
"cg00037791",0,0,1,0,1
"cg00038131",0,0,1,0,1
"cg00038233",1,0,0,0,1
"cg00038623",0,1,0,0,1
"cg00039936",46,4,0,0,50
"cg00041636",2,0,0,0,2
"cg00041641",2,0,0,0,2
"cg00041935",1,0,0,0,1
"cg00042254",1,0,0,0,1
"cg00044501",223,193,17,0,433
"cg00045748",0,0,1,0,1
"cg00045785",0,1,0,0,1
"cg00046977",1,0,0,0,1
"cg00047162",0,0,2,0,2
"cg00047553",2,1,0,0,3
"cg00048838",1,0,0,0,1
"cg00049004",0,0,5,0,5
"cg00049947",0,0,1,0,1
"cg00050555",0,0,1,0,1
"cg00051510",41,0,0,0,41
"cg00051623",2,0,0,0,2
"cg00051629",1,0,0,0,1
"cg00052561",1,0,0,0,1
"cg00052626",1,0,0,0,1
"cg00053113",0,0,2,0,2
"cg00053647",0,0,2,0,2
"cg00053716",0,1,0,0,1
"cg00054209",3,5,0,0,8
"cg00054352",0,0,1,0,1
"cg00055233",0,0,1,0,1
"cg00056208",1,0,0,0,1
"cg00056268",16,10,1,0,27
"cg00056672",1,0,0,0,1
"cg00057434",0,0,1,0,1
"cg00057517",0,0,1,0,1
"cg00058449",0,1,0,0,1
"cg00059277",0,0,1,0,1
"cg00059374",0,0,1,0,1
"cg00059643",1,0,0,0,1
"cg00059782",0,1,0,0,1
"cg00060165",0,0,1,0,1
"cg00060715",1,1,4,0,6
"cg00061436",0,0,1,0,1
"cg00061679",4,0,0,0,4
"cg00061956",3,0,0,0,3
"cg00062592",0,1,0,0,1
"cg00063040",2,0,1,0,3
"cg00063654",0,1,0,0,1
"cg00064336",0,0,1,0,1
"cg00064464",5,5,8,0,18
"cg00064531",0,0,1,0,1
"cg00065998",167,20,1,0,188
"cg00066668",119,202,7,0,328
"cg00067803",1,0,0,0,1
"cg00067858",1,0,0,0,1
"cg00068196",2,0,0,0,2
"cg00068684",30,17,0,0,47
"cg00069662",1,0,0,0,1
"cg00070542",0,0,1,0,1
"cg00070870",3,0,0,0,3
"cg00071045",0,1,2,0,3
"cg00071137",1,0,0,0,1
"cg00071452",0,1,0,0,1
"cg00071575",0,2,0,0,2
"cg00071869",7,0,0,0,7
"cg00072839",0,0,1,0,1
"cg00073384",1,0,0,0,1
"cg00074091",1,1,1,0,3
"cg00074638",1008,98,3,0,1109
"cg00075383",2,1,0,0,3
"cg00075488",0,0,1,0,1
"cg00075844",6,1,0,0,7
"cg00077299",668,32,1,0,701
"cg00079116",1,0,0,0,1
"cg00079602",1,2,2,0,5
"cg00080253",8,2,0,0,10
"cg00080418",0,1,0,0,1
"cg00081141",16,16,2,0,34
"cg00081852",0,0,1,0,1
"cg00084958",0,1,0,0,1
"cg00085249",3,1,2,0,6
"cg00087301",0,1,0,0,1
"cg00087430",0,1,0,0,1
"cg00087746",13,1,0,0,14
"cg00087939",10,0,0,0,10
"cg00088251",0,0,1,0,1
"cg00089430",1,1,1,0,3
"cg00090612",110,228,161,0,499
"cg00091063",40,1,0,0,41
"cg00091178",0,0,1,0,1
"cg00091552",13,0,0,0,13
"cg00092052",0,0,4,0,4
"cg00093354",0,1,0,0,1
"cg00093794",0,1,0,0,1
"cg00094044",0,1,1,0,2
"cg00094269",0,3,0,0,3
"cg00094319",0,2,1,0,3
"cg00095105",10,1,0,0,11
"cg00096282",0,0,1,0,1
"cg00096747",0,0,1,0,1
"cg00097389",1,0,0,0,1
"cg00097415",0,0,0,1,1
"cg00097645",0,1,0,0,1
"cg00097790",0,0,1,0,1
"cg00098188",3,0,0,0,3
"cg00098451",0,1,0,0,1
"cg00099129",0,0,1,0,1
"cg00099788",0,0,1,0,1
"cg00100121",0,1,0,0,1
"cg00101712",1,0,0,0,1
"cg00102266",1,12,11,0,24
"cg00103771",0,1,0,0,1
"cg00104007",0,0,1,0,1
"cg00104098",1,0,0,0,1
"cg00104553",0,0,1,0,1
"cg00105229",1,0,0,0,1
"cg00105368",2,6,6,0,14
"cg00105403",2,0,0,0,2
"cg00106052",1,0,0,0,1
"cg00106254",10,2,1,0,13
"cg00106920",0,0,1,0,1
"cg00108524",0,0,1,0,1
"cg00109148",0,1,0,0,1
"cg00109629",0,1,0,0,1
"cg00109817",1,0,0,0,1
"cg00110695",62,31,3,0,96
"cg00111221",0,0,2,0,2
"cg00111466",3,1,3,0,7
"cg00111532",1,0,0,0,1
"cg00111723",120,49,2,0,171
"cg00112042",4,0,0,0,4
"cg00112558",0,0,1,0,1
"cg00114503",18,9,1,0,28
"cg00114618",434,15,0,0,449
"cg00114942",0,0,1,0,1
"cg00115102",0,2,0,0,2
"cg00115167",14,1,0,0,15
"cg00115714",1,0,1,0,2
"cg00116265",0,1,0,0,1
"cg00116686",2,0,0,0,2
"cg00117908",0,0,1,0,1
"cg00117965",0,0,1,0,1
"cg00118363",1,0,0,0,1
"cg00119034",0,0,2,0,2
"cg00120274",0,2,0,0,2
"cg00120435",1,1,0,0,2
"cg00121005",0,3,0,0,3
"cg00121030",0,1,0,0,1
"cg00121148",0,0,2,0,2
"cg00121366",0,0,1,0,1
"cg00121712",8,8,4,0,20
"cg00123057",0,2,2,0,4
"cg00123986",0,0,2,0,2
"cg00124101",6,0,1,0,7
"cg00125002",9,7,10,0,26
"cg00125148",0,1,0,0,1
"cg00125858",4,5,1,0,10
"cg00128171",0,0,6,0,6
"cg00128430",13,7,1,0,21
"cg00129524",0,0,2,0,2
"cg00129693",405,710,18,0,1133
"cg00133223",0,1,2,0,3
"cg00134041",0,0,0,1,1
"cg00134340",1,0,1,0,2
"cg00134695",1,0,2,0,3
"cg00135078",6,1,0,0,7
"cg00135121",0,0,1,0,1
"cg00135841",1,5,2,0,8
"cg00135897",1,0,0,0,1
"cg00137535",1,0,0,0,1
"cg00137629",1,0,0,0,1
"cg00137745",8,0,0,0,8
"cg00137846",0,0,1,0,1
"cg00140494",0,0,1,0,1
"cg00141190",0,7,3,0,10
"cg00141295",2,0,0,0,2
"cg00141478",1,0,0,0,1
"cg00144039",1,0,0,0,1
"cg00144832",0,3,0,0,3
"cg00145419",1,0,0,0,1
"cg00145866",1,0,0,0,1
"cg00147332",0,1,0,0,1
"cg00147751",0,0,1,0,1
"cg00147752",0,0,1,0,1
"cg00148558",0,0,1,0,1
"cg00148867",0,5,0,0,5
"cg00151744",0,0,2,0,2
"cg00152034",1,0,0,0,1
"cg00152644",0,0,1,0,1
"cg00152757",0,1,0,0,1
"cg00153942",0,1,1,0,2
"cg00154733",1,0,0,0,1
"cg00154920",0,0,1,0,1
"cg00155538",1,1,3,0,5
"cg00155844",0,1,4,0,5
"cg00156057",0,0,4,0,4
"cg00156684",0,0,1,0,1
"cg00157477",0,2,0,0,2
"cg00157693",0,1,1,0,2
"cg00158227",0,0,1,0,1
"cg00158918",84,7,0,0,91
"cg00159267",0,1,0,0,1
"cg00159780",0,0,11,0,11
"cg00159873",0,1,1,0,2
"cg00159971",0,0,1,0,1
"cg00160018",1,1,0,0,2
"cg00160462",1,2,1,0,4
"cg00160777",6,1,1,0,8
"cg00160853",0,1,0,0,1
"cg00161367",2,0,1,0,3
"cg00161515",0,1,0,1,2
"cg00162191",2,1,0,2,5
"cg00162943",3,1,0,0,4
"cg00162952",0,2,1,0,3
"cg00163668",0,0,4,0,4
"cg00164175",1,0,0,0,1
"cg00164217",0,3,11,0,14
"cg00165872",0,1,0,0,1
"cg00166392",2,0,0,0,2
"cg00166770",0,1,0,0,1
"cg00167234",18,4,1,0,23
"cg00167275",0,1,0,0,1
"cg00167783",0,0,1,0,1
"cg00167979",0,1,0,0,1
"cg00168091",0,0,4,0,4
"cg00168502",1,0,0,0,1
"cg00169301",64,4,0,0,68
"cg00169541",2,0,0,0,2
"cg00170799",1,1,1,0,3
"cg00171052",4,2,0,0,6
"cg00171192",0,0,1,1,2
"cg00171214",0,0,1,0,1
"cg00171578",2,3,3,0,8
"cg00171634",1,0,0,0,1
"cg00173170",1,5,0,0,6
"cg00173324",0,5,2,0,7
"cg00173768",0,1,0,0,1
"cg00174201",0,1,0,0,1
"cg00174967",399,23,0,0,422
"cg00175423",6,0,0,0,6
"cg00176896",1,4,0,0,5
"cg00177631",2,3,3,0,8
"cg00177866",1,2,0,0,3
"cg00178224",0,0,0,1,1
"cg00178785",315,140,4,0,459
"cg00179085",0,0,4,0,4
"cg00181676",90,16,0,0,106
"cg00183340",0,1,0,0,1
"cg00183546",126,16,0,0,142
"cg00183770",0,1,0,0,1
"cg00185189",0,1,0,0,1
"cg00185909",1,0,0,0,1
"cg00191696",0,1,0,0,1
"cg00191858",0,1,5,0,6
"cg00192750",1,0,0,0,1
"cg00193281",631,657,35,0,1323
"cg00193551",12,0,0,0,12
"cg00194109",11,3,0,0,14
"cg00194119",1,0,0,0,1
"cg00194341",0,0,3,0,3
"cg00194422",0,1,0,0,1
"cg00198226",1,0,0,0,1
"cg00198436",0,0,2,0,2
"cg00198680",0,0,1,0,1
"cg00198759",1,0,1,0,2
"cg00198933",0,1,0,0,1
"cg00198994",1,0,0,0,1
"cg00199759",0,1,0,0,1
"cg00201863",3,0,0,0,3
"cg00202506",1,0,0,0,1
"cg00204049",1,0,0,0,1
"cg00204355",175,531,8,0,714
"cg00204778",1,0,0,0,1
"cg00205198",0,0,1,0,1
"cg00205313",0,0,1,0,1
"cg00205340",0,1,0,0,1
"cg00205436",3,12,13,0,28
"cg00206271",0,0,1,0,1
"cg00206287",6,4,0,0,10
"cg00206347",0,0,1,0,1
"cg00207100",0,1,3,0,4
"cg00209563",13,1,0,0,14
"cg00209831",3,0,0,0,3
"cg00210839",199,61,2,0,262
"cg00211623",8,0,0,1,9
"cg00211855",0,0,1,0,1
"cg00212264",194,78,12,0,284
"cg00212645",2,1,0,0,3
"cg00213044",0,0,2,0,2
"cg00214039",1,0,0,0,1
"cg00214873",8,2,4,0,14
"cg00215922",25,4,0,0,29
"cg00218215",1,3,4,0,8
"cg00218628",0,0,1,0,1
"cg00218707",0,0,4,0,4
"cg00219774",31,0,0,0,31
"cg00220047",0,0,1,0,1
"cg00221830",179,277,9,0,465
"cg00222835",0,0,1,0,1
"cg00223109",8,1,0,0,9
"cg00223952",0,0,1,0,1
"cg00224234",0,1,0,0,1
"cg00224417",1,2,1,0,4
"cg00224592",0,0,7,0,7
"cg00224771",1,0,0,0,1
"cg00226085",0,1,0,0,1
"cg00226183",0,1,0,0,1
"cg00226360",0,1,0,0,1
"cg00226956",0,0,1,0,1
"cg00226961",215,50,0,0,265
"cg00226964",12,12,19,0,43
"cg00228355",446,17,1,0,464
"cg00229233",1,0,0,0,1
"cg00229755",0,0,2,0,2
"cg00231099",0,0,3,0,3
"cg00231300",0,0,1,0,1
"cg00232086",14,12,0,0,26
"cg00232675",31,2,0,0,33
"cg00232805",0,1,0,0,1
"cg00233329",13,1,0,0,14
"cg00233366",7,5,0,0,12
"cg00234467",0,1,0,0,1
"cg00234855",1,1,0,0,2
"cg00235079",2,0,0,0,2
"cg00237026",5,3,0,0,8
"cg00237687",0,0,1,0,1
"cg00238038",47,5,2,0,54
"cg00238958",1,0,0,0,1
"cg00239505",1,0,0,0,1
"cg00241427",1,0,0,0,1
"cg00241482",368,38,0,0,406
"cg00243321",0,1,8,0,9
"cg00244034",567,15,0,0,582
"cg00244299",2,0,0,0,2
"cg00244842",0,1,0,0,1
"cg00244920",0,0,1,0,1
"cg00245492",0,1,0,0,1
"cg00246693",0,0,2,0,2
"cg00247803",16,3,0,0,19
"cg00248449",0,0,1,0,1
"cg00249225",0,0,1,0,1
"cg00250063",0,0,1,0,1
"cg00250948",59,1,0,0,60
"cg00252057",28,1,0,0,29
"cg00252230",0,1,1,0,2
"cg00252512",1,0,0,0,1
"cg00252529",0,1,0,0,1
"cg00252533",1,0,0,0,1
"cg00252696",1,0,0,0,1
"cg00253415",0,0,1,0,1
"cg00253854",60,158,239,0,457
"cg00254524",0,1,0,0,1
"cg00256370",0,1,1,0,2
"cg00258136",0,0,1,0,1
"cg00259043",19,2,0,0,21
"cg00259871",0,1,0,0,1
"cg00260028",1,0,0,0,1
"cg00260543",1,4,0,0,5
"cg00261099",15,4,1,0,20
"cg00263314",0,0,1,0,1
"cg00263856",0,0,1,0,1
"cg00264298",179,294,51,0,524
"cg00264634",0,0,1,0,1
"cg00265422",2,0,0,0,2
"cg00266579",0,0,1,0,1
"cg00267512",0,0,0,1,1
"cg00268965",0,1,9,0,10
"cg00271579",0,0,1,0,1
"cg00271807",0,0,1,0,1
"cg00271882",0,0,1,0,1
"cg00273544",18,0,0,0,18
"cg00274691",1,0,0,0,1
"cg00275090",0,1,0,0,1
"cg00275425",0,1,0,0,1
"cg00275760",1,0,0,0,1
"cg00275942",4,2,1,0,7
"cg00277098",1,1,2,0,4
"cg00277475",0,0,1,0,1
"cg00278107",0,1,0,0,1
"cg00279557",0,0,1,0,1
"cg00280814",0,1,1,0,2
"cg00282267",73,8,2,0,83
"cg00282370",2,1,0,0,3
"cg00283037",0,0,10,0,10
"cg00283771",0,2,1,0,3
"cg00285353",0,0,2,0,2
"cg00286160",37,4,0,0,41
"cg00287601",0,1,1,0,2
"cg00288127",9,13,5,0,27
"cg00288559",50,3,0,0,53
"cg00288652",279,82,2,0,363
"cg00288815",0,0,1,0,1
"cg00289933",2,0,0,0,2
"cg00290627",0,0,1,0,1
"cg00291765",1,1,0,0,2
"cg00292851",4,0,0,0,4
"cg00293678",94,111,16,0,221
"cg00294152",3,5,1,0,9
"cg00294558",1,1,1,0,3
"cg00294814",340,264,5,0,609
"cg00294830",0,0,2,0,2
"cg00294848",9,3,1,0,13
"cg00294852",0,1,0,0,1
"cg00294916",0,1,1,0,2
"cg00295060",0,0,6,0,6
"cg00296226",21,4,0,0,25
"cg00297004",91,1,0,0,92
"cg00297334",6,0,0,0,6
"cg00298639",1,0,0,0,1
"cg00300016",0,0,1,0,1
"cg00300322",0,1,0,0,1
"cg00301064",1,0,0,0,1
"cg00301256",0,4,0,0,4
"cg00301390",0,1,2,0,3
"cg00302263",0,1,0,0,1
"cg00304959",1,0,0,0,1
"cg00305263",0,0,1,0,1
"cg00305320",0,0,1,0,1
"cg00305639",0,0,1,0,1
"cg00305878",0,1,0,0,1
"cg00307290",2,0,0,0,2
"cg00307357",5,1,0,0,6
"cg00307501",293,147,3,0,443
"cg00307717",0,0,1,0,1
"cg00307916",0,0,2,0,2
"cg00308434",222,33,61,0,316
"cg00308458",39,7,1,0,47
"cg00308697",0,1,2,0,3
"cg00309351",1,0,1,0,2
"cg00310845",1,0,0,0,1
"cg00311963",0,0,0,1,1
"cg00313185",1,0,0,0,1
"cg00314015",1,5,0,0,6
"cg00314178",73,35,7,0,115
"cg00314248",2,0,0,0,2
"cg00314276",71,115,2,0,188
"cg00314627",52,1,0,0,53
"cg00314966",1,0,0,0,1
"cg00315280",0,1,2,0,3
"cg00316015",0,1,0,0,1
"cg00316279",0,0,1,0,1
"cg00316520",5,0,0,0,5
"cg00318111",0,0,1,0,1
"cg00318897",0,0,1,0,1
"cg00320081",1,0,0,0,1
"cg00320345",2,1,0,0,3
"cg00320845",10,0,0,0,10
"cg00322687",82,321,96,0,499
"cg00323962",2,0,0,0,2
"cg00324257",3,7,0,0,10
"cg00325910",0,1,0,0,1
"cg00326208",0,1,0,0,1
"cg00326651",3,0,0,0,3
"cg00329180",0,0,2,0,2
"cg00329656",0,2,0,0,2
"cg00330318",0,0,1,0,1
"cg00330490",1,0,2,0,3
"cg00330546",0,0,1,0,1
"cg00330647",2,4,0,0,6
"cg00330857",6,1,0,0,7
"cg00332021",0,0,1,0,1
"cg00332139",0,0,1,0,1
"cg00333364",2,0,0,0,2
"cg00333698",2,0,0,0,2
"cg00334293",2,0,0,0,2
"cg00334876",4,0,0,0,4
"cg00335297",0,0,1,0,1
"cg00335872",3,1,0,0,4
"cg00336555",36,29,1,0,66
"cg00337070",0,0,3,0,3
"cg00337553",0,1,1,0,2
"cg00338377",6,2,0,0,8
"cg00338758",0,0,2,0,2
"cg00339739",2,0,0,0,2
"cg00339778",0,6,3,0,9
"cg00340584",0,4,0,0,4
"cg00340744",88,5,0,0,93
"cg00341415",0,0,1,0,1
"cg00341966",0,0,0,1,1
"cg00342875",0,0,1,0,1
"cg00343238",0,1,0,0,1
"cg00343349",1,0,0,0,1
"cg00344614",2,0,0,0,2
"cg00344709",0,2,1,1,4
"cg00345059",1,0,0,0,1
"cg00345366",1,1,0,0,2
"cg00345656",1,0,0,0,1
"cg00345916",0,0,2,0,2
"cg00346123",301,279,0,0,580
"cg00346180",0,0,1,0,1
"cg00346320",0,0,1,0,1
"cg00346673",13,1,0,0,14
"cg00347122",10,9,0,0,19
"cg00347267",0,0,1,0,1
"cg00348692",0,1,0,0,1
"cg00349360",0,1,1,0,2
"cg00349495",4,3,6,0,13
"cg00349700",49,24,1,0,74
"cg00350200",0,0,1,0,1
"cg00350362",1,2,0,0,3
"cg00350607",0,0,1,0,1
"cg00350642",5,0,0,0,5
"cg00351054",2,0,0,0,2
"cg00351097",937,183,3,0,1123
"cg00351202",45,5,0,0,50
"cg00351213",7,1,0,0,8
"cg00351237",1,0,0,0,1
"cg00351283",2,1,0,0,3
"cg00352334",1,0,0,0,1
"cg00352366",1,1,1,0,3
"cg00352681",0,0,1,0,1
"cg00352903",0,0,1,0,1
"cg00353337",3,2,0,0,5
"cg00353643",5,0,0,0,5
"cg00353916",0,3,0,0,3
"cg00354124",0,0,2,0,2
"cg00354219",1,0,0,0,1
"cg00354279",0,0,1,0,1
"cg00354736",0,0,1,0,1
"cg00356425",2,1,0,0,3
"cg00356769",0,1,0,0,1
"cg00356888",0,0,1,0,1
"cg00357543",0,0,4,0,4
"cg00358442",1,2,0,0,3
"cg00358570",3,0,0,0,3
"cg00359110",0,1,0,0,1
"cg00359257",2,0,0,0,2
"cg00359421",81,42,12,0,135
"cg00360402",0,0,1,0,1
"cg00360478",0,0,1,0,1
"cg00360757",1,6,6,0,13
"cg00360969",1,0,0,0,1
"cg00361320",1,0,0,0,1
"cg00362401",3,2,0,0,5
"cg00363006",0,1,0,0,1
"cg00363815",484,123,3,0,610
"cg00364644",0,0,1,0,1
"cg00365004",0,1,0,0,1
"cg00365507",0,0,1,0,1
"cg00366531",0,1,1,0,2
"cg00366594",2,1,0,0,3
"cg00367070",1,0,0,0,1
"cg00367497",0,1,0,0,1
"cg00367649",1,3,6,0,10
"cg00368844",5,2,0,0,7
"cg00370079",5,1,1,0,7
"cg00370296",0,0,1,0,1
"cg00370815",10,4,2,0,16
"cg00371570",0,0,1,0,1
"cg00371950",0,3,0,0,3
"cg00374016",0,0,1,0,1
"cg00374836",1,4,0,0,5
"cg00375490",13,3,0,0,16
"cg00375548",1,0,0,0,1
"cg00375999",0,0,3,0,3
"cg00376199",1,0,0,0,1
"cg00378007",22,0,0,0,22
"cg00378142",103,42,4,0,149
"cg00378694",3,2,1,0,6
"cg00379272",325,120,10,0,455
"cg00379337",0,0,1,0,1
"cg00379657",785,58,0,0,843
"cg00380846",0,0,22,0,22
"cg00381054",0,0,1,0,1
"cg00383190",1,3,3,0,7
"cg00384816",0,1,0,0,1
"cg00384856",1,0,0,0,1
"cg00387945",0,1,0,0,1
"cg00388637",7,1,0,0,8
"cg00388732",89,5,1,0,95
"cg00388905",3,14,1,0,18
"cg00389181",1,0,0,0,1
"cg00389300",0,0,1,0,1
"cg00389785",8,5,0,0,13
"cg00390191",0,1,0,0,1
"cg00391025",1,2,0,0,3
"cg00391352",1,1,0,0,2
"cg00391354",0,0,0,1,1
"cg00391884",0,1,6,0,7
"cg00393087",5,0,0,0,5
"cg00394725",0,0,2,0,2
"cg00395140",935,141,0,0,1076
"cg00395705",1,0,0,0,1
"cg00396101",2,0,0,0,2
"cg00396991",0,1,0,0,1
"cg00397059",0,2,4,0,6
"cg00397113",131,16,1,0,148
"cg00397545",29,0,0,0,29
"cg00398265",164,210,14,0,388
"cg00399107",0,0,2,0,2
"cg00399683",2,1,2,0,5
"cg00400085",248,28,1,0,277
"cg00400654",0,1,0,0,1
"cg00400827",0,0,1,0,1
"cg00401234",4,1,0,0,5
"cg00401678",2,3,0,0,5
"cg00401844",12,39,33,0,84
"cg00402069",1,0,0,0,1
"cg00402120",1,0,0,0,1
"cg00402551",223,17,1,0,241
"cg00402737",0,0,1,0,1
"cg00402830",1,0,0,0,1
"cg00402980",5,3,0,0,8
"cg00403202",0,2,1,0,3
"cg00403874",0,0,1,0,1
"cg00404743",0,0,1,0,1
"cg00404755",1,0,0,0,1
"cg00405494",0,0,1,0,1
"cg00405596",0,0,1,0,1
"cg00405769",0,1,0,0,1
"cg00406621",0,0,1,0,1
"cg00407089",2,0,0,0,2
"cg00407452",0,1,25,0,26
"cg00407709",2,3,2,0,7
"cg00408021",1,3,0,0,4
"cg00408623",0,1,0,0,1
"cg00408747",6,2,0,0,8
"cg00409201",0,0,1,0,1
"cg00409711",1,0,0,0,1
"cg00410323",32,118,6,0,156
"cg00411928",1,1,0,0,2
"cg00412067",14,8,1,0,23
"cg00412252",3,0,0,0,3
"cg00413124",1,0,0,0,1
"cg00413370",1446,151,1,0,1598
"cg00413849",0,1,0,0,1
"cg00413870",0,2,6,0,8
"cg00414689",2,0,0,0,2
"cg00414890",1,0,0,0,1
"cg00415042",14,1,0,0,15
"cg00415702",0,1,2,0,3
"cg00415735",0,1,0,0,1
"cg00415822",1,0,0,0,1
"cg00416522",0,1,0,0,1
"cg00417078",0,1,0,0,1
"cg00417638",1,0,0,0,1
"cg00417710",0,0,1,0,1
"cg00417719",2,0,0,0,2
"cg00417819",0,2,2,0,4
"cg00418479",597,127,5,0,729
"cg00419314",1,0,0,0,1
"cg00419509",0,7,1,0,8
"cg00419822",4,0,0,0,4
"cg00420847",0,2,0,0,2
"cg00422995",0,1,4,0,5
"cg00423014",5,1,0,0,6
"cg00423291",1,0,0,0,1
"cg00423482",0,2,0,0,2
"cg00423700",0,0,1,0,1
"cg00423759",2,2,0,0,4
"cg00424315",1,0,0,0,1
"cg00424740",1,0,0,0,1
"cg00424923",2,0,0,0,2
"cg00425828",1,0,0,0,1
"cg00427223",0,1,0,0,1
"cg00427669",8,0,0,0,8
"cg00427885",780,82,0,0,862
"cg00428214",0,2,0,0,2
"cg00428487",0,0,2,0,2
"cg00429618",0,0,1,0,1
"cg00429671",0,0,3,0,3
"cg00430039",3,0,0,0,3
"cg00430389",0,0,1,0,1
"cg00431924",0,2,0,0,2
"cg00433119",0,1,0,0,1
"cg00434743",2,0,0,0,2
"cg00437102",2,0,0,0,2
"cg00437173",1,0,0,0,1
"cg00437192",1,0,0,0,1
"cg00437334",0,1,0,0,1
"cg00437441",2,0,0,0,2
"cg00437719",1,0,0,0,1
"cg00438164",0,0,2,0,2
"cg00440263",0,1,0,0,1
"cg00440702",271,199,2,0,472
"cg00441703",0,0,2,0,2
"cg00441754",3,1,1,0,5
"cg00441808",5,0,0,0,5
"cg00442458",30,4,0,0,34
"cg00442621",0,0,1,0,1
"cg00444151",1,0,0,0,1
"cg00446413",0,1,0,0,1
"cg00447068",1,0,0,0,1
"cg00448143",1,0,0,0,1
"cg00448235",5,2,14,0,21
"cg00448891",0,0,1,0,1
"cg00451807",1,1,2,0,4
"cg00452836",6,1,0,0,7
"cg00453065",0,2,0,0,2
"cg00454010",22,8,1,0,31
"cg00454650",1,0,0,0,1
"cg00454696",0,0,1,0,1
"cg00455018",0,0,1,0,1
"cg00455164",0,1,0,0,1
"cg00455514",69,7,0,0,76
"cg00455545",1,0,0,0,1
"cg00455883",0,1,5,0,6
"cg00455892",1,1,2,0,4
"cg00456513",1,0,0,0,1
"cg00456637",1,1,1,0,3
"cg00457167",0,0,1,0,1
"cg00457495",0,0,1,0,1
"cg00457596",0,1,0,0,1
"cg00458002",0,4,2,0,6
"cg00458156",0,0,1,0,1
"cg00458268",4,0,0,0,4
"cg00459243",0,0,1,0,1
"cg00459447",0,0,1,0,1
"cg00459550",19,2,0,0,21
"cg00459574",3,1,4,0,8
"cg00459667",3,6,1,0,10
"cg00459845",1,0,0,0,1
"cg00460179",1,0,0,0,1
"cg00460690",516,31,0,0,547
"cg00460763",1,0,0,0,1
"cg00461082",10,27,0,0,37
"cg00461506",3,1,0,0,4
"cg00462104",0,2,0,0,2
"cg00463949",1,1,0,0,2
"cg00465278",0,0,1,0,1
"cg00466326",1,0,0,0,1
"cg00467160",20,2,0,0,22
"cg00468410",27,10,0,0,37
"cg00468511",0,1,0,0,1
"cg00469630",850,70,0,0,920
"cg00470565",0,0,4,0,4
"cg00470882",2,0,2,0,4
"cg00470905",3,0,0,0,3
"cg00470972",0,0,1,0,1
"cg00471110",0,4,0,0,4
"cg00471293",3,0,0,0,3
"cg00472454",0,1,0,0,1
"cg00472640",0,0,1,0,1
"cg00473025",2,0,0,0,2
"cg00473179",0,1,0,0,1
"cg00474039",0,0,5,0,5
"cg00475112",0,1,1,0,2
"cg00475182",0,0,3,0,3
"cg00476577",0,0,2,0,2
"cg00476896",0,0,1,0,1
"cg00477538",1,0,1,0,2
"cg00477817",338,9,0,0,347
"cg00479718",1,1,2,0,4
"cg00479885",1,0,0,0,1
"cg00480643",44,7,1,0,52
"cg00480704",0,3,0,0,3
"cg00481415",131,596,4,0,731
"cg00482310",3,0,0,0,3
"cg00483718",2,1,0,0,3
"cg00484597",0,1,0,0,1
"cg00487226",0,0,1,0,1
"cg00487526",0,0,1,0,1
"cg00488283",0,0,1,0,1
"cg00489211",0,0,5,0,5
"cg00489902",0,0,8,0,8
"cg00490097",3,1,1,0,5
"cg00490286",0,1,0,0,1
"cg00490606",0,0,1,0,1
"cg00490885",1,0,1,0,2
"cg00491786",0,4,0,0,4
"cg00492074",5,1,0,0,6
"cg00492092",0,0,1,0,1
"cg00492784",0,0,1,0,1
"cg00494446",0,0,1,0,1
"cg00495457",0,1,0,0,1
"cg00495496",1,0,0,0,1
"cg00495570",55,180,34,0,269
"cg00496389",5,0,0,0,5
"cg00496791",0,0,3,0,3
"cg00496805",0,0,1,0,1
"cg00498419",1,0,0,0,1
"cg00498438",1,0,0,0,1
"cg00499055",32,1,0,0,33
"cg00499509",5,2,2,0,9
"cg00500007",0,2,0,0,2
"cg00500229",0,0,1,0,1
"cg00501886",6,2,0,0,8
"cg00502035",0,1,0,0,1
"cg00502041",1,0,0,0,1
"cg00504088",0,0,2,0,2
"cg00504248",0,0,1,0,1
"cg00504896",0,0,1,0,1
"cg00505801",0,1,1,0,2
"cg00506056",5,4,1,0,10
"cg00506574",0,0,3,0,3
"cg00506587",2,0,0,0,2
"cg00508604",0,1,0,0,1
"cg00508800",31,11,0,0,42
"cg00509108",1,0,0,0,1
"cg00509261",3,0,1,0,4
"cg00509751",0,2,0,0,2
"cg00512399",128,3,0,0,131
"cg00512425",7,0,0,0,7
"cg00512622",1,0,3,0,4
"cg00512709",0,1,0,0,1
"cg00512818",0,0,1,0,1
"cg00512985",4,0,0,0,4
"cg00513220",0,0,1,0,1
"cg00513451",1,0,0,0,1
"cg00513717",5,1,0,0,6
"cg00514202",0,1,0,0,1
"cg00514284",0,0,1,0,1
"cg00514514",0,1,7,0,8
"cg00514746",1,0,0,0,1
"cg00514971",0,1,0,0,1
"cg00517005",0,0,1,0,1
"cg00517330",1,0,0,0,1
"cg00517407",0,0,1,0,1
"cg00517535",0,0,5,0,5
"cg00518152",0,1,4,0,5
"cg00518770",0,5,0,0,5
"cg00518995",0,0,1,0,1
"cg00519484",1,1,0,0,2
"cg00519782",0,0,1,0,1
"cg00520188",6,3,4,0,13
"cg00520626",1,0,1,0,2
"cg00521492",0,0,1,0,1
"cg00522288",1,0,0,0,1
"cg00522328",0,0,1,0,1
"cg00523240",0,2,0,0,2
"cg00523901",9,0,0,0,9
"cg00524577",28,1,0,0,29
"cg00524978",1,0,0,0,1
"cg00525044",1,6,7,0,14
"cg00525833",0,1,0,0,1
"cg00526274",0,0,1,0,1
"cg00526576",0,0,1,0,1
"cg00526740",0,0,1,0,1
"cg00528040",0,1,0,0,1
"cg00531525",0,0,1,0,1
"cg00531806",0,0,0,1,1
"cg00531853",1,0,0,0,1
"cg00531965",0,2,0,0,2
"cg00532123",19,0,0,0,19
"cg00532477",0,1,0,0,1
"cg00532659",21,3,0,0,24
"cg00532667",1,6,0,0,7
"cg00532706",0,3,2,0,5
"cg00533633",0,1,0,0,1
"cg00533990",1,0,0,0,1
"cg00534858",0,0,4,0,4
"cg00535622",2,0,0,0,2
"cg00535994",9,0,0,0,9
"cg00537607",0,1,0,0,1
"cg00538495",0,1,0,0,1
"cg00539325",725,97,2,0,824
"cg00539789",0,0,1,0,1
"cg00541002",0,4,4,0,8
"cg00541156",0,0,1,0,1
"cg00541363",2,0,0,0,2
"cg00541500",0,0,1,0,1
"cg00542384",0,0,2,0,2
"cg00543093",1,0,3,0,4
"cg00543456",1,1,0,0,2
"cg00543520",2,3,4,0,9
"cg00544070",5,0,0,0,5
"cg00545674",5,3,1,0,9
"cg00546078",0,3,1,0,4
"cg00547312",1,0,0,0,1
"cg00547318",3,6,6,0,15
"cg00547444",0,1,0,0,1
"cg00547839",0,0,1,0,1
"cg00548273",0,1,0,0,1
"cg00548821",0,3,4,0,7
"cg00549541",0,0,2,0,2
"cg00550040",0,1,0,0,1
"cg00551244",1,2,0,0,3
"cg00551387",0,1,0,0,1
"cg00551589",0,0,1,0,1
"cg00551654",46,8,2,0,56
"cg00552478",0,2,0,0,2
"cg00552659",0,0,1,0,1
"cg00552897",1,0,0,0,1
"cg00552973",0,0,2,0,2
"cg00553504",0,5,1,0,6
"cg00554192",0,0,1,0,1
"cg00554640",3,0,0,0,3
"cg00555036",0,1,2,0,3
"cg00555695",2,2,0,0,4
"cg00556570",0,0,1,0,1
"cg00556614",0,0,1,0,1
"cg00557131",1,0,0,0,1
"cg00557596",1,0,0,0,1
"cg00558297",215,16,0,0,231
"cg00559115",1,1,0,0,2
"cg00560826",2,3,0,0,5
"cg00561389",179,579,84,0,842
"cg00561736",0,3,23,0,26
"cg00562898",36,17,0,0,53
"cg00563768",0,0,1,0,1
"cg00564862",34,5,0,0,39
"cg00565984",1,0,0,0,1
"cg00566066",0,0,1,0,1
"cg00566311",1,0,0,0,1
"cg00566515",0,1,0,0,1
"cg00567401",0,0,2,0,2
"cg00568041",0,1,0,0,1
"cg00569467",2,2,0,0,4
"cg00569951",77,89,1,0,167
"cg00570207",0,0,1,0,1
"cg00571088",2,0,0,0,2
"cg00572020",1,0,0,0,1
"cg00572146",12,0,0,0,12
"cg00572487",76,1,0,0,77
"cg00572756",0,0,3,0,3
"cg00573140",2,5,1,0,8
"cg00573410",0,1,0,0,1
"cg00573550",0,0,0,1,1
"cg00573963",1,0,0,0,1
"cg00574114",0,0,1,0,1
"cg00574919",2,2,0,0,4
"cg00575095",1,0,0,0,1
"cg00575135",0,0,1,0,1
"cg00576139",0,0,1,0,1
"cg00577386",4,0,0,0,4
"cg00578775",0,0,1,0,1
"cg00579673",23,0,0,0,23
"cg00579921",1,0,0,0,1
"cg00582963",0,1,0,0,1
"cg00583618",0,1,0,0,1
"cg00584456",0,1,17,0,18
"cg00584549",1,1,0,0,2
"cg00586014",188,3,0,0,191
"cg00586248",1,2,0,0,3
"cg00587180",4,1,0,0,5
"cg00587228",0,1,2,0,3
"cg00587465",1,0,0,0,1
"cg00588143",7,0,1,0,8
"cg00588853",0,1,0,0,1
"cg00589791",32,4,0,0,36
"cg00590830",2,1,0,0,3
"cg00591225",1,0,0,0,1
"cg00591384",0,0,1,0,1
"cg00592460",3,2,0,0,5
"cg00592870",2,5,0,0,7
"cg00592944",2,0,0,0,2
"cg00593414",5,2,0,0,7
"cg00593446",1,0,0,0,1
"cg00594016",2,1,0,0,3
"cg00594488",164,277,30,0,471
"cg00595053",0,1,0,1,2
"cg00595610",0,1,0,0,1
"cg00595856",0,0,1,0,1
"cg00596207",1,1,0,0,2
"cg00596438",18,22,4,0,44
"cg00596784",28,6,0,0,34
"cg00597112",0,1,1,2,4
"cg00597602",0,0,1,0,1
"cg00598125",1,0,0,0,1
"cg00599377",0,1,0,0,1
"cg00599809",0,0,2,0,2
"cg00600362",1,0,0,0,1
"cg00601809",1,0,1,0,2
"cg00601819",0,0,1,0,1
"cg00603487",0,2,0,0,2
"cg00603733",23,9,0,0,32
"cg00604188",0,0,4,0,4
"cg00604382",2,0,0,0,2
"cg00604771",0,2,0,0,2
"cg00605447",0,0,1,0,1
"cg00605545",1,3,2,0,6
"cg00605685",0,3,2,0,5
"cg00605988",1,0,0,0,1
"cg00606348",0,0,1,0,1
"cg00606739",0,1,0,0,1
"cg00609291",0,2,0,0,2
"cg00609336",0,1,0,0,1
"cg00609379",0,1,0,0,1
"cg00609645",1,0,0,0,1
"cg00610583",1,1,0,0,2
"cg00611372",1,1,0,0,2
"cg00611901",1,0,0,0,1
"cg00612641",0,1,0,0,1
"cg00612714",0,0,1,0,1
"cg00613562",0,0,1,0,1
"cg00614314",0,0,6,0,6
"cg00614901",0,0,1,0,1
"cg00615794",1,0,0,0,1
"cg00616640",0,0,1,0,1
"cg00616999",0,1,0,0,1
"cg00617219",1,0,0,0,1
"cg00617670",3,0,0,0,3
"cg00617867",7,0,0,0,7
"cg00618696",15,0,0,0,15
"cg00619146",1,0,0,0,1
"cg00619292",221,112,61,0,394
"cg00619798",0,1,0,0,1
"cg00619915",7,0,0,0,7
"cg00620304",1,0,0,0,1
"cg00620824",0,0,1,0,1
"cg00620857",1,0,0,0,1
"cg00621559",0,0,1,0,1
"cg00621666",0,0,1,0,1
"cg00622133",1,0,0,0,1
"cg00624017",0,0,1,0,1
"cg00624440",0,0,1,0,1
"cg00624711",2,1,0,0,3
"cg00624879",0,0,3,0,3
"cg00625161",0,1,0,0,1
"cg00625450",0,1,8,0,9
"cg00626068",2,4,0,0,6
"cg00628299",15,15,14,0,44
"cg00628661",0,0,1,0,1
"cg00629088",0,0,3,0,3
"cg00629514",0,1,2,0,3
"cg00629604",1,0,0,0,1
"cg00629928",1,5,14,0,20
"cg00630494",1,0,1,0,2
"cg00631203",0,0,1,0,1
"cg00631287",0,2,1,0,3
"cg00634606",0,1,0,0,1
"cg00634984",0,0,1,0,1
"cg00636172",0,0,2,0,2
"cg00636416",0,0,2,0,2
"cg00637047",1,0,0,0,1
"cg00637795",1,0,0,0,1
"cg00638491",0,0,1,0,1
"cg00640074",3,4,0,0,7
"cg00640147",0,1,0,0,1
"cg00640398",0,1,0,0,1
"cg00640609",1,3,0,0,4
"cg00640775",0,2,0,0,2
"cg00641177",0,0,1,0,1
"cg00642330",1,0,0,0,1
"cg00643253",1,0,0,0,1
"cg00644010",0,0,1,0,1
"cg00644387",3,3,0,0,6
"cg00644797",0,0,1,0,1
"cg00644922",3,1,0,0,4
"cg00645010",0,4,0,0,4
"cg00645389",0,1,0,0,1
"cg00645729",1,0,0,0,1
"cg00645731",0,0,1,0,1
"cg00646019",0,1,1,0,2
"cg00646244",16,11,1,0,28
"cg00647004",0,0,1,0,1
"cg00647124",0,1,0,0,1
"cg00648005",1,0,0,0,1
"cg00648125",1,0,0,0,1
"cg00649199",4,2,0,0,6
"cg00649216",0,1,0,0,1
"cg00649701",3,0,0,0,3
"cg00650472",0,0,1,0,1
"cg00651381",0,0,1,0,1
"cg00651446",0,0,1,0,1
"cg00652158",7,1,0,0,8
"cg00652594",3,4,1,0,8
"cg00653565",0,1,0,0,1
"cg00654159",1,0,0,0,1
"cg00654697",0,0,1,0,1
"cg00655656",15,0,0,0,15
"cg00656110",0,0,1,0,1
"cg00656264",0,2,0,0,2
"cg00656826",163,174,13,0,350
"cg00657202",0,0,1,0,1
"cg00658965",0,0,1,0,1
"cg00659262",3,1,0,0,4
"cg00661438",3,2,0,1,6
"cg00662258",0,0,1,0,1
"cg00663230",0,1,0,0,1
"cg00663642",0,1,0,0,1
"cg00664021",0,1,1,0,2
"cg00664666",5,4,1,0,10
"cg00664920",0,0,1,0,1
"cg00665029",0,1,0,0,1
"cg00665343",3,0,2,0,5
"cg00665832",0,0,1,0,1
"cg00666596",1,0,0,0,1
"cg00666623",111,15,0,0,126
"cg00666641",1,0,0,0,1
"cg00666877",2,1,1,0,4
"cg00667898",1,1,0,0,2
"cg00667924",0,1,2,0,3
"cg00668419",1,0,0,0,1
"cg00669212",114,31,4,0,149
"cg00669746",234,280,15,0,529
"cg00670958",1024,17,1,0,1042
"cg00672222",1,0,0,0,1
"cg00672381",0,0,1,0,1
"cg00673008",1,5,4,0,10
"cg00673081",0,0,1,0,1
"cg00673109",0,0,5,0,5
"cg00673622",0,1,0,0,1
"cg00676137",2,0,0,0,2
"cg00677180",42,1,0,0,43
"cg00677195",1,0,0,0,1
"cg00677708",0,1,0,0,1
"cg00677901",0,0,1,0,1
"cg00678322",3,0,1,0,4
"cg00678820",0,0,1,0,1
"cg00680808",3,1,0,0,4
"cg00681001",0,0,1,0,1
"cg00681004",0,2,0,0,2
"cg00681566",0,0,1,0,1
"cg00686169",3,3,17,0,23
"cg00686340",1,0,0,0,1
"cg00686476",0,0,1,0,1
"cg00686667",0,0,1,0,1
"cg00687582",0,1,0,0,1
"cg00687812",1,0,0,0,1
"cg00688323",2,0,0,0,2
"cg00688460",1,0,0,0,1
"cg00688734",2,3,1,0,6
"cg00688850",2,0,0,0,2
"cg00689214",1,0,0,0,1
"cg00689360",1,0,0,0,1
"cg00689425",1,0,0,0,1
"cg00690692",1,0,0,0,1
"cg00690710",0,1,0,0,1
"cg00690903",19,0,0,0,19
"cg00691830",2,0,1,0,3
"cg00692100",0,0,1,0,1
"cg00692484",0,1,0,0,1
"cg00695633",19,36,15,0,70
"cg00696433",3,1,0,0,4
"cg00697413",0,0,1,0,1
"cg00698217",5,17,2,0,24
"cg00698982",0,0,1,0,1
"cg00699002",1,0,0,0,1
"cg00699238",6,9,4,0,19
"cg00699361",0,0,2,0,2
"cg00699831",0,0,1,0,1
"cg00700466",1,0,0,0,1
"cg00702472",0,0,1,0,1
"cg00702489",0,1,0,0,1
"cg00702835",5,0,0,0,5
"cg00702837",3,0,0,0,3
"cg00702877",51,46,7,0,104
"cg00703392",51,1,0,0,52
"cg00703849",1,0,0,0,1
"cg00704176",23,3,0,0,26
"cg00705156",1,1,1,0,3
"cg00705255",0,4,0,0,4
"cg00706683",2,3,1,0,6
"cg00710028",2,0,0,0,2
"cg00710209",229,9,2,0,240
"cg00710269",162,13,0,0,175
"cg00710456",324,20,1,0,345
"cg00711386",4,1,0,0,5
"cg00711542",0,1,0,0,1
"cg00712884",2,0,0,0,2
"cg00713055",1,0,0,0,1
"cg00713204",1,0,0,0,1
"cg00713813",0,1,1,0,2
"cg00715139",1,0,0,0,1
"cg00715913",156,9,0,0,165
"cg00716025",0,1,0,0,1
"cg00716272",7,1,0,0,8
"cg00717009",0,0,1,0,1
"cg00718539",0,0,1,0,1
"cg00718581",0,0,0,1,1
"cg00719569",1,0,0,0,1
"cg00719879",1,1,0,0,2
"cg00720119",156,161,0,0,317
"cg00720855",0,1,0,0,1
"cg00721703",0,1,1,0,2
"cg00721947",1,1,0,0,2
"cg00723307",1,0,0,0,1
"cg00723379",0,1,4,0,5
"cg00725145",0,0,3,0,3
"cg00725426",1,0,0,0,1
"cg00725654",1,3,3,0,7
"cg00725690",1,0,0,0,1
"cg00725722",0,1,0,0,1
"cg00727386",290,245,5,0,540
"cg00727556",109,21,4,0,134
"cg00727940",0,2,0,0,2
"cg00728224",0,0,1,0,1
"cg00728300",0,1,1,0,2
"cg00729184",118,33,0,0,151
"cg00729281",0,1,0,0,1
"cg00730100",0,5,1,0,6
"cg00731201",6,0,0,0,6
"cg00731852",2,0,0,0,2
"cg00731874",8,7,1,0,16
"cg00732098",0,0,1,0,1
"cg00732232",2,7,4,0,13
"cg00733315",1,2,1,0,4
"cg00733705",415,1126,66,0,1607
"cg00733992",1,0,0,0,1
"cg00734103",0,2,0,0,2
"cg00734311",5,5,0,0,10
"cg00734979",71,22,4,0,97
"cg00735023",1,0,0,0,1
"cg00736819",0,1,3,0,4
"cg00737250",0,0,6,0,6
"cg00737302",0,1,0,0,1
"cg00738113",0,0,2,0,2
"cg00738299",800,23,1,0,824
"cg00738849",0,5,1,0,6
"cg00738945",3,0,0,0,3
"cg00740408",0,1,0,0,1
"cg00741351",1,0,0,0,1
"cg00743962",1,3,0,0,4
"cg00744145",0,2,0,0,2
"cg00744187",0,1,0,0,1
"cg00744351",1,0,0,0,1
"cg00744679",0,0,5,0,5
"cg00744920",0,1,1,0,2
"cg00745184",0,2,1,0,3
"cg00745463",1,0,0,0,1
"cg00745606",0,0,1,0,1
"cg00747726",1,0,0,0,1
"cg00747739",0,1,2,0,3
"cg00748958",1,0,0,0,1
"cg00750806",0,0,2,0,2
"cg00751857",3,0,0,0,3
"cg00752047",0,0,1,0,1
"cg00752077",4,1,0,0,5
"cg00753566",12,8,0,0,20
"cg00753692",0,0,1,0,1
"cg00753806",1,0,0,0,1
"cg00755130",0,1,0,0,1
"cg00755505",3,0,0,0,3
"cg00755563",0,0,1,0,1
"cg00755729",1,0,0,0,1
"cg00755819",1,0,0,0,1
"cg00755868",0,1,0,0,1
"cg00756362",156,32,3,0,191
"cg00756448",0,1,5,0,6
"cg00756450",61,9,0,0,70
"cg00756860",0,3,0,0,3
"cg00757382",13,5,0,0,18
"cg00758816",1,3,1,0,5
"cg00759817",0,1,0,0,1
"cg00760290",0,0,1,0,1
"cg00760490",0,1,0,0,1
"cg00760536",0,0,1,0,1
"cg00760812",23,5,0,0,28
"cg00762372",0,0,1,0,1
"cg00762450",0,0,5,0,5
"cg00763136",207,343,0,0,550
"cg00763200",0,6,0,0,6
"cg00763244",54,80,2,0,136
"cg00764167",1,7,8,0,16
"cg00764514",2,0,0,0,2
"cg00765090",0,0,1,0,1
"cg00765483",1,0,0,0,1
"cg00766915",0,5,13,0,18
"cg00767185",0,0,1,0,1
"cg00767264",0,2,2,0,4
"cg00767637",0,0,1,0,1
"cg00767663",0,1,0,0,1
"cg00767679",0,1,0,0,1
"cg00768815",1,0,0,0,1
"cg00769240",1,2,1,0,4
"cg00769810",2,1,2,0,5
"cg00769882",0,0,1,0,1
"cg00770134",0,0,0,2,2
"cg00770837",0,0,1,0,1
"cg00771483",3,14,12,0,29
"cg00772775",4,2,1,0,7
"cg00772962",0,11,3,0,14
"cg00773093",0,0,1,0,1
"cg00773349",1,0,0,0,1
"cg00774458",0,2,1,0,3
"cg00774769",6,5,0,0,11
"cg00775388",0,3,0,0,3
"cg00775777",2,0,0,0,2
"cg00776237",18,4,1,0,23
"cg00776252",7,0,0,0,7
"cg00780567",0,2,2,0,4
"cg00782265",2,0,0,0,2
"cg00783544",0,0,1,0,1
"cg00783857",0,2,0,0,2
"cg00784791",4,1,2,0,7
"cg00786083",1,0,0,0,1
"cg00786256",1,0,0,0,1
"cg00786390",2,0,0,0,2
"cg00786635",0,0,1,0,1
"cg00788067",0,1,0,0,1
"cg00788688",0,0,1,0,1
"cg00789394",0,0,2,0,2
"cg00789540",0,0,1,0,1
"cg00790055",0,0,1,0,1
"cg00790649",0,1,0,0,1
"cg00791422",149,493,21,0,663
"cg00791789",4,1,0,0,5
"cg00793285",1,0,3,0,4
"cg00793325",0,1,0,0,1
"cg00793992",0,0,1,0,1
"cg00794178",0,1,0,0,1
"cg00794209",0,0,15,0,15
"cg00796755",0,0,1,0,1
"cg00798645",2,0,0,0,2
"cg00800759",1,0,0,0,1
"cg00800997",1,0,0,0,1
"cg00801577",1,1,0,0,2
"cg00802168",2,4,0,0,6
"cg00803004",1,0,0,0,1
"cg00803478",0,0,1,0,1
"cg00803910",0,0,4,0,4
"cg00804237",2,0,0,0,2
"cg00804338",1,0,0,0,1
"cg00804745",0,0,1,0,1
"cg00805496",1,0,0,0,1
"cg00805874",0,1,0,0,1
"cg00806126",6,1,1,0,8
"cg00806959",2,0,0,0,2
"cg00807342",1,1,0,0,2
"cg00807495",1,0,0,0,1
"cg00807609",56,2,0,0,58
"cg00808053",0,2,0,0,2
"cg00808199",0,0,1,0,1
"cg00808307",1,0,0,0,1
"cg00810321",0,0,1,0,1
"cg00810877",1,4,3,0,8
"cg00812839",8,7,1,0,16
"cg00813267",2,0,0,0,2
"cg00813765",0,5,0,0,5
"cg00814324",0,0,4,0,4
"cg00814476",0,0,1,0,1
"cg00816224",0,0,1,0,1
"cg00817529",2,0,0,0,2
"cg00817749",0,1,0,0,1
"cg00819949",2,2,0,0,4
"cg00821510",162,4,1,0,167
"cg00822308",0,0,1,0,1
"cg00822353",1,0,0,0,1
"cg00822571",0,2,1,0,3
"cg00823319",1,0,1,0,2
"cg00823602",0,0,6,0,6
"cg00823683",0,1,0,0,1
"cg00824547",2,14,6,0,22
"cg00824714",0,9,0,0,9
"cg00825031",1,0,0,0,1
"cg00825131",39,91,12,0,142
"cg00825705",0,2,0,0,2
"cg00825739",11,7,3,0,21
"cg00826626",0,0,2,0,2
"cg00826726",3,1,0,0,4
"cg00827196",0,0,19,0,19
"cg00827596",3,0,0,0,3
"cg00828059",3,3,5,0,11
"cg00828468",1,3,1,0,5
"cg00829786",21,9,2,0,32
"cg00830139",17,0,0,0,17
"cg00830596",1,0,0,0,1
"cg00830614",1,0,0,0,1
"cg00831331",0,0,1,0,1
"cg00831633",0,0,1,0,1
"cg00831698",0,0,1,0,1
"cg00831770",11,1,0,0,12
"cg00832199",0,0,1,0,1
"cg00832547",1,0,0,0,1
"cg00833344",0,2,0,0,2
"cg00833479",0,1,0,0,1
"cg00833552",0,0,1,0,1
"cg00833822",0,0,1,0,1
"cg00834073",0,0,1,0,1
"cg00834234",404,53,3,0,460
"cg00834590",5,0,0,0,5
"cg00835232",0,0,1,0,1
"cg00835389",98,76,17,0,191
"cg00835526",28,7,0,0,35
"cg00835832",1,0,0,0,1
"cg00836097",11,1,0,0,12
"cg00836705",0,0,2,0,2
"cg00837086",0,1,1,0,2
"cg00837548",2,2,0,0,4
"cg00837753",0,0,1,0,1
"cg00838032",5,6,0,0,11
"cg00838189",22,1,0,0,23
"cg00839893",2,0,0,0,2
"cg00841141",4,1,0,0,5
"cg00841768",0,0,1,0,1
"cg00842794",6,0,0,0,6
"cg00842874",0,1,0,0,1
"cg00843055",1,0,0,0,1
"cg00844277",4,0,0,0,4
"cg00844600",1,0,0,0,1
"cg00845195",2,0,0,0,2
"cg00845521",2,0,0,0,2
"cg00845901",5,1,6,0,12
"cg00846218",8,0,0,0,8
"cg00846300",1,0,0,0,1
"cg00847239",0,1,1,0,2
"cg00847250",1,0,0,0,1
"cg00847301",2,0,2,0,4
"cg00847544",3,15,0,0,18
"cg00847826",0,0,5,0,5
"cg00850683",0,1,0,0,1
"cg00850868",81,8,0,0,89
"cg00852317",26,11,1,0,38
"cg00853237",0,0,1,0,1
"cg00853242",0,1,0,0,1
"cg00853671",7,3,0,0,10
"cg00854043",0,1,3,0,4
"cg00854546",0,0,2,0,2
"cg00854560",0,1,2,0,3
"cg00854841",0,1,0,0,1
"cg00855014",7,4,3,0,14
"cg00855461",0,1,0,0,1
"cg00856502",1,1,1,0,3
"cg00856850",0,0,1,0,1
"cg00857419",0,0,4,0,4
"cg00858196",77,2,0,0,79
"cg00858451",0,0,1,0,1
"cg00858760",3,0,0,0,3
"cg00860380",0,0,3,0,3
"cg00861214",2,0,0,0,2
"cg00862041",1,1,0,0,2
"cg00862117",1,0,1,0,2
"cg00862675",0,1,0,0,1
"cg00863099",0,0,1,0,1
"cg00863652",0,0,1,0,1
"cg00863654",60,220,424,0,704
"cg00863986",0,3,2,0,5
"cg00864400",0,0,3,0,3
"cg00864563",885,39,0,0,924
"cg00865118",0,3,15,0,18
"cg00865653",196,38,1,0,235
"cg00867694",0,1,0,0,1
"cg00869530",0,0,1,0,1
"cg00869730",0,0,1,0,1
"cg00869962",1,0,0,0,1
"cg00870630",5,0,0,0,5
"cg00871508",1,0,0,0,1
"cg00871518",0,0,1,0,1
"cg00871578",0,2,2,0,4
"cg00871929",7,3,0,0,10
"cg00872900",0,0,3,0,3
"cg00873974",0,0,0,1,1
"cg00874929",5,1,0,0,6
"cg00875852",30,3,0,0,33
"cg00875979",1,0,0,0,1
"cg00876142",0,0,5,0,5
"cg00876837",0,0,1,0,1
"cg00878188",0,0,1,0,1
"cg00878389",0,0,1,0,1
"cg00878488",0,2,1,0,3
"cg00878866",0,0,0,1,1
"cg00880618",2,0,0,0,2
"cg00880812",3,1,0,0,4
"cg00880918",2,2,0,0,4
"cg00882175",1,0,5,0,6
"cg00882355",0,0,2,0,2
"cg00882757",0,1,0,0,1
"cg00883210",0,3,0,0,3
"cg00883323",1,3,0,0,4
"cg00883384",1,0,0,0,1
"cg00884068",0,0,1,0,1
"cg00884081",2,7,3,0,12
"cg00884139",0,0,1,0,1
"cg00884170",0,1,0,0,1
"cg00884445",180,98,5,0,283
"cg00885005",0,1,3,0,4
"cg00886432",98,15,0,0,113
"cg00887602",0,1,1,0,2
"cg00887749",1,0,0,0,1
"cg00888098",3,0,0,0,3
"cg00889287",0,0,1,0,1
"cg00889778",159,12,0,0,171
"cg00890874",4,1,0,0,5
"cg00891138",27,1,0,0,28
"cg00891520",0,2,0,0,2
"cg00892060",0,1,0,0,1
"cg00892138",2,1,0,0,3
"cg00893045",0,3,1,0,4
"cg00894142",0,3,0,0,3
"cg00894606",3,0,0,0,3
"cg00895354",0,3,3,0,6
"cg00895680",22,5,0,0,27
"cg00896220",0,0,2,0,2
"cg00896342",0,0,1,0,1
"cg00896693",0,1,0,0,1
"cg00897744",0,1,0,0,1
"cg00897863",1,3,1,0,5
"cg00898157",0,1,3,0,4
"cg00898768",6,0,0,0,6
"cg00901857",1,0,0,0,1
"cg00902674",0,0,1,0,1
"cg00902933",0,1,0,0,1
"cg00903011",1,0,0,0,1
"cg00903245",0,2,7,0,9
"cg00903375",0,1,0,0,1
"cg00903534",3,1,0,0,4
"cg00903950",0,1,0,0,1
"cg00905420",0,0,1,0,1
"cg00906169",4,1,0,0,5
"cg00906239",0,0,1,0,1
"cg00906794",0,0,1,0,1
"cg00906838",3,0,0,0,3
"cg00907473",1,0,0,0,1
"cg00908318",1,0,0,0,1
"cg00908381",3,0,0,0,3
"cg00908797",0,2,2,0,4
"cg00910103",0,1,0,0,1
"cg00910676",0,1,2,0,3
"cg00910715",1,1,1,0,3
"cg00910893",0,1,0,0,1
"cg00911351",0,0,1,0,1
"cg00911538",2,0,0,0,2
"cg00911894",2,0,0,0,2
"cg00913521",0,1,0,0,1
"cg00913945",0,1,0,0,1
"cg00914354",0,1,0,0,1
"cg00914659",0,1,0,0,1
"cg00915473",9,0,0,0,9
"cg00915652",1,0,0,0,1
"cg00916628",53,1,0,0,54
"cg00916680",0,0,1,0,1
"cg00916831",1,0,0,0,1
"cg00917101",0,0,1,0,1
"cg00917362",0,0,2,0,2
"cg00917566",7,0,0,0,7
"cg00917603",2,2,2,0,6
"cg00918005",0,0,1,0,1
"cg00919576",3,0,0,0,3
"cg00920691",2,0,0,0,2
"cg00920789",0,5,0,0,5
"cg00920799",0,0,1,0,1
"cg00920990",0,0,1,0,1
"cg00922819",10,1,0,0,11
"cg00923458",0,0,1,0,1
"cg00923803",0,0,1,0,1
"cg00924144",0,0,1,0,1
"cg00927939",0,0,1,0,1
"cg00928002",0,2,20,0,22
"cg00930306",0,0,1,0,1
"cg00931375",1,0,0,0,1
"cg00931491",3,0,0,0,3
"cg00932413",8,3,1,0,12
"cg00933249",34,9,1,0,44
"cg00936077",0,1,0,0,1
"cg00936904",0,0,1,0,1
"cg00938517",0,1,0,0,1
"cg00939495",2,0,0,0,2
"cg00940473",1,1,0,0,2
"cg00941203",0,0,1,0,1
"cg00941419",0,1,0,0,1
"cg00941588",0,1,0,0,1
"cg00941671",4,2,0,0,6
"cg00941912",223,14,0,0,237
"cg00942023",356,13,0,0,369
"cg00942160",0,1,4,0,5
"cg00942763",3,2,2,0,7
"cg00942997",0,1,0,0,1
"cg00943060",39,4,0,0,43
"cg00943360",0,0,1,0,1
"cg00943756",3,0,4,0,7
"cg00945107",2,0,1,0,3
"cg00946921",0,0,1,0,1
"cg00947801",364,16,2,0,382
"cg00948906",0,0,1,1,2
"cg00949249",1,0,1,0,2
"cg00949554",0,1,0,0,1
"cg00951089",0,1,0,0,1
"cg00951099",0,2,4,0,6
"cg00951518",0,1,0,0,1
"cg00952292",2,0,0,0,2
"cg00952534",0,1,0,0,1
"cg00953233",0,0,8,0,8
"cg00953531",6,1,0,0,7
"cg00954931",183,173,0,0,356
"cg00955035",0,1,0,0,1
"cg00955780",1,0,0,0,1
"cg00956193",0,0,1,0,1
"cg00956244",0,0,1,0,1
"cg00957138",0,1,0,0,1
"cg00957686",1,1,6,0,8
"cg00958273",1,0,0,0,1
"cg00959334",0,0,1,0,1
"cg00960209",0,1,0,0,1
"cg00960475",1,0,0,0,1
"cg00960580",1,6,2,0,9
"cg00960790",0,0,4,0,4
"cg00961139",0,0,1,0,1
"cg00961446",92,307,64,0,463
"cg00961450",0,0,0,1,1
"cg00962466",2,3,2,0,7
"cg00962799",1,1,0,0,2
"cg00963079",0,1,0,0,1
"cg00963850",0,4,6,0,10
"cg00963942",2,1,0,0,3
"cg00964321",0,0,1,0,1
"cg00964484",0,0,1,0,1
"cg00964858",0,1,0,0,1
"cg00965971",0,1,0,0,1
"cg00965991",107,449,15,0,571
"cg00966920",0,0,1,0,1
"cg00966930",1,0,0,0,1
"cg00967331",1,0,0,0,1
"cg00967347",0,0,1,0,1
"cg00967567",2,0,0,0,2
"cg00967811",0,5,4,0,9
"cg00969731",44,7,3,0,54
"cg00969815",0,1,0,0,1
"cg00970279",0,0,1,0,1
"cg00970558",1,0,0,0,1
"cg00970737",0,0,1,0,1
"cg00970926",1,1,0,0,2
"cg00972672",2,0,0,1,3
"cg00973517",1,0,0,0,1
"cg00974107",0,3,3,0,6
"cg00974326",13,2,0,0,15
"cg00974523",2,1,0,0,3
"cg00975163",0,0,2,0,2
"cg00975375",0,0,1,0,1
"cg00975587",1,0,0,0,1
"cg00975746",3,7,0,0,10
"cg00975929",0,0,1,0,1
"cg00976162",1,0,0,0,1
"cg00977301",3,2,0,0,5
"cg00977502",0,0,1,0,1
"cg00977827",0,2,2,0,4
"cg00978491",4,0,0,0,4
"cg00978912",0,0,2,0,2
"cg00978946",0,0,1,0,1
"cg00979288",1,0,2,0,3
"cg00980674",1,0,0,0,1
"cg00980677",0,1,0,0,1
"cg00981552",1,0,0,0,1
"cg00982214",0,0,2,0,2
"cg00982683",2,0,0,0,2
"cg00982775",0,0,1,0,1
"cg00982805",0,0,1,0,1
"cg00982936",186,229,32,0,447
"cg00984715",277,22,0,0,299
"cg00984967",0,3,0,0,3
"cg00986391",1,1,10,0,12
"cg00986490",0,0,1,0,1
"cg00986824",0,0,1,0,1
"cg00987898",0,1,5,0,6
"cg00990030",1,0,0,0,1
"cg00990270",0,1,0,0,1
"cg00991447",0,0,1,0,1
"cg00991496",0,0,3,0,3
"cg00991546",5,1,0,0,6
"cg00991958",1,0,4,0,5
"cg00992264",0,0,1,0,1
"cg00992521",1,0,0,0,1
"cg00992711",0,0,2,0,2
"cg00993952",1,1,2,0,4
"cg00994389",0,3,3,0,6
"cg00994491",0,0,7,0,7
"cg00994644",55,9,0,0,64
"cg00994784",63,2,1,0,66
"cg00994941",2,1,3,0,6
"cg00995085",4,2,0,0,6
"cg00995689",2,0,0,1,3
"cg00997174",1,0,0,0,1
"cg00997234",138,580,38,0,756
"cg00997262",8,0,0,0,8
"cg00997801",0,0,1,0,1
"cg00997875",8,0,0,0,8
"cg00999137",12,0,0,0,12
"cg00999506",0,1,0,0,1
"cg00999638",44,16,1,0,61
"cg00999858",1,0,0,0,1
"cg01000036",339,101,14,0,454
"cg01000611",0,1,0,0,1
"cg01000657",2,3,0,0,5
"cg01001350",0,0,1,0,1
"cg01002288",0,2,2,0,4
"cg01003176",0,2,1,0,3
"cg01003813",0,0,1,0,1
"cg01004833",2,2,0,0,4
"cg01005425",0,1,0,0,1
"cg01005630",1,5,2,0,8
"cg01005877",6,1,0,0,7
"cg01006124",4,0,0,0,4
"cg01007147",0,0,3,0,3
"cg01007262",0,1,0,0,1
"cg01007350",3,2,0,0,5
"cg01008097",0,1,3,0,4
"cg01008310",1,0,0,0,1
"cg01008361",0,1,0,0,1
"cg01008422",2,0,1,0,3
"cg01009486",0,0,1,0,1
"cg01010221",2,1,0,0,3
"cg01011482",0,0,1,0,1
"cg01011943",2,5,2,0,9
"cg01012559",0,1,0,0,1
"cg01012819",0,1,0,0,1
"cg01013595",6,3,0,0,9
"cg01014087",10,1,0,0,11
"cg01014382",0,0,1,0,1
"cg01015359",0,1,0,0,1
"cg01016850",0,1,0,0,1
"cg01017235",0,1,1,0,2
"cg01017464",0,1,0,0,1
"cg01018117",0,0,1,0,1
"cg01018606",273,594,5,0,872
"cg01018782",1,0,0,0,1
"cg01019344",0,1,0,0,1
"cg01019377",0,0,1,0,1
"cg01021251",2,9,1,0,12
"cg01021653",1,0,0,0,1
"cg01023169",0,0,1,0,1
"cg01023362",0,0,1,0,1
"cg01023403",0,1,1,0,2
"cg01023693",0,1,0,0,1
"cg01024175",0,0,1,0,1
"cg01024783",0,7,0,0,7
"cg01026613",362,13,0,0,375
"cg01028844",1,2,0,0,3
"cg01029331",0,1,2,0,3
"cg01029684",1,0,0,0,1
"cg01029934",14,8,1,0,23
"cg01030435",1,1,0,0,2
"cg01030627",1,0,0,0,1
"cg01031542",5,6,0,0,11
"cg01031907",1,0,0,0,1
"cg01032996",0,0,1,0,1
"cg01033822",215,6,0,0,221
"cg01034363",0,0,1,0,1
"cg01035170",1,0,0,0,1
"cg01035190",0,1,0,0,1
"cg01035563",25,1,0,0,26
"cg01035640",0,0,1,0,1
"cg01035826",1,0,0,0,1
"cg01036012",3,1,0,0,4
"cg01036828",0,2,0,0,2
"cg01038172",2,9,6,0,17
"cg01038681",0,1,0,0,1
"cg01038940",1,0,0,0,1
"cg01040315",2,0,0,0,2
"cg01041681",1,6,7,0,14
"cg01041809",12,12,3,0,27
"cg01042278",7,0,6,0,13
"cg01042640",0,0,2,0,2
"cg01042687",0,0,1,0,1
"cg01042877",6,3,0,0,9
"cg01043550",5,1,0,0,6
"cg01043849",1,0,0,0,1
"cg01046377",0,0,1,0,1
"cg01046833",0,0,1,0,1
"cg01047040",123,2,0,0,125
"cg01049316",21,0,0,0,21
"cg01049933",0,1,0,0,1
"cg01049959",23,13,0,0,36
"cg01050005",3,0,0,0,3
"cg01050612",4,1,0,0,5
"cg01050740",100,5,0,0,105
"cg01050935",0,1,1,0,2
"cg01052120",0,0,1,0,1
"cg01052200",2,0,0,0,2
"cg01052294",0,3,0,0,3
"cg01052572",15,1,1,0,17
"cg01052838",2,0,0,0,2
"cg01052864",0,0,1,0,1
"cg01053252",0,1,0,0,1
"cg01053349",0,0,1,0,1
"cg01055129",17,2,6,0,25
"cg01055403",0,3,1,0,4
"cg01058326",11,0,0,0,11
"cg01058711",0,1,1,0,2
"cg01059331",0,7,0,0,7
"cg01060089",0,0,1,0,1
"cg01060153",6,0,0,0,6
"cg01060346",0,3,3,0,6
"cg01060387",0,0,1,0,1
"cg01061047",1,1,0,0,2
"cg01061164",0,0,4,0,4
"cg01061626",0,0,1,0,1
"cg01065156",5,2,0,0,7
"cg01065748",868,664,37,0,1569
"cg01067139",0,1,0,0,1
"cg01068023",0,0,1,0,1
"cg01069210",1,0,0,0,1
"cg01069442",0,1,0,0,1
"cg01070250",0,0,0,1,1
"cg01070781",0,0,1,0,1
"cg01070923",7,0,0,0,7
"cg01071112",0,1,0,0,1
"cg01072456",2,1,0,0,3
"cg01072529",18,9,0,0,27
"cg01074622",0,0,2,0,2
"cg01074780",1,0,0,0,1
"cg01075810",4,0,0,0,4
"cg01076254",0,1,0,0,1
"cg01076347",2,0,0,0,2
"cg01076454",0,0,280,0,280
"cg01077024",0,0,1,0,1
"cg01077052",0,0,2,0,2
"cg01077172",0,0,1,0,1
"cg01077616",4,0,0,0,4
"cg01077623",0,0,1,0,1
"cg01078337",5,1,0,0,6
"cg01079019",0,0,1,0,1
"cg01079199",0,0,1,0,1
"cg01079307",353,2,0,0,355
"cg01079950",5,0,1,0,6
"cg01080483",180,169,22,0,371
"cg01081086",0,0,1,0,1
"cg01081369",12,3,1,0,16
"cg01082910",1025,80,5,0,1110
"cg01083469",20,1,0,0,21
"cg01084918",3,0,0,0,3
"cg01085129",0,1,0,0,1
"cg01085765",1,0,0,0,1
"cg01085974",0,1,0,0,1
"cg01086113",0,0,1,0,1
"cg01086627",0,0,1,0,1
"cg01087991",10,3,0,0,13
"cg01088239",6,20,0,0,26
"cg01088455",0,0,2,0,2
"cg01088726",0,2,1,0,3
"cg01088863",0,0,2,0,2
"cg01088952",0,7,0,0,7
"cg01089751",0,0,1,0,1
"cg01089781",0,4,0,0,4
"cg01090037",0,0,1,0,1
"cg01091407",0,0,0,1,1
"cg01092531",1,0,0,0,1
"cg01093315",5,7,0,0,12
"cg01093800",0,0,1,0,1
"cg01094121",2,0,0,0,2
"cg01094213",239,316,18,0,573
"cg01096418",0,1,0,0,1
"cg01097011",1,0,0,0,1
"cg01097196",9,0,0,0,9
"cg01097677",1,0,0,0,1
"cg01097725",0,3,11,0,14
"cg01098082",0,0,1,0,1
"cg01098234",3,5,2,0,10
"cg01098431",0,1,0,0,1
"cg01098436",1,0,0,0,1
"cg01098711",0,1,0,0,1
"cg01099299",16,2,0,2,20
"cg01099737",0,0,1,0,1
"cg01099902",26,0,0,0,26
"cg01100690",13,0,0,0,13
"cg01102358",0,0,0,1,1
"cg01103513",1,0,0,0,1
"cg01103828",1,0,0,0,1
"cg01105140",0,3,0,0,3
"cg01105557",1,2,0,0,3
"cg01105802",0,0,3,0,3
"cg01105833",0,1,0,0,1
"cg01106349",0,1,3,0,4
"cg01107119",0,0,1,0,1
"cg01107190",5,1,0,0,6
"cg01107365",0,0,1,0,1
"cg01107958",0,0,1,0,1
"cg01108283",1,0,0,0,1
"cg01109254",0,0,1,0,1
"cg01109633",0,1,0,0,1
"cg01110103",6,4,0,0,10
"cg01112871",0,0,2,0,2
"cg01113589",0,1,0,0,1
"cg01113832",83,4,0,0,87
"cg01113934",7,2,0,0,9
"cg01114156",0,0,1,0,1
"cg01114944",0,0,18,4,22
"cg01115099",1,0,0,0,1
"cg01116134",0,2,22,0,24
"cg01120527",0,1,0,0,1
"cg01121060",104,16,1,0,121
"cg01121182",5,0,0,0,5
"cg01121978",0,0,2,0,2
"cg01122057",308,288,0,0,596
"cg01122415",1,0,0,0,1
"cg01123227",49,24,0,0,73
"cg01123298",0,0,4,0,4
"cg01124810",3,0,0,0,3
"cg01125329",0,0,1,0,1
"cg01125436",6,0,0,0,6
"cg01125563",262,28,0,0,290
"cg01126999",0,1,0,0,1
"cg01127970",0,1,0,0,1
"cg01128039",0,1,0,0,1
"cg01128295",1,12,1,0,14
"cg01129155",4,0,0,0,4
"cg01129379",0,1,0,0,1
"cg01130322",12,3,0,0,15
"cg01130658",0,0,1,0,1
"cg01131625",0,0,5,0,5
"cg01131917",0,1,0,0,1
"cg01132160",81,306,234,0,621
"cg01133726",16,0,0,0,16
"cg01134260",2,0,0,0,2
"cg01134284",1,1,0,0,2
"cg01134358",1,0,0,0,1
"cg01135538",0,0,1,0,1
"cg01135961",282,286,0,0,568
"cg01136067",0,1,0,0,1
"cg01136438",506,5,0,0,511
"cg01136471",0,0,1,0,1
"cg01136922",0,0,1,0,1
"cg01137421",337,18,1,0,356
"cg01137672",4,0,0,0,4
"cg01137907",3,14,0,0,17
"cg01137980",6,1,0,0,7
"cg01138114",1,0,0,0,1
"cg01139541",1,2,6,0,9
"cg01142328",1,0,0,0,1
"cg01143263",0,0,1,0,1
"cg01143862",0,1,0,0,1
"cg01144275",2,0,0,0,2
"cg01145066",1,0,0,0,1
"cg01145284",1,0,0,0,1
"cg01145320",0,0,1,0,1
"cg01145708",0,2,2,0,4
"cg01145910",1,1,0,0,2
"cg01145928",7,2,0,0,9
"cg01145948",0,6,4,0,10
"cg01146205",0,1,2,0,3
"cg01146870",1,0,0,0,1
"cg01146990",3,0,0,0,3
"cg01147487",13,1,0,0,14
"cg01147610",0,0,1,0,1
"cg01148014",0,0,2,0,2
"cg01149041",1,1,0,0,2
"cg01149132",1,0,0,0,1
"cg01151393",0,1,0,0,1
"cg01151642",0,0,1,0,1
"cg01152103",0,0,0,1,1
"cg01152168",0,1,0,0,1
"cg01153186",0,0,1,0,1
"cg01154525",43,1,0,0,44
"cg01154658",2,0,0,0,2
"cg01154903",0,0,3,0,3
"cg01154985",0,2,0,0,2
"cg01155497",0,1,0,0,1
"cg01156081",1,0,0,0,1
"cg01157515",10,0,1,0,11
"cg01157559",0,0,1,0,1
"cg01157952",1,0,0,0,1
"cg01158199",0,0,1,0,1
"cg01158257",0,1,0,0,1
"cg01158679",1,0,0,0,1
"cg01158934",0,1,0,0,1
"cg01160125",0,1,0,0,1
"cg01160145",0,4,0,0,4
"cg01160724",0,1,0,0,1
"cg01161629",0,4,20,0,24
"cg01161842",0,2,0,0,2
"cg01161953",37,0,0,0,37
"cg01162425",0,2,0,0,2
"cg01162549",0,1,0,0,1
"cg01162610",1,1,0,0,2
"cg01164178",0,1,0,0,1
"cg01164972",0,0,2,0,2
"cg01165203",504,25,1,0,530
"cg01165403",2,0,0,0,2
"cg01165426",0,3,0,0,3
"cg01165442",0,1,0,0,1
"cg01165560",2,2,2,0,6
"cg01165752",1,0,0,0,1
"cg01166159",4,0,0,0,4
"cg01166299",0,0,1,0,1
"cg01166759",0,0,1,0,1
"cg01167095",0,0,1,0,1
"cg01167408",2,0,0,0,2
"cg01167628",1,1,6,0,8
"cg01168914",1,0,0,0,1
"cg01169379",0,0,1,0,1
"cg01169453",0,1,0,0,1
"cg01169521",3,2,4,0,9
"cg01170069",1,0,0,0,1
"cg01170114",0,0,1,2,3
"cg01170139",0,1,0,0,1
"cg01170298",1,1,0,0,2
"cg01171149",0,0,1,0,1
"cg01171339",5,0,0,0,5
"cg01171368",0,0,1,0,1
"cg01171428",0,3,3,0,6
"cg01172496",0,2,2,0,4
"cg01172785",1,0,0,0,1
"cg01172985",2,0,0,0,2
"cg01173511",2,0,0,0,2
"cg01174269",0,0,3,0,3
"cg01174327",1,0,0,0,1
"cg01174428",1,0,1,0,2
"cg01174674",3,0,0,0,3
"cg01175497",0,0,1,0,1
"cg01175736",0,0,1,0,1
"cg01176782",2,34,86,0,122
"cg01177189",61,18,0,0,79
"cg01177276",2,0,0,0,2
"cg01177846",2,0,0,0,2
"cg01178659",0,0,1,0,1
"cg01179769",11,0,0,0,11
"cg01180035",109,6,0,0,115
"cg01180268",0,0,1,0,1
"cg01181233",5,1,0,0,6
"cg01181863",0,0,2,0,2
"cg01183965",0,0,2,0,2
"cg01185087",0,0,1,0,1
"cg01185138",918,30,1,0,949
"cg01185825",0,1,0,0,1
"cg01186020",0,1,0,0,1
"cg01187490",12,0,0,0,12
"cg01188023",0,1,0,0,1
"cg01188183",1,0,0,0,1
"cg01189984",4,2,0,0,6
"cg01191766",0,2,1,0,3
"cg01191832",0,0,1,0,1
"cg01192605",4,3,1,0,8
"cg01192965",2,1,0,0,3
"cg01193526",0,0,1,0,1
"cg01193822",6,7,1,0,14
"cg01194336",0,0,1,0,1
"cg01195615",0,0,1,0,1
"cg01196268",1,0,0,0,1
"cg01196574",0,0,1,0,1
"cg01196996",2,0,0,0,2
"cg01198208",12,0,0,0,12
"cg01198359",121,8,3,0,132
"cg01199509",0,0,1,0,1
"cg01199647",0,1,0,0,1
"cg01200051",196,6,0,0,202
"cg01200086",2,3,0,0,5
"cg01200482",0,0,1,0,1
"cg01200893",5,0,0,0,5
"cg01201054",1,0,0,0,1
"cg01201744",84,3,0,0,87
"cg01203563",111,6,0,0,117
"cg01204939",4,0,0,0,4
"cg01204985",1,3,0,0,4
"cg01205338",0,1,0,0,1
"cg01206398",2,0,0,0,2
"cg01206697",0,0,1,0,1
"cg01206756",1,0,2,0,3
"cg01206872",553,759,49,0,1361
"cg01207678",1,0,0,0,1
"cg01208068",2,0,0,0,2
"cg01208557",2,4,7,0,13
"cg01209784",1,0,0,0,1
"cg01209808",0,0,1,0,1
"cg01211390",1,0,0,0,1
"cg01212215",1,0,0,0,1
"cg01213331",0,0,1,0,1
"cg01213536",1,0,1,0,2
"cg01213682",1,0,0,0,1
"cg01214224",38,5,0,0,43
"cg01215695",1,0,0,0,1
"cg01216060",0,0,1,0,1
"cg01216679",0,4,0,0,4
"cg01217475",48,68,1,0,117
"cg01217514",15,0,0,0,15
"cg01217720",0,0,8,0,8
"cg01217822",0,0,1,0,1
"cg01218414",1,1,0,0,2
"cg01219451",0,0,1,0,1
"cg01219620",0,3,0,0,3
"cg01220934",0,1,0,0,1
"cg01220944",1,0,0,0,1
"cg01221711",0,0,1,0,1
"cg01221716",0,0,1,0,1
"cg01222594",7,14,0,0,21
"cg01224913",3,0,0,0,3
"cg01224922",0,1,0,0,1
"cg01225035",0,0,2,0,2
"cg01226586",25,4,0,0,29
"cg01227264",0,3,5,0,8
"cg01227344",0,1,0,0,1
"cg01227445",17,1,0,0,18
"cg01227815",18,10,0,0,28
"cg01228134",0,2,1,0,3
"cg01228487",1,0,0,0,1
"cg01228510",0,1,1,0,2
"cg01230067",1,3,2,0,6
"cg01230154",215,405,109,0,729
"cg01230491",0,0,3,0,3
"cg01230784",1,0,0,0,1
"cg01230988",1,0,0,0,1
"cg01231757",29,3,0,0,32
"cg01232206",0,0,1,0,1
"cg01233535",0,1,0,0,1
"cg01233625",1,0,0,0,1
"cg01235479",1,0,0,0,1
"cg01235536",3,2,3,0,8
"cg01237132",1,0,0,0,1
"cg01237333",1,0,1,0,2
"cg01238479",2,1,0,0,3
"cg01239389",0,1,1,0,2
"cg01239944",13,1,0,0,14
"cg01240109",0,1,0,0,1
"cg01240161",0,0,1,0,1
"cg01241427",0,0,1,0,1
"cg01241814",30,12,0,0,42
"cg01242044",2,0,1,0,3
"cg01242426",1,1,1,0,3
"cg01242451",1,1,0,0,2
"cg01242499",51,14,0,0,65
"cg01243249",1,0,0,0,1
"cg01243789",0,0,3,0,3
"cg01244018",0,1,0,0,1
"cg01244128",0,1,0,0,1
"cg01244571",0,0,1,0,1
"cg01245269",0,1,0,0,1
"cg01245604",3,0,0,0,3
"cg01245656",1,0,0,0,1
"cg01245776",0,2,3,0,5
"cg01245790",7,4,1,0,12
"cg01246390",3,4,1,0,8
"cg01247837",0,1,0,0,1
"cg01249316",0,5,0,0,5
"cg01249480",0,1,0,0,1
"cg01249674",0,0,1,0,1
"cg01250954",1,0,0,0,1
"cg01251118",93,38,6,0,137
"cg01251255",2,0,0,0,2
"cg01251287",4,1,0,0,5
"cg01251290",1,0,0,0,1
"cg01251444",0,0,4,0,4
"cg01251854",5,3,1,0,9
"cg01253184",386,159,5,0,550
"cg01255962",32,5,6,0,43
"cg01256999",0,0,1,0,1
"cg01257667",474,371,10,0,855
"cg01259118",0,5,3,0,8
"cg01260085",0,0,1,0,1
"cg01260170",0,0,1,0,1
"cg01260435",0,2,2,2,6
"cg01260688",1,4,0,0,5
"cg01260768",0,3,0,0,3
"cg01260810",1,0,0,0,1
"cg01260895",2,1,0,0,3
"cg01261770",0,0,2,0,2
"cg01263165",0,3,0,0,3
"cg01263712",0,0,1,0,1
"cg01263999",309,120,17,0,446
"cg01264936",0,0,1,0,1
"cg01265507",205,4,0,0,209
"cg01266264",1,3,2,0,6
"cg01267485",0,0,1,0,1
"cg01269044",3,0,0,0,3
"cg01270017",0,1,0,0,1
"cg01270221",0,0,1,0,1
"cg01270228",0,0,4,0,4
"cg01270370",0,0,1,0,1
"cg01271049",0,1,0,0,1
"cg01271835",0,1,0,0,1
"cg01272334",1,0,0,0,1
"cg01272937",0,1,2,0,3
"cg01273344",0,1,0,0,1
"cg01273613",5,2,1,0,8
"cg01276201",1,1,0,0,2
"cg01276327",16,4,0,0,20
"cg01277177",0,1,0,0,1
"cg01277431",0,0,1,0,1
"cg01278720",0,0,2,0,2
"cg01279662",0,1,0,0,1
"cg01282078",0,2,0,0,2
"cg01282508",2,0,0,0,2
"cg01283202",4,2,0,0,6
"cg01283306",1,0,0,0,1
"cg01283712",1,3,0,0,4
"cg01285197",20,13,2,0,35
"cg01285717",1,1,0,0,2
"cg01285756",0,0,7,0,7
"cg01286040",3,1,0,0,4
"cg01286555",1,0,0,0,1
"cg01287043",3,1,0,0,4
"cg01287904",10,0,0,0,10
"cg01288748",0,0,1,0,1
"cg01288993",3,0,0,0,3
"cg01289489",1,0,0,0,1
"cg01290450",0,0,1,0,1
"cg01290869",0,0,1,0,1
"cg01291201",2,0,1,0,3
"cg01291320",7,3,0,0,10
"cg01291513",1,0,0,0,1
"cg01291875",0,0,1,0,1
"cg01292036",1,0,0,0,1
"cg01293724",3,0,0,0,3
"cg01294637",1,1,3,0,5
"cg01296755",0,0,2,0,2
"cg01296971",1,0,0,0,1
"cg01297210",0,0,1,0,1
"cg01297500",1,0,0,0,1
"cg01298284",0,1,0,0,1
"cg01299854",0,0,2,0,2
"cg01299945",111,17,0,0,128
"cg01300257",0,1,0,0,1
"cg01300682",0,0,2,0,2
"cg01301323",0,1,2,0,3
"cg01301560",35,1,0,0,36
"cg01302101",1,1,0,0,2
"cg01302331",3,0,0,0,3
"cg01304180",7,0,0,0,7
"cg01305849",0,0,1,0,1
"cg01306261",4,1,0,0,5
"cg01306410",0,0,2,0,2
"cg01307555",0,0,1,0,1
"cg01308163",3,6,0,0,9
"cg01308549",1,1,0,0,2
"cg01310750",0,1,0,0,1
"cg01310884",5,0,0,0,5
"cg01312243",0,0,1,0,1
"cg01313422",96,41,1,0,138
"cg01313965",948,214,9,0,1171
"cg01314810",0,2,0,0,2
"cg01315112",1,0,0,0,1
"cg01315222",1,0,0,0,1
"cg01315998",0,0,1,0,1
"cg01316535",0,1,0,0,1
"cg01318726",0,0,2,0,2
"cg01319583",6,0,0,0,6
"cg01319876",0,0,1,0,1
"cg01319959",0,0,1,0,1
"cg01320480",0,0,1,0,1
"cg01320648",10,7,2,0,19
"cg01321648",0,1,0,0,1
"cg01322400",0,1,0,0,1
"cg01323517",0,0,3,0,3
"cg01323766",35,1,0,0,36
"cg01324030",0,1,0,0,1
"cg01324264",1119,144,0,0,1263
"cg01324349",137,126,12,0,275
"cg01324437",0,0,1,0,1
"cg01325116",2,0,0,0,2
"cg01325188",0,1,0,0,1
"cg01325192",1,0,0,0,1
"cg01326874",3,0,0,0,3
"cg01327202",1,0,0,0,1
"cg01327333",2,5,4,0,11
"cg01328860",1,6,0,0,7
"cg01328949",0,0,1,0,1
"cg01329179",0,0,1,0,1
"cg01329495",205,157,54,0,416
"cg01329509",1,0,0,0,1
"cg01330679",59,52,4,0,115
"cg01331064",188,124,3,0,315
"cg01331579",0,0,1,0,1
"cg01331780",1,1,0,0,2
"cg01332624",0,0,2,0,2
"cg01332815",3,0,0,0,3
"cg01333028",0,2,2,0,4
"cg01333884",1,0,0,0,1
"cg01334783",1031,228,4,0,1263
"cg01335566",2,0,0,0,2
"cg01336625",1,0,0,0,1
"cg01337772",0,0,1,0,1
"cg01337795",1,0,0,0,1
"cg01338347",8,6,2,0,16
"cg01338834",3,2,0,0,5
"cg01339008",1,0,0,0,1
"cg01339484",0,3,3,0,6
"cg01339697",4,0,0,0,4
"cg01340165",2,1,0,0,3
"cg01340964",1,0,0,0,1
"cg01341674",2,0,0,0,2
"cg01341969",3,3,4,0,10
"cg01342858",0,1,3,0,4
"cg01342968",1,0,0,0,1
"cg01343093",5,2,1,0,8
"cg01343174",0,1,0,0,1
"cg01343749",0,2,0,0,2
"cg01343768",3,4,1,0,8
"cg01344056",0,0,1,0,1
"cg01344787",41,4,0,0,45
"cg01345365",2,2,0,0,4
"cg01345839",0,0,1,0,1
"cg01346873",0,1,0,0,1
"cg01348172",3,1,0,0,4
"cg01348424",1,0,0,0,1
"cg01348442",0,0,2,0,2
"cg01351278",2,3,18,0,23
"cg01351295",0,0,1,0,1
"cg01353410",5,1,0,0,6
"cg01355835",4,4,0,0,8
"cg01356611",0,5,0,0,5
"cg01356981",0,1,1,0,2
"cg01357003",0,2,2,0,4
"cg01357334",6,0,0,0,6
"cg01358029",0,0,1,0,1
"cg01358406",42,11,0,0,53
"cg01359534",0,1,0,0,1
"cg01359759",0,1,0,0,1
"cg01360457",7,9,0,0,16
"cg01360773",1,0,0,0,1
"cg01362776",433,29,2,0,464
"cg01363235",5,0,0,0,5
"cg01363307",1,0,0,0,1
"cg01363569",272,56,5,0,333
"cg01364483",1,0,0,0,1
"cg01365049",1,7,3,0,11
"cg01366849",2,9,3,0,14
"cg01367439",0,0,1,0,1
"cg01367498",78,38,2,0,118
"cg01367719",1,0,0,0,1
"cg01368087",4,3,2,0,9
"cg01368157",0,0,0,1,1
"cg01368488",0,4,1,0,5
"cg01369331",22,0,0,0,22
"cg01369511",1,0,0,0,1
"cg01370111",259,21,1,0,281
"cg01370599",3,0,0,0,3
"cg01372083",2,0,0,0,2
"cg01372278",4,0,0,0,4
"cg01372421",1,0,0,0,1
"cg01372533",0,2,0,0,2
"cg01373319",0,1,1,0,2
"cg01373687",0,2,0,0,2
"cg01374783",1,0,0,0,1
"cg01375801",0,4,2,0,6
"cg01375871",0,1,1,0,2
"cg01376016",0,1,6,0,7
"cg01377023",0,0,1,0,1
"cg01377436",2,0,0,0,2
"cg01377503",0,0,1,0,1
"cg01378151",0,0,4,0,4
"cg01378677",2,0,0,0,2
"cg01378826",8,1,0,0,9
"cg01378848",0,1,2,0,3
"cg01379290",6,0,0,0,6
"cg01379509",1,0,0,0,1
"cg01379680",0,0,1,0,1
"cg01379788",15,23,5,0,43
"cg01380281",0,1,0,0,1
"cg01383581",1,0,0,0,1
"cg01383934",10,3,0,0,13
"cg01384348",2,1,0,0,3
"cg01385253",0,1,2,0,3
"cg01385774",0,0,1,0,1
"cg01385850",12,1,0,0,13
"cg01385862",1,0,0,0,1
"cg01386294",7,2,0,0,9
"cg01386341",1,1,0,0,2
"cg01389383",237,24,0,0,261
"cg01389942",0,0,7,0,7
"cg01390728",1,0,0,0,1
"cg01391297",0,0,1,0,1
"cg01393115",0,1,1,0,2
"cg01393207",0,0,1,0,1
"cg01393901",0,0,1,0,1
"cg01393932",2,0,1,0,3
"cg01395041",0,0,1,0,1
"cg01395132",9,0,0,0,9
"cg01395667",0,1,0,0,1
"cg01396102",0,0,1,0,1
"cg01396186",3,0,0,0,3
"cg01396275",0,0,1,0,1
"cg01396832",1,0,10,0,11
"cg01396998",0,1,3,0,4
"cg01397001",1,0,0,0,1
"cg01397616",0,0,1,0,1
"cg01398838",1,0,0,0,1
"cg01399611",1,1,0,0,2
"cg01400830",1,0,0,0,1
"cg01401337",1,0,0,0,1
"cg01401762",0,0,3,0,3
"cg01402053",1,0,0,0,1
"cg01402625",0,1,0,0,1
"cg01402781",1,0,0,0,1
"cg01402948",618,22,0,0,640
"cg01403309",1,13,8,0,22
"cg01403676",44,4,0,0,48
"cg01403906",1,2,0,0,3
"cg01405367",2,0,0,0,2
"cg01405404",4,1,9,0,14
"cg01406061",38,2,0,0,40
"cg01406075",0,1,1,0,2
"cg01406134",1,0,0,0,1
"cg01406317",1,0,0,0,1
"cg01406647",0,6,3,0,9
"cg01406836",101,191,121,0,413
"cg01406864",9,3,0,0,12
"cg01407345",0,0,1,0,1
"cg01408100",1,0,0,0,1
"cg01408260",0,1,0,0,1
"cg01408682",2,2,0,0,4
"cg01408860",0,0,1,0,1
"cg01408871",0,0,1,0,1
"cg01409255",1,0,0,0,1
"cg01409554",2,1,0,0,3
"cg01409995",0,0,1,0,1
"cg01410479",1,1,0,0,2
"cg01410532",5,1,0,0,6
"cg01412379",1,0,0,0,1
"cg01412630",0,0,2,0,2
"cg01412856",0,1,0,0,1
"cg01413005",0,1,0,0,1
"cg01413240",7,3,0,0,10
"cg01413289",0,0,1,0,1
"cg01413368",0,0,1,0,1
"cg01414232",0,0,1,0,1
"cg01415456",109,47,12,0,168
"cg01415857",0,0,1,0,1
"cg01416563",2,0,1,0,3
"cg01417563",0,1,0,0,1
"cg01418896",0,0,2,0,2
"cg01421726",1,0,0,0,1
"cg01424973",2,0,0,0,2
"cg01425807",0,0,1,0,1
"cg01425897",0,1,0,0,1
"cg01426208",2,0,0,0,2
"cg01428568",35,65,6,0,106
"cg01428817",0,1,0,0,1
"cg01429032",0,0,1,0,1
"cg01429471",2,0,0,0,2
"cg01430103",1,5,0,0,6
"cg01430372",5,0,0,0,5
"cg01431318",23,1,0,0,24
"cg01431950",0,0,1,0,1
"cg01432169",1,6,1,0,8
"cg01432878",0,1,0,0,1
"cg01433225",0,1,0,0,1
"cg01433265",2,0,0,0,2
"cg01433305",1,0,0,0,1
"cg01433435",33,18,0,0,51
"cg01435020",0,1,0,0,1
"cg01435137",1,0,0,0,1
"cg01435188",5,1,0,0,6
"cg01435401",0,1,2,0,3
"cg01435641",0,0,0,1,1
"cg01435678",1,0,0,0,1
"cg01436128",1,0,0,0,1
"cg01436634",159,142,40,0,341
"cg01436914",0,1,0,0,1
"cg01437450",992,23,0,0,1015
"cg01438291",0,1,0,0,1
"cg01439199",3,2,4,0,9
"cg01439601",0,1,0,0,1
"cg01439696",0,1,0,0,1
"cg01440665",0,0,0,1,1
"cg01440781",2,1,1,0,4
"cg01441927",0,0,1,0,1
"cg01442696",3,2,4,0,9
"cg01442851",1,0,0,0,1
"cg01442959",1,0,0,0,1
"cg01443020",0,0,1,0,1
"cg01443166",1,0,0,0,1
"cg01443684",2,0,0,0,2
"cg01443718",106,9,1,0,116
"cg01444579",1,0,0,0,1
"cg01444712",0,1,0,0,1
"cg01446100",1,0,0,0,1
"cg01447429",0,0,1,0,1
"cg01447674",0,0,1,0,1
"cg01449932",0,1,0,0,1
"cg01450965",19,29,9,0,57
"cg01452204",0,0,1,0,1
"cg01453667",0,1,0,0,1
"cg01454487",0,0,1,0,1
"cg01455366",0,1,0,0,1
"cg01456671",1,1,4,0,6
"cg01458356",16,9,0,0,25
"cg01458605",0,1,0,0,1
"cg01458865",0,0,1,0,1
"cg01459345",28,2,0,0,30
"cg01460095",0,0,1,0,1
"cg01460557",0,1,0,0,1
"cg01460814",1,0,0,0,1
"cg01461654",0,1,2,0,3
"cg01463832",1,0,0,0,1
"cg01466020",1,0,0,0,1
"cg01466096",2,0,0,0,2
"cg01468919",1,0,0,0,1
"cg01470462",0,1,0,0,1
"cg01471269",1,0,0,0,1
"cg01471317",2,2,0,0,4
"cg01472503",1,0,0,0,1
"cg01473472",0,1,0,0,1
"cg01473840",2,2,0,0,4
"cg01474140",1,1,0,0,2
"cg01474260",0,0,1,0,1
"cg01474346",0,1,0,0,1
"cg01474741",0,5,0,0,5
"cg01475346",2,1,0,0,3
"cg01475387",1,0,0,0,1
"cg01476456",0,0,1,0,1
"cg01476855",1,0,0,0,1
"cg01477797",0,1,0,0,1
"cg01478131",0,1,1,0,2
"cg01478494",0,2,0,0,2
"cg01480727",1,1,0,0,2
"cg01481151",0,0,1,0,1
"cg01481506",2,1,0,0,3
"cg01481902",1,1,0,0,2
"cg01482313",6,0,0,0,6
"cg01482319",656,92,1,0,749
"cg01482456",302,12,0,0,314
"cg01482826",0,0,1,0,1
"cg01482912",18,8,0,0,26
"cg01483505",0,1,1,0,2
"cg01483871",0,1,0,0,1
"cg01484172",0,3,1,0,4
"cg01484569",0,0,1,0,1
"cg01485610",1,0,0,0,1
"cg01486253",1,1,0,0,2
"cg01486406",0,2,0,0,2
"cg01486523",0,2,2,0,4
"cg01486713",7,0,0,0,7
"cg01486814",1,0,0,0,1
"cg01486987",85,3,0,0,88
"cg01488085",1,0,0,0,1
"cg01488659",106,123,19,0,248
"cg01490040",19,2,0,0,21
"cg01490296",1,0,0,0,1
"cg01490325",783,90,0,0,873
"cg01490535",2,6,3,0,11
"cg01490578",0,0,2,0,2
"cg01490870",1,0,0,0,1
"cg01491450",1,0,0,0,1
"cg01491466",206,1,0,0,207
"cg01492146",6,1,0,0,7
"cg01492604",1,1,0,0,2
"cg01493567",1,0,0,1,2
"cg01494245",0,1,3,0,4
"cg01495354",0,0,1,0,1
"cg01495670",1,4,0,0,5
"cg01496161",1,0,0,0,1
"cg01496199",1,0,0,0,1
"cg01496220",0,0,1,0,1
"cg01496475",0,1,0,0,1
"cg01496970",0,0,1,0,1
"cg01497088",0,0,2,0,2
"cg01497699",0,1,0,0,1
"cg01498468",0,1,0,0,1
"cg01499902",0,0,2,0,2
"cg01500733",0,0,1,0,1
"cg01501491",0,1,1,0,2
"cg01501540",8,0,0,0,8
"cg01501776",21,3,0,0,24
"cg01502484",2,0,0,0,2
"cg01503378",3,2,0,0,5
"cg01503773",2,0,0,0,2
"cg01504784",0,1,0,0,1
"cg01505312",0,1,1,0,2
"cg01505987",1,0,0,0,1
"cg01506298",0,1,0,0,1
"cg01507577",5,3,1,0,9
"cg01508600",24,14,0,0,38
"cg01509427",1,6,6,0,13
"cg01509621",3,0,0,0,3
"cg01509727",1,0,0,0,1
"cg01509839",3,0,0,0,3
"cg01511151",2,3,0,0,5
"cg01511809",5,0,0,0,5
"cg01513643",1,0,0,0,1
"cg01513806",2,2,0,0,4
"cg01514341",0,0,1,0,1
"cg01515015",0,1,0,0,1
"cg01515114",2,2,0,0,4
"cg01515401",0,0,1,0,1
"cg01516809",297,10,0,0,307
"cg01516933",0,1,0,0,1
"cg01517139",2,2,0,0,4
"cg01517490",1,1,0,0,2
"cg01517690",0,3,1,0,4
"cg01517906",0,0,1,0,1
"cg01518002",0,0,1,0,1
"cg01518755",0,0,2,0,2
"cg01518906",1,2,17,0,20
"cg01519223",1,0,0,0,1
"cg01519733",3,0,0,0,3
"cg01521036",3,11,9,0,23
"cg01521143",4,0,0,0,4
"cg01521480",0,1,0,0,1
"cg01521567",0,1,0,0,1
"cg01521865",0,0,1,0,1
"cg01522278",421,79,8,0,508
"cg01522525",2,0,0,0,2
"cg01523029",0,1,8,0,9
"cg01523316",14,4,3,0,21
"cg01525560",2,2,1,0,5
"cg01526355",0,0,1,0,1
"cg01526771",6,1,0,0,7
"cg01528830",493,85,4,0,582
"cg01529454",2,0,0,0,2
"cg01531320",0,10,0,0,10
"cg01531551",6,0,0,0,6
"cg01531806",2,1,0,0,3
"cg01532713",2,0,0,0,2
"cg01533849",0,1,0,0,1
"cg01534273",2,0,1,0,3
"cg01534629",0,1,0,0,1
"cg01534758",0,1,0,0,1
"cg01534765",0,0,1,0,1
"cg01536330",74,36,2,0,112
"cg01536436",1,0,0,0,1
"cg01537270",0,0,1,0,1
"cg01537271",0,0,1,0,1
"cg01537406",105,4,0,0,109
"cg01538971",0,1,0,0,1
"cg01539006",1,0,1,0,2
"cg01539206",1,1,0,0,2
"cg01540869",0,0,1,0,1
"cg01541565",5,1,0,0,6
"cg01541773",185,90,2,0,277
"cg01542190",0,2,1,0,3
"cg01544213",0,1,0,0,1
"cg01544227",0,0,3,0,3
"cg01544812",0,0,1,0,1
"cg01544851",0,0,3,0,3
"cg01545108",1,0,0,0,1
"cg01545952",1,0,1,0,2
"cg01546046",0,1,0,0,1
"cg01546329",0,1,2,0,3
"cg01546595",1,8,3,0,12
"cg01547165",2,0,0,0,2
"cg01547289",20,2,0,0,22
"cg01547359",0,0,1,0,1
"cg01547622",5,0,0,0,5
"cg01549226",0,5,3,0,8
"cg01550607",8,2,0,0,10
"cg01550893",0,0,1,0,1
"cg01552286",0,1,0,0,1
"cg01552707",1,1,0,0,2
"cg01552777",2,2,5,0,9
"cg01553112",0,0,1,0,1
"cg01553616",2,0,0,0,2
"cg01554873",0,0,1,0,1
"cg01555105",16,9,1,0,26
"cg01555263",1,5,24,0,30
"cg01557029",0,0,1,0,1
"cg01557296",0,2,0,0,2
"cg01558721",0,0,1,0,1
"cg01559776",6,4,0,0,10
"cg01560140",0,1,0,0,1
"cg01561108",1,11,26,0,38
"cg01561295",2,2,0,0,4
"cg01561434",1,0,0,0,1
"cg01561737",1,0,0,0,1
"cg01561861",1,0,0,0,1
"cg01562825",4,5,2,0,11
"cg01563601",1,1,0,0,2
"cg01563774",0,0,4,0,4
"cg01565380",6,6,0,0,12
"cg01566262",2,1,0,0,3
"cg01566692",1,0,4,0,5
"cg01566710",0,0,1,0,1
"cg01567279",11,0,0,0,11
"cg01567591",0,0,3,0,3
"cg01569306",3,25,1,0,29
"cg01570445",0,0,1,0,1
"cg01570504",0,0,1,0,1
"cg01570662",0,0,0,1,1
"cg01570685",0,0,1,0,1
"cg01570817",2,1,0,0,3
"cg01571548",0,1,1,0,2
"cg01571722",1,0,0,0,1
"cg01573470",0,1,1,0,2
"cg01573622",1,4,1,0,6
"cg01573921",1,0,0,0,1
"cg01575164",1306,603,7,0,1916
"cg01576350",81,23,1,0,105
"cg01577251",0,0,7,0,7
"cg01577514",0,0,2,0,2
"cg01577700",6,0,0,0,6
"cg01577992",0,0,4,0,4
"cg01579093",22,17,7,0,46
"cg01579172",104,161,4,0,269
"cg01579231",14,17,3,0,34
"cg01579370",0,1,1,0,2
"cg01579629",297,29,1,0,327
"cg01580225",0,0,1,0,1
"cg01580475",1,1,0,0,2
"cg01580696",1,0,0,0,1
"cg01581106",156,4,0,0,160
"cg01583657",1,3,2,0,6
"cg01583878",14,0,0,0,14
"cg01584464",3,0,0,0,3
"cg01585069",0,1,2,2,5
"cg01585094",1,0,0,0,1
"cg01585297",45,143,145,0,333
"cg01585723",0,1,2,0,3
"cg01586011",1,0,0,0,1
"cg01586208",0,1,0,0,1
"cg01586506",1,0,0,0,1
"cg01586779",2,1,0,0,3
"cg01587655",1,0,0,0,1
"cg01588177",0,1,2,0,3
"cg01589157",0,0,0,1,1
"cg01590541",1,0,0,0,1
"cg01590768",0,1,0,0,1
"cg01592257",0,1,0,0,1
"cg01592369",0,0,0,1,1
"cg01592593",147,16,1,0,164
"cg01593421",4,5,0,0,9
"cg01593692",0,1,0,0,1
"cg01593808",0,0,3,0,3
"cg01594675",1,0,0,0,1
"cg01596325",1,0,0,0,1
"cg01597257",0,1,0,0,1
"cg01597784",0,0,1,0,1
"cg01598415",11,0,0,0,11
"cg01598742",2,1,2,0,5
"cg01598983",0,1,0,0,1
"cg01599167",1,0,0,0,1
"cg01599189",0,2,1,0,3
"cg01599699",36,76,3,0,115
"cg01600189",0,0,6,0,6
"cg01600661",49,2,0,0,51
"cg01602339",0,0,4,0,4
"cg01603311",0,1,0,0,1
"cg01603569",1,1,0,0,2
"cg01603620",5,3,0,0,8
"cg01603921",1,0,1,0,2
"cg01606628",0,0,1,0,1
"cg01606718",1,0,0,0,1
"cg01606822",34,0,0,0,34
"cg01607346",22,12,0,0,34
"cg01607468",0,0,2,0,2
"cg01608382",4,1,3,0,8
"cg01608878",2,0,0,0,2
"cg01609081",3,0,0,0,3
"cg01611273",10,0,0,0,10
"cg01612190",0,0,1,0,1
"cg01612468",0,0,1,0,1
"cg01612532",1,4,1,0,6
"cg01614387",0,1,0,0,1
"cg01615309",0,0,1,0,1
"cg01617603",0,1,0,0,1
"cg01617924",0,0,1,0,1
"cg01618470",1,0,0,0,1
"cg01619190",2,16,0,0,18
"cg01620649",2,0,0,0,2
"cg01621422",0,1,1,0,2
"cg01621711",15,15,15,0,45
"cg01622594",3,19,45,0,67
"cg01622930",1,0,7,0,8
"cg01623085",0,0,1,0,1
"cg01623657",2,4,1,0,7
"cg01624037",0,2,0,0,2
"cg01624238",0,1,0,0,1
"cg01624386",1,0,0,0,1
"cg01624569",0,0,1,0,1
"cg01624645",1,0,0,0,1
"cg01626125",0,0,0,1,1
"cg01626639",1,0,0,0,1
"cg01630130",0,1,1,0,2
"cg01630940",0,2,2,0,4
"cg01632517",0,0,1,0,1
"cg01633517",3,0,0,0,3
"cg01633848",0,0,2,0,2
"cg01633909",1,0,0,0,1
"cg01634102",58,6,0,0,64
"cg01634289",11,8,0,0,19
"cg01634482",1,0,0,0,1
"cg01634664",1,0,0,0,1
"cg01634700",6,0,0,0,6
"cg01635128",0,1,0,0,1
"cg01636541",1,0,0,0,1
"cg01636576",13,14,2,0,29
"cg01636631",7,0,0,0,7
"cg01636967",3,0,0,0,3
"cg01637512",3,0,0,0,3
"cg01637519",3,0,0,0,3
"cg01638082",0,1,0,0,1
"cg01638235",0,1,0,0,1
"cg01638829",4,15,13,0,32
"cg01641152",0,0,2,0,2
"cg01641177",0,2,0,0,2
"cg01642415",6,0,0,0,6
"cg01642627",1,2,0,0,3
"cg01643675",0,0,1,0,1
"cg01645401",1,0,0,0,1
"cg01645955",2,0,0,0,2
"cg01647734",1,0,0,0,1
"cg01648779",0,0,1,0,1
"cg01650097",2,0,0,0,2
"cg01650371",2,0,0,0,2
"cg01650965",249,10,0,0,259
"cg01651290",2,2,1,0,5
"cg01651688",0,0,1,0,1
"cg01651927",1,0,0,0,1
"cg01653459",1,1,0,0,2
"cg01653494",0,0,1,0,1
"cg01653868",33,51,13,0,97
"cg01655158",1,2,0,0,3
"cg01656376",3,3,0,0,6
"cg01656567",0,1,1,0,2
"cg01658302",1,0,0,0,1
"cg01658444",0,1,0,0,1
"cg01658502",0,1,0,0,1
"cg01658563",1,0,0,0,1
"cg01659202",17,3,0,0,20
"cg01659483",284,206,36,0,526
"cg01660676",0,1,2,0,3
"cg01660978",0,0,2,0,2
"cg01661358",0,0,1,0,1
"cg01663150",2,0,0,0,2
"cg01663649",3,0,0,0,3
"cg01664273",1,0,0,0,1
"cg01665013",8,2,0,0,10
"cg01665970",10,1,0,0,11
"cg01666573",0,1,0,0,1
"cg01666717",1,0,0,0,1
"cg01668740",0,1,1,0,2
"cg01668907",0,1,0,0,1
"cg01670029",43,15,1,0,59
"cg01670404",0,0,1,0,1
"cg01671587",0,0,2,0,2
"cg01672546",0,0,1,0,1
"cg01673347",23,1,1,0,25
"cg01673418",2,0,0,0,2
"cg01673454",0,1,0,0,1
"cg01673783",0,0,2,0,2
"cg01673800",1,0,0,0,1
"cg01675238",0,1,0,0,1
"cg01675955",2,4,22,0,28
"cg01678317",1,1,0,0,2
"cg01678468",1,0,0,0,1
"cg01678701",18,1,0,0,19
"cg01679086",1,1,1,0,3
"cg01679542",0,2,1,0,3
"cg01679630",1,0,0,0,1
"cg01679924",0,2,0,0,2
"cg01681351",0,0,2,0,2
"cg01682748",1,3,0,0,4
"cg01683000",0,0,1,0,1
"cg01683082",1,0,0,0,1
"cg01684860",1,3,4,0,8
"cg01685281",1,0,0,0,1
"cg01686861",0,0,1,0,1
"cg01687389",41,1,0,0,42
"cg01687682",0,0,1,0,1
"cg01687925",2,1,2,0,5
"cg01688243",2,1,2,0,5
"cg01689796",0,3,2,0,5
"cg01690455",1,1,2,0,4
"cg01690573",327,286,3,0,616
"cg01690754",0,1,0,0,1
"cg01692616",6,15,1,0,22
"cg01692649",2,0,0,0,2
"cg01694529",1,0,0,0,1
"cg01694554",5,0,0,0,5
"cg01694628",0,1,1,0,2
"cg01694818",0,1,0,0,1
"cg01694873",0,0,1,0,1
"cg01695023",0,0,1,0,1
"cg01695706",0,5,3,0,8
"cg01696060",815,398,11,0,1224
"cg01700035",821,33,1,0,855
"cg01700413",1,0,0,0,1
"cg01700868",21,5,1,0,27
"cg01701555",0,3,0,0,3
"cg01701599",2,0,0,0,2
"cg01701655",0,0,1,0,1
"cg01702095",1,0,0,0,1
"cg01702517",1,3,0,0,4
"cg01702834",1,0,3,0,4
"cg01703390",1,0,0,0,1
"cg01704252",0,3,13,0,16
"cg01704285",0,0,1,0,1
"cg01704734",0,1,0,0,1
"cg01706270",0,0,1,0,1
"cg01706419",5,0,0,0,5
"cg01706603",0,0,1,0,1
"cg01706844",1,1,0,0,2
"cg01708302",0,1,0,0,1
"cg01708338",0,0,1,0,1
"cg01708427",1,0,0,0,1
"cg01708693",0,0,1,0,1
"cg01709551",6,3,6,0,15
"cg01710670",0,0,5,0,5
"cg01711850",258,320,46,0,624
"cg01712432",21,0,0,0,21
"cg01712494",1,0,0,0,1
"cg01713491",0,4,1,0,5
"cg01714921",7,8,3,0,18
"cg01715263",1,0,0,0,1
"cg01715726",0,2,0,0,2
"cg01716469",1,0,0,0,1
"cg01716830",3,5,3,0,11
"cg01717010",121,53,0,0,174
"cg01717031",0,0,1,0,1
"cg01717047",3,0,3,0,6
"cg01717482",0,0,1,0,1
"cg01717586",0,0,1,0,1
"cg01717609",11,0,0,0,11
"cg01718222",1,0,1,0,2
"cg01718231",11,0,0,0,11
"cg01718332",2,0,0,0,2
"cg01718738",0,0,1,0,1
"cg01719179",0,0,1,0,1
"cg01719566",2,0,0,0,2
"cg01719577",1,0,0,0,1
"cg01719994",2,0,0,0,2
"cg01720033",0,1,0,0,1
"cg01720520",1,0,0,0,1
"cg01720947",0,0,2,0,2
"cg01721069",0,1,0,0,1
"cg01721454",0,0,2,0,2
"cg01725445",7,0,0,0,7
"cg01725474",2,0,0,0,2
"cg01726949",3,0,0,0,3
"cg01727255",12,1,0,0,13
"cg01727317",0,0,1,0,1
"cg01727625",0,0,3,0,3
"cg01727751",1,4,2,0,7
"cg01728552",16,3,0,0,19
"cg01729288",287,149,21,0,457
"cg01729523",0,3,1,0,4
"cg01729827",0,1,0,0,1
"cg01729977",2,0,0,0,2
"cg01731360",0,0,1,0,1
"cg01731704",600,87,3,0,690
"cg01731804",0,0,1,0,1
"cg01732538",1,2,0,0,3
"cg01734648",1,0,0,0,1
"cg01735070",0,0,1,0,1
"cg01735781",0,0,2,0,2
"cg01737532",0,0,1,1,2
"cg01737548",1,0,1,0,2
"cg01737634",1,0,0,0,1
"cg01739431",2,0,0,0,2
"cg01740821",3,0,0,0,3
"cg01741040",3,0,0,0,3
"cg01741491",0,0,1,0,1
"cg01742333",0,1,0,0,1
"cg01745044",0,0,1,0,1
"cg01745248",0,0,1,0,1
"cg01746522",4,2,3,0,9
"cg01747036",0,0,1,0,1
"cg01750780",0,2,1,0,3
"cg01751337",0,1,0,0,1
"cg01751807",0,0,1,0,1
"cg01752870",3,0,0,0,3
"cg01752877",1,0,0,0,1
"cg01753315",0,1,1,0,2
"cg01753715",1246,504,11,0,1761
"cg01755528",0,1,0,0,1
"cg01755805",0,0,1,0,1
"cg01755807",26,7,2,0,35
"cg01755891",42,5,0,0,47
"cg01756599",0,0,1,0,1
"cg01756687",1,0,0,0,1
"cg01757127",13,7,6,0,26
"cg01757308",0,0,1,0,1
"cg01757535",0,0,0,1,1
"cg01757760",135,201,160,0,496
"cg01757789",1,2,0,0,3
"cg01757887",0,0,2,0,2
"cg01758548",1,0,0,0,1
"cg01758588",6,1,0,0,7
"cg01758747",0,0,1,0,1
"cg01758870",0,1,0,0,1
"cg01758988",1,0,0,0,1
"cg01759033",0,1,0,0,1
"cg01759226",1,0,0,0,1
"cg01759469",0,1,1,0,2
"cg01759622",0,1,0,0,1
"cg01759835",8,2,1,0,11
"cg01759906",1,0,0,0,1
"cg01760876",2,1,0,0,3
"cg01762091",1,1,0,0,2
"cg01762301",2,0,0,0,2
"cg01762490",1,0,0,0,1
"cg01763120",2,1,0,0,3
"cg01764447",0,1,0,0,1
"cg01765800",0,1,0,0,1
"cg01766505",5,0,0,0,5
"cg01767118",0,0,1,0,1
"cg01767973",0,1,0,0,1
"cg01769284",5,7,6,0,18
"cg01769354",1,0,0,0,1
"cg01769729",69,2,0,0,71
"cg01770015",2,1,0,0,3
"cg01771629",0,2,1,0,3
"cg01772547",1,0,0,0,1
"cg01773879",0,3,1,0,4
"cg01774400",207,83,8,0,298
"cg01774704",0,1,2,0,3
"cg01776020",0,0,5,0,5
"cg01776221",244,294,36,0,574
"cg01779724",1,8,7,0,16
"cg01779768",3,0,0,0,3
"cg01780228",1,0,0,0,1
"cg01780412",0,1,0,0,1
"cg01781279",712,125,2,0,839
"cg01783011",1,0,0,0,1
"cg01783051",22,8,0,0,30
"cg01783525",1,0,0,0,1
"cg01783736",10,2,0,0,12
"cg01784721",8,2,1,0,11
"cg01785278",1,0,1,0,2
"cg01785719",0,0,1,0,1
"cg01787110",0,0,2,0,2
"cg01788221",3,3,2,0,8
"cg01789846",0,0,1,0,1
"cg01789962",0,1,13,0,14
"cg01790213",128,42,3,0,173
"cg01790269",14,5,0,0,19
"cg01790530",1,0,0,0,1
"cg01790577",0,2,0,0,2
"cg01791785",3,0,14,0,17
"cg01792041",0,0,1,0,1
"cg01792402",0,2,1,0,3
"cg01793386",0,1,0,0,1
"cg01793576",1,0,0,0,1
"cg01793617",0,0,1,0,1
"cg01794166",0,0,2,0,2
"cg01795426",267,95,3,0,365
"cg01796823",0,0,1,0,1
"cg01796902",4,1,1,0,6
"cg01796929",1,0,0,0,1
"cg01797652",0,0,1,0,1
"cg01797727",19,13,0,0,32
"cg01798149",0,2,3,0,5
"cg01798232",0,1,4,0,5
"cg01798255",138,19,0,0,157
"cg01799075",1,0,0,0,1
"cg01799667",0,0,1,0,1
"cg01799791",0,1,0,0,1
"cg01800128",4,6,0,0,10
"cg01800190",0,1,9,0,10
"cg01800623",0,33,76,0,109
"cg01802078",2,0,0,0,2
"cg01803125",1,0,0,0,1
"cg01803284",21,9,1,0,31
"cg01803908",0,2,3,0,5
"cg01804944",2,1,3,0,6
"cg01805347",1,0,0,0,1
"cg01806195",2,0,0,0,2
"cg01806469",3,2,2,0,7
"cg01806526",2,0,0,0,2
"cg01807649",0,1,0,0,1
"cg01808090",1,0,0,0,1
"cg01808171",6,0,0,0,6
"cg01808810",0,1,2,0,3
"cg01809080",681,743,76,0,1500
"cg01810684",0,0,1,0,1
"cg01811378",0,0,1,0,1
"cg01813171",0,1,0,0,1
"cg01813209",8,4,1,0,13
"cg01814152",0,14,0,0,14
"cg01814459",3,1,0,0,4
"cg01815376",1,0,0,0,1
"cg01815856",0,1,0,0,1
"cg01816425",0,0,2,0,2
"cg01816633",1,6,5,0,12
"cg01816783",16,3,0,0,19
"cg01817216",0,0,2,0,2
"cg01819707",0,1,0,0,1
"cg01820961",0,1,0,0,1
"cg01821126",0,0,1,0,1
"cg01821553",2,0,0,0,2
"cg01821850",0,2,0,1,3
"cg01822143",259,273,13,0,545
"cg01822187",2,1,22,0,25
"cg01822559",3,0,0,0,3
"cg01823005",3,0,0,0,3
"cg01823222",0,0,1,0,1
"cg01823275",0,0,2,0,2
"cg01823510",0,1,0,0,1
"cg01823827",321,71,3,0,395
"cg01824252",1,0,0,0,1
"cg01824316",797,221,2,0,1020
"cg01825786",0,1,0,0,1
"cg01826367",1,1,0,0,2
"cg01827770",0,0,1,0,1
"cg01827805",0,1,0,0,1
"cg01828159",0,0,1,0,1
"cg01828328",0,0,1,0,1
"cg01828661",0,0,1,0,1
"cg01829407",1,0,0,0,1
"cg01829941",1,0,0,0,1
"cg01831107",0,0,1,0,1
"cg01831896",0,1,1,0,2
"cg01831959",21,29,7,0,57
"cg01832487",1,0,0,0,1
"cg01834029",31,1,0,0,32
"cg01834373",2,0,0,0,2
"cg01835509",0,1,0,0,1
"cg01835944",7,4,0,0,11
"cg01836197",2,2,0,0,4
"cg01836455",2,0,0,0,2
"cg01836687",0,1,0,0,1
"cg01836858",200,412,40,0,652
"cg01837016",0,1,0,0,1
"cg01837661",20,3,1,0,24
"cg01838916",2,2,0,0,4
"cg01839271",0,0,1,0,1
"cg01839806",0,2,0,0,2
"cg01839983",3,0,0,0,3
"cg01841696",0,5,2,0,7
"cg01841772",0,0,1,0,1
"cg01842095",1,0,0,0,1
"cg01843131",1,0,0,0,1
"cg01843766",271,12,0,0,283
"cg01843804",2,0,0,0,2
"cg01846753",4,0,0,0,4
"cg01847834",0,1,0,0,1
"cg01847992",29,23,1,0,53
"cg01849065",0,0,1,0,1
"cg01849309",0,1,0,0,1
"cg01849644",2,7,3,0,12
"cg01850086",0,2,0,0,2
"cg01850091",40,68,21,0,129
"cg01850561",60,580,15,0,655
"cg01852611",46,16,0,0,62
"cg01853981",1,1,0,0,2
"cg01853986",0,1,0,0,1
"cg01854026",0,0,1,0,1
"cg01854144",0,0,0,1,1
"cg01854162",1,0,0,0,1
"cg01855098",1,0,0,0,1
"cg01856048",1,6,0,0,7
"cg01856162",0,1,0,0,1
"cg01857264",0,0,2,0,2
"cg01857327",0,1,0,0,1
"cg01858274",0,1,3,0,4
"cg01858458",840,229,4,0,1073
"cg01858764",44,1,0,0,45
"cg01858966",0,0,1,0,1
"cg01859402",1,0,0,0,1
"cg01859473",0,0,2,0,2
"cg01860124",3,0,0,0,3
"cg01860459",1,0,0,0,1
"cg01860517",1,0,0,0,1
"cg01860778",0,1,0,0,1
"cg01860954",0,0,1,0,1
"cg01861885",0,0,1,0,1
"cg01863139",3,0,0,0,3
"cg01864404",0,1,0,0,1
"cg01865305",4,4,0,0,8
"cg01865312",7,4,8,0,19
"cg01866959",1,0,0,0,1
"cg01867045",0,0,1,0,1
"cg01867155",125,4,0,0,129
"cg01867320",4,0,0,0,4
"cg01867854",179,226,31,0,436
"cg01867994",0,0,1,0,1
"cg01868367",0,1,0,0,1
"cg01869157",0,1,1,0,2
"cg01870562",0,0,1,0,1
"cg01870679",3,1,0,0,4
"cg01871750",0,0,1,0,1
"cg01872160",2,3,0,1,6
"cg01873311",0,0,1,0,1
"cg01874112",1,0,0,0,1
"cg01875604",0,1,0,0,1
"cg01877500",10,0,0,0,10
"cg01878825",0,2,0,0,2
"cg01879534",2,4,0,0,6
"cg01880147",1,0,0,0,1
"cg01880149",0,0,2,0,2
"cg01880743",23,2,0,0,25
"cg01880913",3,4,0,0,7
"cg01881456",2,1,0,0,3
"cg01881574",1,0,0,0,1
"cg01881620",2,1,1,0,4
"cg01881993",0,1,0,0,1
"cg01882227",0,0,1,0,1
"cg01883427",0,0,1,0,1
"cg01883883",1,0,0,0,1
"cg01884526",0,0,1,0,1
"cg01884589",553,49,0,0,602
"cg01885222",1,0,0,0,1
"cg01885783",0,0,1,0,1
"cg01886234",0,0,1,0,1
"cg01886593",0,0,1,0,1
"cg01887878",1,0,0,0,1
"cg01888748",4,11,0,0,15
"cg01890083",6,1,0,0,7
"cg01890098",1,1,0,0,2
"cg01891002",1,0,0,0,1
"cg01891622",0,1,0,0,1
"cg01892211",0,0,3,0,3
"cg01892426",0,0,0,1,1
"cg01892980",0,1,0,0,1
"cg01893320",35,6,0,0,41
"cg01893993",0,0,1,0,1
"cg01895003",1,0,0,0,1
"cg01895141",0,0,2,0,2
"cg01895200",2,0,0,0,2
"cg01895357",0,1,0,0,1
"cg01895760",27,83,0,0,110
"cg01896091",1,0,3,0,4
"cg01896152",1,0,0,0,1
"cg01896656",1,0,0,0,1
"cg01897156",1,0,0,0,1
"cg01897498",1,0,0,0,1
"cg01899154",2,2,0,0,4
"cg01900254",0,0,2,0,2
"cg01900452",6,0,0,0,6
"cg01900690",0,0,1,0,1
"cg01901708",0,0,1,0,1
"cg01902355",0,2,0,0,2
"cg01902849",0,0,1,0,1
"cg01902915",1,0,0,0,1
"cg01903381",16,16,10,0,42
"cg01904634",0,2,0,0,2
"cg01904642",3,2,4,0,9
"cg01904776",0,0,6,0,6
"cg01905157",7,5,0,0,12
"cg01905902",2,1,0,0,3
"cg01906102",4,5,5,0,14
"cg01906717",0,1,0,0,1
"cg01907476",0,1,0,0,1
"cg01908444",2,0,0,0,2
"cg01908508",0,1,0,0,1
"cg01908618",1,0,0,0,1
"cg01908902",0,0,1,0,1
"cg01908909",0,1,0,0,1
"cg01909103",0,1,0,0,1
"cg01909446",5,12,0,0,17
"cg01909588",0,0,2,0,2
"cg01911395",0,1,0,0,1
"cg01911977",0,0,2,0,2
"cg01912388",0,0,1,0,1
"cg01913077",1,0,0,0,1
"cg01913285",2,0,0,0,2
"cg01913505",192,207,5,0,404
"cg01913604",0,0,1,0,1
"cg01914769",0,1,0,0,1
"cg01915081",0,0,1,0,1
"cg01916846",1,0,0,0,1
"cg01917648",0,0,1,0,1
"cg01918114",0,0,18,0,18
"cg01918803",0,0,2,0,2
"cg01919250",6,7,1,0,14
"cg01919309",2,0,0,0,2
"cg01919618",3,0,0,0,3
"cg01919963",0,0,2,0,2
"cg01920485",1,0,0,0,1
"cg01921212",33,4,0,0,37
"cg01922220",1,0,0,0,1
"cg01922979",0,0,1,0,1
"cg01923740",1,0,0,0,1
"cg01924518",1,0,0,0,1
"cg01924644",0,0,1,0,1
"cg01926391",4,0,0,0,4
"cg01926717",2,0,0,0,2
"cg01926769",1,0,0,0,1
"cg01927072",0,1,0,0,1
"cg01929239",0,0,5,0,5
"cg01929379",0,1,0,0,1
"cg01929867",1,0,0,0,1
"cg01930395",0,0,2,0,2
"cg01931066",5,3,0,0,8
"cg01931751",1,0,0,0,1
"cg01932215",0,0,2,0,2
"cg01932247",1,0,0,0,1
"cg01932381",0,0,3,0,3
"cg01932762",0,1,1,0,2
"cg01933240",2,12,0,0,14
"cg01933245",27,20,3,0,50
"cg01933421",6,3,0,0,9
"cg01933559",0,0,1,0,1
"cg01933576",0,0,1,0,1
"cg01935942",0,0,1,0,1
"cg01937055",1,0,0,0,1
"cg01937395",1,0,0,0,1
"cg01937932",1,0,1,0,2
"cg01938295",1,0,0,0,1
"cg01939613",3,0,0,0,3
"cg01939912",0,0,1,0,1
"cg01939924",6,4,1,0,11
"cg01940490",0,1,1,0,2
"cg01941265",9,0,0,0,9
"cg01941740",0,1,0,0,1
"cg01942492",0,3,0,0,3
"cg01943337",0,1,0,0,1
"cg01943843",2,0,0,0,2
"cg01944530",50,1206,39,0,1295
"cg01944624",0,1,0,0,1
"cg01945263",1,0,0,0,1
"cg01945391",0,1,0,0,1
"cg01945822",0,1,0,0,1
"cg01946042",0,0,1,0,1
"cg01947805",5,0,0,0,5
"cg01948451",83,3,0,0,86
"cg01948703",1,0,0,0,1
"cg01948913",0,1,0,0,1
"cg01949133",1,0,0,0,1
"cg01950127",21,0,0,0,21
"cg01950479",1,0,0,0,1
"cg01952807",5,0,0,0,5
"cg01953152",0,0,1,0,1
"cg01953431",1,0,0,0,1
"cg01953879",2,0,0,0,2
"cg01954057",5,0,0,0,5
"cg01955286",0,5,4,0,9
"cg01955322",0,0,1,0,1
"cg01955656",0,0,1,0,1
"cg01956003",0,0,1,0,1
"cg01959355",0,1,0,0,1
"cg01959625",5,6,1,0,12
"cg01960306",1,0,0,0,1
"cg01961092",6,0,0,0,6
"cg01962405",4,0,0,0,4
"cg01962868",1,0,0,0,1
"cg01963654",109,16,0,0,125
"cg01963866",1,4,0,0,5
"cg01963897",1,1,0,0,2
"cg01964925",0,1,0,0,1
"cg01966510",0,0,4,0,4
"cg01966599",552,42,3,0,597
"cg01966756",1,0,0,0,1
"cg01967894",0,1,1,0,2
"cg01968054",0,0,1,0,1
"cg01968676",221,207,14,0,442
"cg01968683",0,1,0,0,1
"cg01968759",0,0,1,0,1
"cg01969916",1,0,0,0,1
"cg01970061",1,0,0,0,1
"cg01971516",4,4,0,0,8
"cg01972288",1,0,0,0,1
"cg01972496",3,0,0,0,3
"cg01972631",0,0,1,0,1
"cg01972899",24,0,0,0,24
"cg01973725",1,0,0,0,1
"cg01973858",1,0,0,0,1
"cg01974715",1,0,0,0,1
"cg01974973",7,0,0,0,7
"cg01975174",3,2,0,0,5
"cg01975714",0,1,0,0,1
"cg01975734",1,0,0,0,1
"cg01976034",3,2,0,0,5
"cg01976726",2,0,0,0,2
"cg01979270",0,0,1,0,1
"cg01979458",0,0,1,0,1
"cg01979600",0,1,1,0,2
"cg01979668",0,0,1,0,1
"cg01980984",90,1,0,0,91
"cg01982873",1,0,0,0,1
"cg01982884",1245,366,9,0,1620
"cg01984656",2,2,1,0,5
"cg01986179",1,0,2,0,3
"cg01986682",1,0,0,0,1
"cg01988539",0,1,0,0,1
"cg01989621",0,1,0,0,1
"cg01990184",16,1,0,0,17
"cg01990196",0,0,1,0,1
"cg01990328",0,0,1,0,1
"cg01990378",1,2,1,0,4
"cg01990433",2,0,0,0,2
"cg01990572",4,0,0,0,4
"cg01990901",0,1,0,0,1
"cg01992303",1,0,0,0,1
"cg01992604",0,0,2,0,2
"cg01993824",40,1,0,0,41
"cg01993907",0,1,0,0,1
"cg01995718",1,0,0,0,1
"cg01996643",3,0,0,0,3
"cg01996902",0,1,0,0,1
"cg01996921",18,1,0,0,19
"cg01997806",1,0,3,0,4
"cg01998262",138,4,0,0,142
"cg01998754",0,0,1,0,1
"cg01999086",0,1,0,0,1
"cg01999295",0,2,2,0,4
"cg01999539",0,1,0,0,1
"cg02001099",0,0,6,0,6
"cg02001299",18,2,1,0,21
"cg02001956",0,2,4,0,6
"cg02002247",0,1,0,0,1
"cg02002400",0,1,3,0,4
"cg02004494",7,1,0,0,8
"cg02004872",1,0,0,0,1
"cg02005062",55,2,0,0,57
"cg02005425",0,0,5,0,5
"cg02005709",1,5,0,0,6
"cg02005771",1,0,0,0,1
"cg02005989",0,4,0,0,4
"cg02006488",1,0,0,0,1
"cg02006904",1,0,0,0,1
"cg02007235",478,43,0,0,521
"cg02007433",2,9,0,0,11
"cg02007785",0,1,0,0,1
"cg02008169",1,0,0,0,1
"cg02008279",23,2,0,0,25
"cg02008936",0,0,9,0,9
"cg02009964",1,0,0,0,1
"cg02011394",0,5,2,0,7
"cg02011520",0,0,1,0,1
"cg02011982",0,1,0,0,1
"cg02012379",0,1,0,0,1
"cg02012712",1,0,0,0,1
"cg02014475",0,0,3,0,3
"cg02015053",0,0,1,0,1
"cg02015439",0,2,1,0,3
"cg02015735",0,0,2,0,2
"cg02016659",3,0,0,0,3
"cg02016772",44,35,5,0,84
"cg02016786",1,1,1,0,3
"cg02016903",0,0,1,0,1
"cg02017155",0,0,1,0,1
"cg02018798",0,1,0,0,1
"cg02019487",2,1,0,0,3
"cg02019873",53,8,1,0,62
"cg02019920",0,1,2,0,3
"cg02020366",1,0,0,0,1
"cg02021032",1,0,0,0,1
"cg02021442",0,1,6,0,7
"cg02022294",3,1,2,0,6
"cg02022319",0,0,1,0,1
"cg02022431",0,1,0,0,1
"cg02022978",41,2,0,0,43
"cg02023042",10,0,0,0,10
"cg02023550",0,0,1,0,1
"cg02024219",1,0,0,0,1
"cg02024579",0,0,1,0,1
"cg02025206",1,0,0,0,1
"cg02026774",8,7,3,0,18
"cg02027189",0,1,0,0,1
"cg02027263",0,0,1,0,1
"cg02027838",0,0,1,0,1
"cg02027844",0,1,0,0,1
"cg02028883",2,0,0,0,2
"cg02029089",6,0,0,0,6
"cg02029203",0,0,1,0,1
"cg02029539",1,0,0,0,1
"cg02029891",2,0,1,0,3
"cg02031827",1,2,0,0,3
"cg02033647",49,6,0,0,55
"cg02033694",0,0,1,0,1
"cg02034473",0,5,6,0,11
"cg02034497",2,1,0,0,3
"cg02034890",328,20,1,0,349
"cg02035002",0,0,1,0,1
"cg02035015",14,0,0,0,14
"cg02035018",0,0,1,0,1
"cg02035173",1,0,0,0,1
"cg02035242",1,0,0,0,1
"cg02035824",0,0,1,0,1
"cg02036127",0,0,3,0,3
"cg02037232",0,0,1,0,1
"cg02037300",1,1,0,0,2
"cg02038910",0,0,1,0,1
"cg02038919",13,0,0,0,13
"cg02039018",9,0,0,0,9
"cg02039712",0,1,0,0,1
"cg02040972",4,4,0,0,8
"cg02041621",2,0,0,0,2
"cg02042467",3,0,0,0,3
"cg02044172",114,204,5,0,323
"cg02044242",1,0,0,0,1
"cg02045801",0,0,2,0,2
"cg02047628",0,0,2,0,2
"cg02047977",1,0,0,0,1
"cg02049333",0,1,0,0,1
"cg02050232",0,0,1,0,1
"cg02050593",4,0,0,0,4
"cg02051553",0,1,0,0,1
"cg02051981",5,0,0,0,5
"cg02052548",6,8,1,0,15
"cg02052894",319,17,0,0,336
"cg02052905",0,0,1,0,1
"cg02053281",0,1,0,0,1
"cg02053568",0,0,2,0,2
"cg02053786",1,0,0,0,1
"cg02053850",2,0,0,0,2
"cg02054568",0,1,0,0,1
"cg02055547",1,0,2,0,3
"cg02056828",1,11,19,0,31
"cg02057144",2,0,0,0,2
"cg02057598",1,0,1,0,2
"cg02057716",0,1,0,0,1
"cg02058640",0,0,1,0,1
"cg02058815",0,1,1,0,2
"cg02058944",7,3,0,0,10
"cg02059705",1,0,0,0,1
"cg02061604",0,1,0,0,1
"cg02061626",0,0,1,0,1
"cg02061906",0,1,1,0,2
"cg02062530",0,1,0,0,1
"cg02062953",0,1,0,0,1
"cg02063165",0,0,1,0,1
"cg02063306",13,2,0,0,15
"cg02063833",0,1,0,0,1
"cg02064080",1,1,1,0,3
"cg02064413",57,18,0,0,75
"cg02064848",0,0,1,0,1
"cg02065883",0,1,1,0,2
"cg02065970",173,486,9,0,668
"cg02066092",0,2,6,0,8
"cg02066638",0,1,0,0,1
"cg02067414",4,0,0,0,4
"cg02069181",1,0,0,0,1
"cg02069723",55,65,109,0,229
"cg02070028",1,0,0,0,1
"cg02071267",151,55,7,0,213
"cg02071798",73,44,5,0,122
"cg02072589",1,0,0,0,1
"cg02072757",0,1,0,0,1
"cg02073669",1,0,0,0,1
"cg02075020",0,1,0,0,1
"cg02075434",0,0,1,0,1
"cg02076254",1,0,0,0,1
"cg02076598",0,0,0,1,1
"cg02077481",0,0,0,1,1
"cg02078896",5,0,0,0,5
"cg02078936",0,0,1,0,1
"cg02079963",0,0,1,0,1
"cg02080093",0,0,1,0,1
"cg02080152",3,0,0,0,3
"cg02081087",0,0,23,0,23
"cg02082613",7,1,0,0,8
"cg02083109",2,1,0,0,3
"cg02083151",1,0,0,0,1
"cg02084279",1,0,0,0,1
"cg02084772",5,2,0,0,7
"cg02086139",0,9,1,0,10
"cg02086742",0,1,0,0,1
"cg02086866",0,0,1,0,1
"cg02087212",0,1,0,0,1
"cg02088071",0,2,2,0,4
"cg02088447",0,0,1,0,1
"cg02088962",0,0,1,0,1
"cg02089745",0,1,0,0,1
"cg02089929",3,0,0,0,3
"cg02090069",0,3,0,0,3
"cg02091341",0,0,1,0,1
"cg02092014",55,6,0,0,61
"cg02092706",1,0,0,0,1
"cg02093168",12,0,0,0,12
"cg02093732",0,1,1,0,2
"cg02093833",0,0,1,0,1
"cg02095553",1,0,0,0,1
"cg02095572",0,0,1,0,1
"cg02096091",0,1,1,0,2
"cg02097032",5,0,1,0,6
"cg02097172",0,1,1,0,2
"cg02098194",9,0,0,0,9
"cg02098380",0,0,2,0,2
"cg02098999",1,1,0,0,2
"cg02099030",0,2,5,0,7
"cg02099136",0,1,1,0,2
"cg02101338",0,0,0,1,1
"cg02101689",3,3,5,0,11
"cg02102490",30,1,0,0,31
"cg02103202",11,6,0,0,17
"cg02103856",1,0,0,0,1
"cg02104415",18,7,0,0,25
"cg02105352",0,0,1,0,1
"cg02105579",44,1,0,0,45
"cg02105751",0,1,0,0,1
"cg02106342",14,18,2,0,34
"cg02108378",23,6,1,0,30
"cg02109086",1,0,0,0,1
"cg02109394",1,0,0,0,1
"cg02110606",1,0,1,0,2
"cg02112038",0,1,1,0,2
"cg02113605",4,1,0,0,5
"cg02113641",0,0,1,0,1
"cg02113794",10,0,0,0,10
"cg02114972",3,4,0,0,7
"cg02115252",49,2,0,0,51
"cg02115664",1,0,0,0,1
"cg02116162",2,0,0,0,2
"cg02117086",0,1,0,0,1
"cg02117823",3,0,0,0,3
"cg02117859",0,1,0,0,1
"cg02119152",0,1,0,0,1
"cg02119755",0,0,1,0,1
"cg02119909",1,0,0,0,1
"cg02121996",2,2,0,0,4
"cg02122372",5,6,3,0,14
"cg02125104",1,0,0,0,1
"cg02125400",8,2,0,0,10
"cg02125554",2,7,13,0,22
"cg02126249",0,7,2,0,9
"cg02127215",2,0,0,0,2
"cg02127560",16,1,0,0,17
"cg02127589",8,5,2,0,15
"cg02128091",1,0,0,0,1
"cg02128110",3,3,0,0,6
"cg02128156",1,0,0,0,1
"cg02128233",282,168,23,0,473
"cg02129999",0,2,0,0,2
"cg02132460",95,373,109,0,577
"cg02132560",0,0,1,0,1
"cg02133194",0,1,1,0,2
"cg02133324",0,0,1,0,1
"cg02133941",92,14,1,0,107
"cg02135859",1,0,2,0,3
"cg02136259",0,0,1,0,1
"cg02136723",886,341,4,0,1231
"cg02137581",0,0,1,0,1
"cg02138606",0,0,1,0,1
"cg02139641",0,5,0,0,5
"cg02139846",0,0,1,0,1
"cg02140171",11,7,0,0,18
"cg02140510",1,0,0,0,1
"cg02140517",0,1,0,0,1
"cg02140963",1,2,5,0,8
"cg02141570",9,7,0,0,16
"cg02142961",1,5,0,0,6
"cg02143429",1,1,0,0,2
"cg02144148",6,0,0,0,6
"cg02144187",0,2,0,0,2
"cg02145213",0,1,0,0,1
"cg02145931",232,16,1,0,249
"cg02146117",2,1,0,0,3
"cg02146966",0,0,2,0,2
"cg02147009",1,0,0,0,1
"cg02147592",0,0,1,0,1
"cg02147805",1,1,0,0,2
"cg02148292",1,0,1,0,2
"cg02148352",0,0,1,0,1
"cg02149169",1,0,0,0,1
"cg02149323",0,1,0,0,1
"cg02149884",0,1,0,0,1
"cg02150612",0,1,0,0,1
"cg02150926",0,3,0,0,3
"cg02151150",0,0,1,0,1
"cg02153334",3,3,6,0,12
"cg02153358",1,0,0,0,1
"cg02153534",2,0,0,0,2
"cg02154268",150,229,25,0,404
"cg02154269",0,1,0,0,1
"cg02154728",696,19,0,0,715
"cg02154997",0,0,1,0,1
"cg02155675",0,6,7,0,13
"cg02157454",1,1,2,0,4
"cg02158100",402,31,1,0,434
"cg02158292",0,0,1,0,1
"cg02158722",0,0,3,0,3
"cg02160872",9,5,2,0,16
"cg02161359",0,1,0,0,1
"cg02161858",0,0,1,0,1
"cg02163266",0,0,2,0,2
"cg02163958",0,1,0,0,1
"cg02164508",0,0,1,0,1
"cg02165614",0,0,1,0,1
"cg02165749",1,0,0,0,1
"cg02166431",216,11,2,0,229
"cg02167241",1,0,0,0,1
"cg02168492",8,0,0,0,8
"cg02168525",0,1,0,0,1
"cg02169692",14,0,0,0,14
"cg02170066",0,1,0,0,1
"cg02170534",7,0,0,0,7
"cg02171838",1,1,0,0,2
"cg02172345",13,4,3,0,20
"cg02172381",1,0,0,0,1
"cg02172792",1,0,0,0,1
"cg02172824",2,2,0,0,4
"cg02173067",206,7,0,0,213
"cg02173085",0,1,0,0,1
"cg02173333",1,0,0,0,1
"cg02173360",1,1,0,0,2
"cg02174428",3,0,0,0,3
"cg02174814",3,0,1,0,4
"cg02175035",2,0,0,0,2
"cg02175183",0,1,0,0,1
"cg02175904",0,0,1,0,1
"cg02176078",2,0,0,0,2
"cg02176326",1,1,0,0,2
"cg02179370",2,0,0,0,2
"cg02179412",0,1,0,0,1
"cg02179888",0,2,2,0,4
"cg02180424",6,0,0,0,6
"cg02180907",1,0,0,0,1
"cg02181036",1,0,0,0,1
"cg02181482",0,0,1,0,1
"cg02182127",6,3,3,0,12
"cg02182656",1,2,2,0,5
"cg02183561",5,0,0,0,5
"cg02184175",13,13,1,0,27
"cg02186098",1,1,0,0,2
"cg02186346",2,0,0,0,2
"cg02187900",49,609,5,0,663
"cg02188142",0,0,1,0,1
"cg02188225",1,0,0,0,1
"cg02189117",10,6,0,0,16
"cg02189729",3,1,0,0,4
"cg02190443",1,10,0,0,11
"cg02190454",1,0,0,0,1
"cg02190618",0,1,0,0,1
"cg02190786",104,217,24,0,345
"cg02191233",2,0,0,0,2
"cg02191938",0,6,0,0,6
"cg02192731",2,0,0,0,2
"cg02193967",1,0,5,0,6
"cg02194842",4,0,0,0,4
"cg02194900",2,0,0,0,2
"cg02194908",0,1,0,0,1
"cg02195405",2,0,1,0,3
"cg02196458",0,1,0,0,1
"cg02198625",1,0,0,0,1
"cg02202408",1,0,5,0,6
"cg02203680",0,0,1,0,1
"cg02205140",0,2,0,0,2
"cg02205238",799,48,0,0,847
"cg02206089",0,1,0,0,1
"cg02210038",0,1,0,0,1
"cg02210147",1,0,0,0,1
"cg02210279",0,0,1,0,1
"cg02210441",1,0,0,0,1
"cg02211783",1,0,0,0,1
"cg02211978",0,0,1,0,1
"cg02212061",0,0,1,0,1
"cg02212084",0,1,0,0,1
"cg02214632",2,0,0,0,2
"cg02214674",1,1,0,0,2
"cg02215080",1,0,0,0,1
"cg02215141",12,2,1,0,15
"cg02215418",66,4,0,0,70
"cg02216200",1,0,0,0,1
"cg02218414",0,0,1,0,1
"cg02218931",2,0,0,0,2
"cg02220894",19,1,0,0,20
"cg02220933",0,1,0,0,1
"cg02220985",5,5,1,0,11
"cg02221765",14,0,0,0,14
"cg02222362",0,0,2,0,2
"cg02222761",11,5,0,0,16
"cg02223062",1,2,5,0,8
"cg02223612",9,2,1,0,12
"cg02224374",0,1,0,0,1
"cg02224416",0,1,1,0,2
"cg02224535",2,0,0,0,2
"cg02224847",0,0,6,0,6
"cg02225046",3,1,2,0,6
"cg02225595",3,1,0,0,4
"cg02226252",4,9,3,0,16
"cg02226302",0,0,1,0,1
"cg02226953",1,0,0,0,1
"cg02227015",64,18,3,0,85
"cg02227032",0,1,0,0,1
"cg02227496",0,1,0,0,1
"cg02230089",5,0,1,0,6
"cg02230964",0,0,1,0,1
"cg02231229",1,2,1,0,4
"cg02231601",0,0,1,0,1
"cg02232426",11,0,0,0,11
"cg02234293",1,0,0,0,1
"cg02234352",1,17,3,0,21
"cg02234400",1,0,0,0,1
"cg02235066",4,4,0,0,8
"cg02235652",0,1,0,0,1
"cg02235959",0,1,0,0,1
"cg02236938",0,1,0,0,1
"cg02237493",3,0,0,0,3
"cg02237755",0,0,1,0,1
"cg02238634",0,0,1,0,1
"cg02238751",0,1,0,0,1
"cg02238969",0,1,0,0,1
"cg02239333",3,0,0,0,3
"cg02239377",0,1,0,0,1
"cg02239640",1,0,0,0,1
"cg02241136",11,18,5,0,34
"cg02242370",1,0,0,0,1
"cg02242668",0,0,1,0,1
"cg02243066",3,5,3,0,11
"cg02243092",0,2,4,0,6
"cg02243096",2,1,0,0,3
"cg02244039",0,0,1,0,1
"cg02244670",3,4,0,0,7
"cg02245105",0,2,4,0,6
"cg02245280",1,0,1,0,2
"cg02245518",1,0,0,0,1
"cg02245533",0,6,1,0,7
"cg02246063",444,55,1,0,500
"cg02246671",14,0,0,0,14
"cg02247211",59,27,5,0,91
"cg02249096",0,0,1,0,1
"cg02249099",3,0,0,0,3
"cg02251134",49,5,0,0,54
"cg02252638",7,0,0,0,7
"cg02252694",0,0,1,0,1
"cg02252783",2,0,0,0,2
"cg02254136",227,216,6,0,449
"cg02254261",0,2,5,0,7
"cg02254462",0,0,2,0,2
"cg02255104",346,7,0,0,353
"cg02255618",3,0,0,0,3
"cg02255801",2,1,0,0,3
"cg02256315",4,1,0,0,5
"cg02256546",0,1,0,0,1
"cg02256928",3,0,0,0,3
"cg02257029",2,11,6,0,19
"cg02257675",0,1,0,0,1
"cg02257883",5,0,0,0,5
"cg02258691",236,24,0,0,260
"cg02258972",1,2,3,0,6
"cg02259476",15,2,0,0,17
"cg02259942",0,0,2,0,2
"cg02260180",0,1,0,0,1
"cg02260289",0,0,1,0,1
"cg02260839",0,1,0,0,1
"cg02261135",1,0,0,0,1
"cg02261637",297,21,0,0,318
"cg02262290",4,6,4,0,14
"cg02263296",2,0,0,0,2
"cg02263426",2,1,3,0,6
"cg02263438",1,0,0,0,1
"cg02265318",0,0,1,0,1
"cg02265345",3,0,0,0,3
"cg02266840",9,8,0,0,17
"cg02267215",1,0,1,0,2
"cg02268668",0,1,0,0,1
"cg02268750",0,0,1,0,1
"cg02269231",6,0,0,0,6
"cg02269636",5,18,5,0,28
"cg02269855",2,0,0,0,2
"cg02270935",3,5,0,0,8
"cg02271407",0,1,0,0,1
"cg02271677",0,1,0,0,1
"cg02272213",674,54,2,0,730
"cg02273106",0,0,1,0,1
"cg02273149",3,1,0,0,4
"cg02275622",118,21,2,0,141
"cg02276263",2,1,0,0,3
"cg02276759",0,0,1,1,2
"cg02277303",1,2,0,0,3
"cg02278228",1,0,0,0,1
"cg02278659",0,0,2,0,2
"cg02279891",30,29,11,0,70
"cg02279950",0,0,1,0,1
"cg02280049",1,6,0,0,7
"cg02280221",0,0,7,0,7
"cg02280422",0,1,0,0,1
"cg02282869",3,4,0,0,7
"cg02285732",0,0,1,0,1
"cg02285907",0,4,2,0,6
"cg02288058",0,0,1,0,1
"cg02288260",0,1,0,0,1
"cg02288522",1,0,0,0,1
"cg02288770",0,3,0,0,3
"cg02289287",2,0,0,0,2
"cg02290197",1,0,0,0,1
"cg02290350",2,1,0,0,3
"cg02290855",29,55,31,0,115
"cg02290903",6,0,0,0,6
"cg02291561",3,0,0,0,3
"cg02292456",1,0,0,0,1
"cg02294111",0,0,1,0,1
"cg02294212",0,0,1,0,1
"cg02294991",0,1,0,0,1
"cg02295525",7,1,3,0,11
"cg02295742",2,0,0,0,2
"cg02296564",1,0,0,0,1
"cg02296719",0,1,0,0,1
"cg02297019",1,1,0,0,2
"cg02297021",0,0,1,0,1
"cg02298934",0,12,0,0,12
"cg02299136",0,2,0,0,2
"cg02299937",0,0,2,0,2
"cg02300694",0,0,6,0,6
"cg02301971",0,0,1,0,1
"cg02303386",13,12,0,0,25
"cg02303858",1,0,0,0,1
"cg02303941",0,0,1,0,1
"cg02304361",1,0,0,0,1
"cg02305064",2,2,0,0,4
"cg02305633",3,4,3,0,10
"cg02305676",36,8,0,0,44
"cg02305826",0,0,1,0,1
"cg02306513",115,2,0,0,117
"cg02306639",1,0,0,0,1
"cg02307405",0,1,0,0,1
"cg02307542",0,3,2,0,5
"cg02308371",1,0,0,0,1
"cg02309320",1,2,0,0,3
"cg02309795",0,0,1,0,1
"cg02309849",1,0,0,0,1
"cg02310027",1,0,0,0,1
"cg02310739",0,0,1,0,1
"cg02310922",4,10,50,0,64
"cg02311040",0,0,1,0,1
"cg02311189",22,58,12,0,92
"cg02313331",0,0,1,0,1
"cg02313379",0,1,0,0,1
"cg02313442",128,20,0,0,148
"cg02314619",165,9,1,0,175
"cg02314642",0,2,1,0,3
"cg02315111",1,0,0,0,1
"cg02316115",1,0,0,0,1
"cg02316145",0,0,2,0,2
"cg02316852",10,0,0,0,10
"cg02317701",0,0,2,0,2
"cg02318567",0,1,0,0,1
"cg02320146",0,3,2,0,5
"cg02320614",0,0,1,0,1
"cg02320885",0,1,0,0,1
"cg02321115",0,2,0,1,3
"cg02321965",2,4,3,0,9
"cg02323296",17,4,0,0,21
"cg02325088",2,2,0,0,4
"cg02325411",2,1,0,0,3
"cg02325880",2,2,0,0,4
"cg02327103",1,0,0,0,1
"cg02327109",0,1,1,0,2
"cg02327429",2,13,9,0,24
"cg02328278",1,1,0,0,2
"cg02330371",1,1,0,0,2
"cg02330432",0,2,4,0,6
"cg02331189",0,1,0,0,1
"cg02332123",1,2,0,0,3
"cg02334514",0,1,0,0,1
"cg02334660",0,0,1,0,1
"cg02335145",0,0,4,0,4
"cg02335370",1,1,0,0,2
"cg02335657",1,0,1,0,2
"cg02336143",3,0,1,0,4
"cg02336218",1,0,0,0,1
"cg02336334",1,0,0,0,1
"cg02336729",9,0,0,0,9
"cg02336910",0,0,1,0,1
"cg02337193",1,1,0,0,2
"cg02338889",0,1,0,0,1
"cg02340056",0,1,0,0,1
"cg02340063",0,1,0,0,1
"cg02340121",0,1,2,0,3
"cg02340465",0,1,0,0,1
"cg02340853",0,1,2,0,3
"cg02341729",0,1,0,0,1
"cg02341743",4,2,1,0,7
"cg02343451",1,1,1,0,3
"cg02344113",4,1,1,0,6
"cg02344973",1,0,0,0,1
"cg02345074",1,0,0,0,1
"cg02345566",1,0,0,0,1
"cg02345638",218,355,183,0,756
"cg02346205",0,0,1,0,1
"cg02346241",0,1,0,0,1
"cg02347105",0,1,1,0,2
"cg02348039",0,0,1,0,1
"cg02348876",266,111,15,0,392
"cg02350510",4,0,1,0,5
"cg02350644",2,2,9,0,13
"cg02350740",5,0,0,0,5
"cg02350974",0,0,1,0,1
"cg02351018",56,77,0,0,133
"cg02351437",6,2,0,0,8
"cg02352005",10,2,0,0,12
"cg02352404",0,1,0,0,1
"cg02352949",0,0,1,0,1
"cg02354293",2,0,0,0,2
"cg02354702",0,0,1,0,1
"cg02355010",4,11,8,0,23
"cg02355043",40,5,1,0,46
"cg02355049",0,0,2,0,2
"cg02355307",8,0,0,0,8
"cg02355870",1,0,0,0,1
"cg02356883",5,8,3,0,16
"cg02358448",0,1,1,0,2
"cg02358456",2,2,0,0,4
"cg02359637",0,1,0,0,1
"cg02360119",3,4,1,0,8
"cg02360155",0,0,4,0,4
"cg02360199",1,0,0,0,1
"cg02360948",1,0,0,0,1
"cg02361344",64,25,2,0,91
"cg02361881",4,13,2,0,19
"cg02361984",160,44,2,0,206
"cg02362309",50,2,0,0,52
"cg02362718",128,2,0,0,130
"cg02363979",0,0,2,0,2
"cg02364276",0,1,0,0,1
"cg02364492",0,1,3,0,4
"cg02365967",0,6,0,0,6
"cg02366402",0,1,0,0,1
"cg02366487",2,2,0,0,4
"cg02366642",0,0,3,0,3
"cg02367069",0,0,1,0,1
"cg02367470",0,1,0,0,1
"cg02367709",0,1,1,0,2
"cg02367992",38,17,0,0,55
"cg02368177",0,0,1,0,1
"cg02368274",0,0,1,0,1
"cg02368737",0,0,1,0,1
"cg02368784",188,65,1,0,254
"cg02369024",3,10,1,0,14
"cg02369375",0,0,1,0,1
"cg02369879",4,5,0,0,9
"cg02371692",1,2,6,0,9
"cg02372283",1,0,0,0,1
"cg02372523",1,0,0,0,1
"cg02373807",0,0,1,0,1
"cg02374984",0,0,1,0,1
"cg02376524",1,0,0,0,1
"cg02376610",0,2,2,0,4
"cg02376916",9,1,0,0,10
"cg02377839",1,0,0,0,1
"cg02378521",2,3,2,0,7
"cg02378859",0,1,0,0,1
"cg02378861",0,0,3,0,3
"cg02378862",3,0,0,0,3
"cg02379784",0,1,0,0,1
"cg02380236",1,0,1,0,2
"cg02380878",0,1,0,0,1
"cg02381565",2,2,1,0,5
"cg02382047",1,0,0,0,1
"cg02383043",0,1,0,0,1
"cg02385318",1,1,0,0,2
"cg02385556",36,5,0,0,41
"cg02385760",0,1,0,0,1
"cg02386345",1,0,0,0,1
"cg02387226",5,3,1,0,9
"cg02387612",0,0,1,0,1
"cg02388253",1,0,0,0,1
"cg02388468",0,1,0,0,1
"cg02388749",0,0,1,0,1
"cg02388751",0,0,1,0,1
"cg02389671",0,1,0,0,1
"cg02390115",0,0,5,0,5
"cg02391172",0,1,0,0,1
"cg02392460",0,0,2,0,2
"cg02393684",3,0,0,0,3
"cg02395296",1,0,0,0,1
"cg02395994",1,0,0,0,1
"cg02396431",41,17,0,0,58
"cg02397533",145,298,104,0,547
"cg02398151",0,0,2,0,2
"cg02398878",9,7,1,0,17
"cg02400128",2,0,0,0,2
"cg02400238",1,0,0,0,1
"cg02400509",1,0,0,0,1
"cg02401220",1,0,1,0,2
"cg02401734",1,0,0,0,1
"cg02401941",1,0,0,0,1
"cg02402214",1,0,0,0,1
"cg02402527",1,1,0,0,2
"cg02402744",0,1,0,0,1
"cg02402948",0,2,3,0,5
"cg02403069",0,0,1,0,1
"cg02403294",1,0,0,0,1
"cg02404219",0,0,2,0,2
"cg02404575",3,0,0,0,3
"cg02404685",2,0,1,0,3
"cg02405484",26,1,0,0,27
"cg02405619",0,1,0,0,1
"cg02407004",2,0,0,0,2
"cg02407068",0,1,0,0,1
"cg02408333",0,1,0,0,1
"cg02411293",0,0,4,0,4
"cg02412123",0,0,1,0,1
"cg02412448",3,1,0,0,4
"cg02412527",0,1,0,0,1
"cg02414230",0,0,3,0,3
"cg02414289",1,0,1,0,2
"cg02414646",1,0,0,0,1
"cg02414787",0,0,2,0,2
"cg02416492",5,1,0,0,6
"cg02416769",0,0,2,0,2
"cg02417040",0,1,0,0,1
"cg02417424",16,23,6,0,45
"cg02418055",0,1,0,0,1
"cg02418944",32,4,0,0,36
"cg02419513",9,6,0,0,15
"cg02419873",1,0,1,0,2
"cg02421212",2,0,0,0,2
"cg02421597",1,2,0,0,3
"cg02422011",2,0,0,0,2
"cg02422397",15,3,2,0,20
"cg02424007",1,0,0,0,1
"cg02424450",0,1,2,0,3
"cg02424569",0,1,0,0,1
"cg02425479",0,1,0,0,1
"cg02426151",14,1,0,0,15
"cg02426270",27,4,1,0,32
"cg02426307",2,1,3,0,6
"cg02426584",0,0,0,1,1
"cg02427443",0,3,0,0,3
"cg02427924",0,0,1,0,1
"cg02429035",0,1,0,0,1
"cg02429283",3,0,0,0,3
"cg02429514",6,0,0,0,6
"cg02430720",0,0,1,0,1
"cg02431780",0,2,1,0,3
"cg02432075",0,0,1,0,1
"cg02432101",0,1,1,0,2
"cg02432312",0,0,1,0,1
"cg02432907",54,7,0,0,61
"cg02433036",2,0,0,0,2
"cg02434099",0,1,10,7,18
"cg02434330",147,14,1,0,162
"cg02435593",0,0,1,0,1
"cg02436290",1,1,0,0,2
"cg02436581",1,0,0,0,1
"cg02436990",1,1,1,0,3
"cg02437787",2,0,0,0,2
"cg02438781",2,0,0,0,2
"cg02439471",16,2,5,0,23
"cg02440101",14,2,0,0,16
"cg02440947",682,62,3,0,747
"cg02442303",1,0,0,0,1
"cg02442392",1,3,0,0,4
"cg02442496",19,3,0,0,22
"cg02442854",0,1,0,0,1
"cg02443025",9,5,0,0,14
"cg02443081",0,1,0,0,1
"cg02443176",0,1,4,0,5
"cg02445395",0,1,11,0,12
"cg02445536",0,2,2,0,4
"cg02448190",64,29,13,0,106
"cg02448207",33,2,0,0,35
"cg02448572",1,0,0,0,1
"cg02448922",0,0,1,0,1
"cg02449698",0,1,0,0,1
"cg02449727",0,0,2,0,2
"cg02449764",86,69,12,0,167
"cg02452838",1,0,0,0,1
"cg02454815",0,0,1,0,1
"cg02456344",36,1,0,0,37
"cg02457147",0,0,1,0,1
"cg02457312",0,1,7,0,8
"cg02458000",0,3,0,0,3
"cg02458396",3,2,10,0,15
"cg02459415",0,1,0,0,1
"cg02460141",0,0,4,0,4
"cg02460794",2,0,0,0,2
"cg02461468",7,0,0,0,7
"cg02463844",0,1,0,0,1
"cg02463891",0,1,1,0,2
"cg02464568",2,0,0,0,2
"cg02464984",1,0,1,0,2
"cg02465317",0,3,3,0,6
"cg02466602",0,1,0,0,1
"cg02466933",1,0,0,0,1
"cg02467002",4,3,3,0,10
"cg02467170",1,0,1,0,2
"cg02467339",0,0,3,0,3
"cg02468912",2,0,0,0,2
"cg02469067",0,4,0,0,4
"cg02469461",0,1,1,0,2
"cg02469655",0,0,1,0,1
"cg02470420",0,1,0,0,1
"cg02471132",0,1,0,0,1
"cg02471163",0,0,1,0,1
"cg02471166",1,17,188,0,206
"cg02471486",0,1,0,0,1
"cg02471506",0,0,1,0,1
"cg02471940",0,0,2,0,2
"cg02472339",27,0,0,0,27
"cg02472453",0,1,1,0,2
"cg02472906",0,0,2,0,2
"cg02473643",25,7,1,0,33
"cg02474890",3,0,0,0,3
"cg02475308",0,1,0,0,1
"cg02475408",7,3,14,0,24
"cg02475998",341,110,10,0,461
"cg02476274",17,12,4,0,33
"cg02476674",0,7,0,0,7
"cg02477464",0,0,1,0,1
"cg02477674",0,0,1,0,1
"cg02478711",0,1,0,0,1
"cg02479296",82,65,10,0,157
"cg02479692",0,0,1,0,1
"cg02479782",3,2,0,0,5
"cg02481085",1,5,5,0,11
"cg02481559",0,1,0,0,1
"cg02481878",5,5,0,0,10
"cg02482315",4,0,0,0,4
"cg02482481",0,0,1,0,1
"cg02482576",0,0,1,0,1
"cg02483126",68,216,10,0,294
"cg02483529",1,0,0,0,1
"cg02483713",1,0,0,0,1
"cg02483873",0,2,0,0,2
"cg02483910",4,0,0,0,4
"cg02484345",0,0,1,0,1
"cg02484674",1,0,0,0,1
"cg02486166",1,4,5,0,10
"cg02486239",0,1,0,0,1
"cg02486428",1,0,0,0,1
"cg02486520",1,3,9,0,13
"cg02487049",0,4,0,0,4
"cg02488349",1,0,0,0,1
"cg02489889",0,2,2,0,4
"cg02490228",0,3,0,0,3
"cg02490626",0,0,1,0,1
"cg02490708",0,0,3,0,3
"cg02491787",0,1,0,0,1
"cg02492940",1,0,0,0,1
"cg02493771",1,1,0,0,2
"cg02493986",0,0,1,0,1
"cg02494853",0,0,1,0,1
"cg02495120",0,0,1,0,1
"cg02495417",1,0,0,0,1
"cg02496065",424,22,0,0,446
"cg02496113",456,867,78,0,1401
"cg02496447",0,0,3,0,3
"cg02497698",6,3,0,0,9
"cg02497880",0,0,1,0,1
"cg02498120",0,2,1,2,5
"cg02498280",2,0,2,1,5
"cg02498722",0,0,1,0,1
"cg02498946",6,1,0,0,7
"cg02499236",77,26,3,0,106
"cg02499453",0,1,0,0,1
"cg02500479",1,0,0,0,1
"cg02502827",0,0,1,0,1
"cg02503527",0,0,1,0,1
"cg02503815",1,0,3,0,4
"cg02504280",0,0,4,0,4
"cg02505535",0,1,1,0,2
"cg02505596",0,0,1,0,1
"cg02508093",0,0,1,0,1
"cg02508409",0,1,0,0,1
"cg02508478",1,0,0,0,1
"cg02508684",1,0,0,0,1
"cg02508897",0,0,2,0,2
"cg02510147",2,5,1,0,8
"cg02511526",1,0,0,0,1
"cg02512224",1013,110,3,0,1126
"cg02514611",16,7,0,0,23
"cg02514711",0,0,1,0,1
"cg02514914",1,0,0,0,1
"cg02515001",1,0,0,0,1
"cg02515800",2,0,0,0,2
"cg02516018",0,0,1,0,1
"cg02517040",5,0,0,0,5
"cg02517294",2,2,0,0,4
"cg02518899",0,2,0,0,2
"cg02520502",1,0,0,0,1
"cg02522785",1,0,0,0,1
"cg02525307",0,2,4,0,6
"cg02526939",1,3,0,0,4
"cg02527198",101,25,1,0,127
"cg02529478",0,0,1,0,1
"cg02530095",0,1,0,0,1
"cg02530497",1,0,0,0,1
"cg02530668",0,1,6,0,7
"cg02530723",0,0,1,0,1
"cg02531033",1,0,0,0,1
"cg02531059",2,0,0,0,2
"cg02531214",0,1,0,0,1
"cg02531905",0,1,0,0,1
"cg02532996",1,0,0,0,1
"cg02533057",11,21,8,0,40
"cg02533998",60,2,0,0,62
"cg02534760",1,0,0,0,1
"cg02535317",1,1,0,0,2
"cg02536431",2,1,0,0,3
"cg02536433",0,1,1,0,2
"cg02536541",0,3,3,0,6
"cg02536691",2,1,0,0,3
"cg02536715",5,3,3,0,11
"cg02536923",3,0,0,0,3
"cg02537053",0,0,1,0,1
"cg02537106",1,1,0,0,2
"cg02537142",0,0,1,0,1
"cg02537639",0,1,0,0,1
"cg02538014",32,8,1,0,41
"cg02538562",276,449,50,0,775
"cg02539366",0,0,1,0,1
"cg02539543",1,0,0,0,1
"cg02539586",0,0,2,0,2
"cg02540021",0,1,0,0,1
"cg02540297",0,0,6,0,6
"cg02540355",1,0,0,0,1
"cg02541160",0,1,0,0,1
"cg02541362",109,8,0,0,117
"cg02541658",1,0,0,0,1
"cg02542103",244,10,0,0,254
"cg02542370",5,1,0,0,6
"cg02542853",1,0,0,0,1
"cg02542981",0,1,0,0,1
"cg02543019",83,21,0,0,104
"cg02544571",2,2,3,0,7
"cg02545984",1,1,0,0,2
"cg02546601",0,0,1,0,1
"cg02546883",0,1,1,0,2
"cg02547778",1,0,0,0,1
"cg02548290",0,1,0,0,1
"cg02548444",0,2,2,0,4
"cg02548842",1,0,0,0,1
"cg02549964",0,1,0,0,1
"cg02550068",0,0,1,0,1
"cg02550425",2,5,7,0,14
"cg02550592",0,1,0,0,1
"cg02552489",0,0,2,0,2
"cg02553079",1,0,0,0,1
"cg02553537",0,1,0,0,1
"cg02554980",1,2,0,0,3
"cg02556954",0,1,0,0,1
"cg02557179",1,0,0,0,1
"cg02557322",0,0,1,0,1
"cg02558205",0,1,0,0,1
"cg02558424",57,89,4,0,150
"cg02558735",0,5,4,0,9
"cg02560730",0,2,0,0,2
"cg02561439",0,0,1,0,1
"cg02563028",2,0,1,0,3
"cg02564370",0,0,1,0,1
"cg02564847",253,328,9,0,590
"cg02565324",0,0,1,0,1
"cg02566428",3,0,0,0,3
"cg02567139",3,0,0,0,3
"cg02568615",0,1,0,0,1
"cg02569428",1,3,1,0,5
"cg02569448",2,0,0,0,2
"cg02569820",0,0,1,0,1
"cg02570102",0,0,2,0,2
"cg02571162",0,0,1,0,1
"cg02571503",0,1,0,0,1
"cg02573857",0,0,1,0,1
"cg02574101",0,0,1,0,1
"cg02574731",0,1,0,0,1
"cg02575292",1,1,0,0,2
"cg02575307",0,1,0,0,1
"cg02575561",0,1,0,0,1
"cg02575948",1,0,0,0,1
"cg02576220",2,0,0,0,2
"cg02576938",0,1,0,0,1
"cg02578100",0,1,0,0,1
"cg02578187",5,1,0,0,6
"cg02578368",2,0,0,0,2
"cg02578836",151,281,132,0,564
"cg02579377",0,1,0,0,1
"cg02579736",0,1,0,0,1
"cg02579903",2,2,0,0,4
"cg02580195",0,0,1,0,1
"cg02583536",0,0,1,0,1
"cg02585409",4,3,0,0,7
"cg02585535",0,0,1,0,1
"cg02585729",14,9,0,0,23
"cg02585734",0,0,1,0,1
"cg02586176",0,1,1,0,2
"cg02586298",1,0,0,0,1
"cg02588107",0,1,0,0,1
"cg02588277",0,1,0,0,1
"cg02589067",0,1,14,0,15
"cg02592223",4,0,0,0,4
"cg02592767",3,4,1,0,8
"cg02593048",1,2,5,0,8
"cg02593636",1,0,0,0,1
"cg02594063",1,0,0,0,1
"cg02595851",2,0,0,0,2
"cg02596190",681,170,0,0,851
"cg02596508",0,0,4,0,4
"cg02597016",1,0,0,0,1
"cg02597644",0,1,1,0,2
"cg02598338",1,0,0,0,1
"cg02598465",0,0,0,1,1
"cg02598623",246,275,27,0,548
"cg02599027",287,176,16,0,479
"cg02599116",859,807,27,0,1693
"cg02599583",1,0,0,0,1
"cg02599716",1,0,0,0,1
"cg02599787",0,1,0,0,1
"cg02600331",0,2,0,0,2
"cg02600413",2,1,0,0,3
"cg02600718",0,0,1,0,1
"cg02602533",4,0,0,0,4
"cg02602925",0,3,4,0,7
"cg02603003",3,0,0,0,3
"cg02603304",2,0,1,0,3
"cg02603784",0,1,0,0,1
"cg02603839",0,0,1,0,1
"cg02603861",1,0,3,0,4
"cg02603868",55,1,0,0,56
"cg02605501",8,7,1,0,16
"cg02605954",1,1,0,0,2
"cg02606575",12,1,0,0,13
"cg02606988",0,0,8,0,8
"cg02607259",1,0,0,0,1
"cg02607596",0,0,1,0,1
"cg02607718",4,0,0,0,4
"cg02608029",0,0,1,0,1
"cg02609263",7,1,0,0,8
"cg02609781",1,0,0,0,1
"cg02610327",87,13,1,0,101
"cg02610689",5,0,0,0,5
"cg02611874",1,4,8,0,13
"cg02611970",4,0,0,0,4
"cg02613964",0,1,0,0,1
"cg02614111",3,0,0,0,3
"cg02614443",6,2,0,0,8
"cg02615239",0,0,1,0,1
"cg02615352",0,1,0,0,1
"cg02616069",9,3,0,0,12
"cg02616342",62,100,3,0,165
"cg02617486",0,0,1,0,1
"cg02618306",0,0,1,0,1
"cg02618467",1,0,0,0,1
"cg02618715",0,1,0,0,1
"cg02619464",116,17,0,0,133
"cg02619874",5,0,0,0,5
"cg02621030",1,0,0,0,1
"cg02621032",1,3,2,0,6
"cg02621287",0,2,0,0,2
"cg02621977",3,1,0,0,4
"cg02622251",0,0,1,0,1
"cg02622835",2,2,5,0,9
"cg02622994",1,0,0,0,1
"cg02623071",1,0,0,0,1
"cg02624737",0,0,1,0,1
"cg02625244",1,0,0,0,1
"cg02626012",94,73,0,0,167
"cg02626667",3,0,0,0,3
"cg02627523",1,0,0,0,1
"cg02628260",0,1,0,0,1
"cg02628858",4,0,0,0,4
"cg02629319",0,0,1,0,1
"cg02629963",0,1,0,0,1
"cg02630143",3,1,0,0,4
"cg02630829",141,24,1,0,166
"cg02630881",3,0,0,0,3
"cg02631803",0,0,1,0,1
"cg02631822",0,0,4,0,4
"cg02632108",0,0,1,0,1
"cg02633309",0,8,2,0,10
"cg02633664",1,0,0,0,1
"cg02634641",0,0,1,0,1
"cg02634853",0,0,1,0,1
"cg02635020",0,0,1,0,1
"cg02636167",2,0,0,0,2
"cg02637206",0,0,1,0,1
"cg02637978",0,2,0,0,2
"cg02639157",0,0,1,0,1
"cg02639283",1,1,0,0,2
"cg02639546",1,0,1,0,2
"cg02639619",1,1,0,0,2
"cg02640271",0,3,0,0,3
"cg02640691",0,0,1,0,1
"cg02641420",0,1,0,0,1
"cg02641714",2,0,0,0,2
"cg02642031",0,1,3,0,4
"cg02642298",480,9,0,0,489
"cg02643069",22,9,1,0,32
"cg02643647",0,0,1,0,1
"cg02643860",1,0,0,0,1
"cg02644195",0,1,1,0,2
"cg02644235",0,1,0,0,1
"cg02644734",0,1,1,0,2
"cg02645058",3,0,0,0,3
"cg02645353",15,2,0,0,17
"cg02645861",0,1,0,0,1
"cg02646394",2,2,3,0,7
"cg02646665",0,0,3,0,3
"cg02646787",0,0,4,0,4
"cg02647869",1,0,0,0,1
"cg02647989",5,1,0,0,6
"cg02648170",0,2,0,0,2
"cg02648724",556,640,16,0,1212
"cg02649505",20,1,0,0,21
"cg02650039",1,8,0,0,9
"cg02650631",0,1,0,0,1
"cg02650789",20,0,0,0,20
"cg02651090",1,0,0,0,1
"cg02652321",10,0,1,0,11
"cg02652820",0,1,0,0,1
"cg02652891",1,0,0,0,1
"cg02653177",0,3,0,0,3
"cg02654935",3,3,0,0,6
"cg02655565",3,0,0,0,3
"cg02656341",2,0,0,0,2
"cg02656873",491,73,1,0,565
"cg02656884",1,0,0,0,1
"cg02656947",139,75,3,0,217
"cg02656959",1,3,0,0,4
"cg02657128",0,0,1,0,1
"cg02658214",1,0,0,0,1
"cg02658908",3,2,0,0,5
"cg02658934",0,1,0,0,1
"cg02659041",0,0,1,0,1
"cg02660117",8,0,0,0,8
"cg02660347",0,2,1,0,3
"cg02662530",181,48,1,0,230
"cg02663161",0,0,1,0,1
"cg02663317",5,0,1,0,6
"cg02663382",1,0,0,0,1
"cg02665031",0,1,0,1,2
"cg02665414",2,1,1,0,4
"cg02665595",0,0,1,0,1
"cg02665744",0,0,2,0,2
"cg02665945",0,6,0,0,6
"cg02666966",1,0,0,0,1
"cg02667727",0,0,1,0,1
"cg02667756",3,9,12,0,24
"cg02668812",2,0,0,0,2
"cg02668838",1,0,0,0,1
"cg02669162",1,0,0,0,1
"cg02670999",3,0,0,0,3
"cg02671063",2,0,0,0,2
"cg02671915",163,179,1,0,343
"cg02672130",3,1,0,0,4
"cg02672397",0,0,1,0,1
"cg02672759",1,0,0,0,1
"cg02673636",0,0,1,0,1
"cg02674039",0,1,0,0,1
"cg02675083",0,1,1,0,2
"cg02675179",1,1,0,0,2
"cg02675299",0,0,1,0,1
"cg02676735",1,0,0,0,1
"cg02676785",0,0,1,0,1
"cg02677388",4,0,0,0,4
"cg02678160",3,2,1,0,6
"cg02678356",0,0,1,0,1
"cg02679172",3,0,0,0,3
"cg02679273",1,1,0,0,2
"cg02680531",4,0,0,0,4
"cg02681034",0,3,0,0,3
"cg02682905",0,1,0,0,1
"cg02683461",0,0,1,0,1
"cg02684219",1,0,0,0,1
"cg02685345",1,0,0,0,1
"cg02685684",0,2,0,0,2
"cg02687109",9,0,0,0,9
"cg02687812",0,4,5,0,9
"cg02689230",1,0,0,0,1
"cg02690169",1,4,0,0,5
"cg02690571",0,1,0,0,1
"cg02691002",0,0,2,0,2
"cg02691325",0,1,0,0,1
"cg02691686",14,12,4,0,30
"cg02693227",1,1,0,0,2
"cg02693345",21,6,2,0,29
"cg02694374",1,0,0,0,1
"cg02694456",5,0,0,0,5
"cg02694988",0,0,2,0,2
"cg02695751",566,51,3,0,620
"cg02696450",0,0,1,0,1
"cg02697258",0,0,3,0,3
"cg02697427",0,0,1,0,1
"cg02697527",0,0,1,0,1
"cg02699383",4,0,0,0,4
"cg02699432",0,5,0,0,5
"cg02699450",1,0,0,0,1
"cg02700958",7,1,0,0,8
"cg02701642",2,4,1,0,7
"cg02701747",358,622,7,0,987
"cg02703013",1,0,0,0,1
"cg02703535",1,13,2,0,16
"cg02703695",151,21,0,0,172
"cg02704485",9,3,1,0,13
"cg02704535",1,0,0,0,1
"cg02705681",0,0,3,0,3
"cg02705940",1,1,0,0,2
"cg02706564",0,0,1,0,1
"cg02706910",2,3,0,0,5
"cg02707222",0,1,0,0,1
"cg02707552",2,3,5,0,10
"cg02709323",1,15,15,0,31
"cg02709717",137,14,0,0,151
"cg02709931",0,1,3,0,4
"cg02711159",25,3,0,0,28
"cg02714013",0,0,1,0,1
"cg02714849",4,1,0,0,5
"cg02715021",1,0,0,0,1
"cg02716302",1,0,0,1,2
"cg02716450",0,5,3,0,8
"cg02718200",1,1,0,0,2
"cg02718464",0,3,0,0,3
"cg02718960",0,2,0,0,2
"cg02719411",0,0,1,0,1
"cg02720013",44,6,0,0,50
"cg02720925",0,1,1,0,2
"cg02721374",1,2,1,0,4
"cg02721426",0,1,1,0,2
"cg02721858",1,0,0,0,1
"cg02722239",0,1,0,0,1
"cg02723063",3,0,0,0,3
"cg02724067",0,5,0,0,5
"cg02724556",0,0,1,0,1
"cg02724903",0,0,1,0,1
"cg02725294",0,0,1,0,1
"cg02725718",1,0,0,0,1
"cg02725872",0,2,0,0,2
"cg02726739",0,0,1,0,1
"cg02726838",4,0,0,0,4
"cg02727110",0,0,5,1,6
"cg02727132",0,0,16,0,16
"cg02727232",1,0,1,0,2
"cg02727651",357,299,20,0,676
"cg02728223",0,1,0,0,1
"cg02728599",4,0,0,0,4
"cg02731412",1,0,0,0,1
"cg02731863",0,1,0,0,1
"cg02732164",0,1,1,0,2
"cg02734521",1,1,0,0,2
"cg02735840",41,5,0,0,46
"cg02736053",2,0,0,0,2
"cg02736334",0,2,1,0,3
"cg02736512",1,2,5,0,8
"cg02736900",0,1,0,0,1
"cg02737307",2,0,0,0,2
"cg02737321",0,1,0,0,1
"cg02737396",0,1,0,0,1
"cg02737655",0,0,1,0,1
"cg02738188",10,16,6,0,32
"cg02738374",1,0,0,0,1
"cg02740643",535,851,61,0,1447
"cg02740893",1,4,3,0,8
"cg02741229",0,0,1,0,1
"cg02741519",0,5,1,0,6
"cg02743252",1,0,0,0,1
"cg02744123",0,1,0,0,1
"cg02744632",2,0,0,0,2
"cg02744713",142,31,15,0,188
"cg02745237",0,1,1,0,2
"cg02745321",1,0,0,0,1
"cg02745398",0,1,0,0,1
"cg02746308",18,6,0,0,24
"cg02746684",0,0,2,0,2
"cg02747748",1,0,0,0,1
"cg02748083",0,0,1,0,1
"cg02749307",2,1,0,0,3
"cg02749789",1,0,0,0,1
"cg02750034",1,0,0,0,1
"cg02750145",0,2,0,0,2
"cg02750322",0,0,1,0,1
"cg02751503",1,0,0,0,1
"cg02752243",0,0,1,0,1
"cg02752915",2,0,0,0,2
"cg02753388",15,7,1,0,23
"cg02753865",1,0,0,0,1
"cg02754554",0,0,1,0,1
"cg02754643",2,0,0,0,2
"cg02755390",1,0,0,0,1
"cg02755871",5,0,0,0,5
"cg02756451",1,1,0,0,2
"cg02758222",0,2,0,0,2
"cg02758766",0,1,0,0,1
"cg02759880",0,0,1,0,1
"cg02759931",0,1,0,0,1
"cg02759946",0,0,1,0,1
"cg02761086",0,1,0,0,1
"cg02762637",0,1,0,0,1
"cg02763888",1,0,0,0,1
"cg02765275",3,2,0,0,5
"cg02768390",0,1,0,0,1
"cg02768998",173,229,16,0,418
"cg02769380",2,2,2,0,6
"cg02769624",2,1,0,0,3
"cg02770165",0,0,1,0,1
"cg02770187",1,4,3,0,8
"cg02770546",22,25,5,0,52
"cg02771261",0,0,1,0,1
"cg02771587",0,1,0,0,1
"cg02772132",31,73,7,0,111
"cg02772147",0,0,1,0,1
"cg02772935",0,1,0,0,1
"cg02773688",4,0,0,0,4
"cg02773756",0,0,1,0,1
"cg02774073",0,1,1,0,2
"cg02774486",0,0,1,0,1
"cg02774632",1,0,0,0,1
"cg02774942",0,1,0,0,1
"cg02775382",1,0,0,0,1
"cg02777068",0,0,1,0,1
"cg02777369",87,85,28,0,200
"cg02778467",0,1,3,0,4
"cg02778551",1,1,2,0,4
"cg02779210",0,0,1,0,1
"cg02779239",669,745,54,0,1468
"cg02780767",1,0,0,0,1
"cg02780862",761,24,0,0,785
"cg02781436",1,0,0,0,1
"cg02782566",0,1,0,0,1
"cg02782579",3,0,0,0,3
"cg02785793",10,29,4,0,43
"cg02786062",1,0,0,0,1
"cg02787767",1,0,0,0,1
"cg02788230",5,2,4,0,11
"cg02789075",0,0,1,0,1
"cg02789316",0,1,0,0,1
"cg02790620",0,0,1,0,1
"cg02791765",271,38,3,0,312
"cg02791784",0,1,2,0,3
"cg02792582",4,8,19,0,31
"cg02792602",0,1,0,0,1
"cg02793102",2,0,0,0,2
"cg02793323",0,0,1,0,1
"cg02793517",3,4,0,0,7
"cg02793695",0,1,0,0,1
"cg02793948",0,1,0,0,1
"cg02794418",0,2,0,0,2
"cg02794895",0,1,0,0,1
"cg02797217",0,0,1,0,1
"cg02797771",0,0,1,0,1
"cg02797940",2,2,1,0,5
"cg02797992",1,0,0,0,1
"cg02798309",0,1,0,0,1
"cg02798548",0,1,0,0,1
"cg02798874",4,0,0,0,4
"cg02799237",1,0,1,0,2
"cg02800016",2,0,0,0,2
"cg02800149",0,0,1,0,1
"cg02800384",0,1,0,0,1
"cg02801550",145,1,0,0,146
"cg02803047",0,14,12,0,26
"cg02803189",2,0,0,0,2
"cg02803281",4,0,0,0,4
"cg02803486",0,1,0,0,1
"cg02803853",2,0,0,0,2
"cg02804920",11,0,0,0,11
"cg02805713",0,0,1,0,1
"cg02806132",0,1,0,0,1
"cg02806329",0,1,0,0,1
"cg02809199",1,1,0,0,2
"cg02812189",0,1,0,0,1
"cg02812510",0,0,1,0,1
"cg02812757",285,633,10,0,928
"cg02812891",0,1,0,0,1
"cg02812970",0,1,0,0,1
"cg02813741",176,522,31,0,729
"cg02814420",0,0,1,0,1
"cg02814761",0,1,0,0,1
"cg02816727",155,124,5,0,284
"cg02817455",0,0,3,0,3
"cg02817670",1,0,0,0,1
"cg02818572",1,2,0,0,3
"cg02819404",1,0,0,0,1
"cg02820041",3,3,0,0,6
"cg02821627",557,15,0,0,572
"cg02823975",5,0,0,0,5
"cg02826078",0,1,0,0,1
"cg02826775",0,1,2,0,3
"cg02827046",1,0,0,0,1
"cg02827685",2,1,0,0,3
"cg02827714",1,0,0,0,1
"cg02827729",0,0,1,0,1
"cg02828397",0,0,2,0,2
"cg02828802",0,0,1,0,1
"cg02829598",2,3,5,1,11
"cg02830265",35,1,0,0,36
"cg02830576",1,0,0,0,1
"cg02831393",0,1,0,0,1
"cg02832305",1,1,0,0,2
"cg02833016",1,0,0,0,1
"cg02833532",1,0,0,0,1
"cg02833725",1,0,0,0,1
"cg02834722",0,1,0,0,1
"cg02836519",1,0,4,0,5
"cg02836833",0,0,1,0,1
"cg02838246",0,0,1,0,1
"cg02838309",0,0,1,0,1
"cg02839727",0,0,1,0,1
"cg02839824",1,0,0,0,1
"cg02841206",2,0,0,0,2
"cg02841322",2,0,0,0,2
"cg02841824",0,0,1,0,1
"cg02842157",0,1,0,0,1
"cg02844004",9,3,1,0,13
"cg02844387",0,2,0,0,2
"cg02844892",0,1,0,0,1
"cg02844984",1,1,0,0,2
"cg02845071",0,0,1,0,1
"cg02846228",0,1,0,0,1
"cg02846550",0,1,0,0,1
"cg02847216",1,0,0,0,1
"cg02847289",361,28,1,0,390
"cg02848072",0,0,11,0,11
"cg02848101",0,2,2,0,4
"cg02848711",0,1,0,0,1
"cg02848928",0,0,1,0,1
"cg02848998",0,0,0,1,1
"cg02849214",8,0,0,0,8
"cg02849475",6,1,0,0,7
"cg02849894",0,1,0,0,1
"cg02849953",4,1,0,0,5
"cg02850468",1,0,0,0,1
"cg02850902",0,1,0,0,1
"cg02851034",52,44,13,0,109
"cg02851397",3,0,0,0,3
"cg02853020",0,0,1,0,1
"cg02853225",5,0,0,0,5
"cg02853490",0,1,0,0,1
"cg02853731",58,14,2,0,74
"cg02853812",1,0,0,0,1
"cg02854515",1,1,5,0,7
"cg02854854",0,2,1,0,3
"cg02854954",193,7,0,0,200
"cg02855426",10,4,1,0,15
"cg02855558",1,0,0,0,1
"cg02855576",0,0,1,0,1
"cg02856808",1,0,0,0,1
"cg02857965",1,0,0,0,1
"cg02858699",2,1,0,0,3
"cg02859484",1,0,0,0,1
"cg02859709",0,1,0,0,1
"cg02860250",0,0,1,0,1
"cg02862087",0,4,4,0,8
"cg02862100",12,5,0,0,17
"cg02862129",6,0,0,0,6
"cg02862516",2,0,0,0,2
"cg02862637",333,29,0,0,362
"cg02862956",64,0,0,0,64
"cg02863409",0,0,2,0,2
"cg02864875",0,1,0,0,1
"cg02866075",0,0,1,0,1
"cg02866536",0,1,0,0,1
"cg02867728",0,0,1,0,1
"cg02868598",1,0,0,0,1
"cg02869126",268,13,1,0,282
"cg02869306",0,0,2,0,2
"cg02871102",0,0,1,0,1
"cg02872018",0,1,1,0,2
"cg02873710",229,154,11,0,394
"cg02874396",9,0,0,0,9
"cg02874538",0,3,3,0,6
"cg02875276",9,0,0,0,9
"cg02875297",0,0,1,0,1
"cg02875610",0,4,0,0,4
"cg02875869",0,0,2,0,2
"cg02876310",3,0,0,0,3
"cg02876798",1,0,0,0,1
"cg02877856",0,2,0,0,2
"cg02879122",0,1,1,0,2
"cg02880256",8,1,0,0,9
"cg02880315",1,1,0,0,2
"cg02881005",0,0,1,0,1
"cg02881011",0,0,1,0,1
"cg02882216",6,0,0,0,6
"cg02882797",1,0,0,0,1
"cg02884270",1,0,0,0,1
"cg02884661",1,0,0,0,1
"cg02886132",0,0,1,0,1
"cg02887779",2,0,0,0,2
"cg02887867",0,1,0,0,1
"cg02888288",1,0,0,0,1
"cg02888769",1,0,0,0,1
"cg02889450",1,1,0,0,2
"cg02889961",2,7,4,0,13
"cg02890046",7,0,0,0,7
"cg02890248",1,0,0,0,1
"cg02890536",4,2,1,0,7
"cg02891082",0,1,0,0,1
"cg02891744",1,2,0,0,3
"cg02892357",1,0,0,0,1
"cg02892624",0,1,0,0,1
"cg02892660",3,3,2,0,8
"cg02893251",1,5,2,0,8
"cg02893493",19,20,7,0,46
"cg02893823",0,1,0,0,1
"cg02894027",1,0,0,0,1
"cg02894362",0,1,0,0,1
"cg02895575",3,2,0,0,5
"cg02895602",0,1,0,0,1
"cg02895754",2,4,11,0,17
"cg02895827",1,0,0,0,1
"cg02897042",2,0,0,0,2
"cg02897482",0,0,2,0,2
"cg02898539",0,0,1,0,1
"cg02899730",53,3,0,0,56
"cg02900017",1,1,3,0,5
"cg02900749",1,0,0,0,1
"cg02902412",0,2,0,0,2
"cg02903305",4,22,15,0,41
"cg02903691",0,0,2,0,2
"cg02903710",1,3,0,0,4
"cg02904628",1,0,0,0,1
"cg02904661",1,0,0,0,1
"cg02904945",3,8,0,0,11
"cg02905065",0,0,2,0,2
"cg02905314",0,1,1,0,2
"cg02906397",1,0,1,0,2
"cg02906557",304,167,17,0,488
"cg02907441",0,0,2,0,2
"cg02909592",0,1,0,0,1
"cg02910873",0,1,0,0,1
"cg02910887",1,1,0,0,2
"cg02911211",101,28,4,0,133
"cg02911408",11,0,0,0,11
"cg02911985",1,1,0,0,2
"cg02912127",1,0,0,0,1
"cg02912345",0,1,0,0,1
"cg02912388",0,0,1,0,1
"cg02913804",0,2,0,0,2
"cg02913840",1,0,0,0,1
"cg02914735",0,0,1,0,1
"cg02915096",3,0,0,0,3
"cg02915290",2,5,1,0,8
"cg02915530",3,3,0,1,7
"cg02915544",0,0,1,0,1
"cg02915774",1,0,0,0,1
"cg02915803",1,0,0,0,1
"cg02916418",1,0,0,0,1
"cg02916425",1,1,2,0,4
"cg02917040",0,0,2,0,2
"cg02917156",1,0,0,0,1
"cg02917606",8,1,0,0,9
"cg02918923",0,1,0,0,1
"cg02919448",1,0,0,0,1
"cg02920196",0,1,0,0,1
"cg02920701",3,4,2,0,9
"cg02922488",0,0,1,0,1
"cg02922654",2,1,0,0,3
"cg02923906",1,0,0,0,1
"cg02924234",12,0,0,0,12
"cg02924447",1,0,0,0,1
"cg02924972",0,1,0,0,1
"cg02926347",0,1,3,0,4
"cg02926495",1,0,0,0,1
"cg02927485",0,1,2,0,3
"cg02930328",1,2,0,0,3
"cg02930356",2,1,1,0,4
"cg02931644",0,0,1,0,1
"cg02931656",152,220,34,0,406
"cg02932738",1,0,1,0,2
"cg02932763",2,0,0,0,2
"cg02932843",28,10,0,0,38
"cg02934226",0,1,5,0,6
"cg02934509",0,0,1,0,1
"cg02934633",5,6,4,0,15
"cg02934736",0,0,1,0,1
"cg02935743",3,4,2,0,9
"cg02935954",0,1,0,0,1
"cg02936076",1,0,0,0,1
"cg02936526",1,0,0,0,1
"cg02936553",0,0,1,0,1
"cg02937513",0,1,0,0,1
"cg02937548",0,2,2,0,4
"cg02937674",0,1,0,0,1
"cg02937720",1,0,0,0,1
"cg02937802",1,0,0,0,1
"cg02939233",0,3,0,0,3
"cg02939311",6,1,0,0,7
"cg02940661",0,2,0,0,2
"cg02940951",1,0,0,0,1
"cg02941596",0,1,1,0,2
"cg02941728",1,0,1,0,2
"cg02941859",0,0,3,0,3
"cg02941900",2,0,0,0,2
"cg02942066",4,1,0,0,5
"cg02942413",0,0,1,0,1
"cg02942649",16,12,1,0,29
"cg02944437",0,0,1,0,1
"cg02944578",36,1,0,0,37
"cg02944761",0,0,2,0,2
"cg02944840",4,0,0,0,4
"cg02945468",2,0,0,0,2
"cg02946290",458,753,30,0,1241
"cg02947374",0,0,1,0,1
"cg02947784",0,1,10,0,11
"cg02948019",0,0,2,0,2
"cg02948541",2,4,0,0,6
"cg02948812",6,3,1,0,10
"cg02949864",1,0,0,0,1
"cg02950168",0,0,1,0,1
"cg02951021",0,1,0,0,1
"cg02951476",25,26,1,0,52
"cg02951766",4,1,1,0,6
"cg02952317",12,18,5,0,35
"cg02952548",0,2,3,0,5
"cg02952740",0,0,1,0,1
"cg02953039",0,0,1,0,1
"cg02953381",0,3,2,0,5
"cg02953382",2,0,0,0,2
"cg02953520",15,1,0,0,16
"cg02953927",1,0,0,0,1
"cg02953976",0,0,1,0,1
"cg02954104",24,0,0,0,24
"cg02954563",38,8,2,0,48
"cg02954835",2,0,0,0,2
"cg02956110",9,2,0,0,11
"cg02956387",15,1,0,0,16
"cg02957053",2,1,0,0,3
"cg02957469",0,0,2,0,2
"cg02958600",3,2,0,0,5
"cg02960716",2,1,0,0,3
"cg02960948",0,0,2,0,2
"cg02961004",0,1,1,0,2
"cg02962705",1,0,0,0,1
"cg02963198",0,0,1,0,1
"cg02963381",0,0,1,0,1
"cg02963803",43,9,0,0,52
"cg02964102",1,1,0,0,2
"cg02964182",7,2,0,0,9
"cg02965545",135,9,0,0,144
"cg02966020",1,0,0,0,1
"cg02967787",14,0,0,0,14
"cg02968405",1,0,0,0,1
"cg02968496",3,0,0,0,3
"cg02968594",5,0,0,0,5
"cg02969084",1,0,0,0,1
"cg02969408",0,0,6,0,6
"cg02969677",1,0,0,0,1
"cg02969923",1,0,1,0,2
"cg02970297",0,0,1,0,1
"cg02971604",95,0,0,0,95
"cg02972098",0,2,1,0,3
"cg02972559",5,1,0,0,6
"cg02973441",0,7,31,0,38
"cg02974484",0,0,1,0,1
"cg02974968",5,9,1,0,15
"cg02975069",0,0,1,0,1
"cg02975081",1,2,0,0,3
"cg02975865",2,0,0,0,2
"cg02977466",0,0,1,0,1
"cg02977559",0,0,2,0,2
"cg02977684",0,0,1,0,1
"cg02977810",1,0,0,0,1
"cg02978204",3,0,0,0,3
"cg02979613",7,0,0,0,7
"cg02979711",2,0,0,0,2
"cg02980566",0,0,1,0,1
"cg02981071",0,2,3,0,5
"cg02981094",10,2,0,0,12
"cg02981978",0,0,1,0,1
"cg02982132",6,0,1,0,7
"cg02982614",0,0,1,0,1
"cg02983613",10,1,0,0,11
"cg02984164",0,0,1,0,1
"cg02984449",62,18,2,0,82
"cg02985366",0,0,1,0,1
"cg02986806",0,1,0,0,1
"cg02986905",0,1,0,0,1
"cg02986960",1,0,0,0,1
"cg02987772",4,0,0,0,4
"cg02987832",0,0,1,0,1
"cg02987888",0,2,0,0,2
"cg02988422",1,2,0,0,3
"cg02988513",0,0,1,0,1
"cg02989230",142,12,0,2,156
"cg02989435",1,0,0,0,1
"cg02989510",0,0,1,0,1
"cg02989828",0,1,0,0,1
"cg02990147",0,1,0,0,1
"cg02990553",1,0,0,0,1
"cg02990742",1,0,0,0,1
"cg02991699",269,12,0,0,281
"cg02993013",145,52,7,0,204
"cg02994009",0,0,1,0,1
"cg02995567",1,0,0,0,1
"cg02995851",0,1,0,0,1
"cg02996355",0,0,4,0,4
"cg02997392",1,0,0,0,1
"cg02997605",42,15,1,0,58
"cg02998155",241,69,10,0,320
"cg02998333",0,2,0,0,2
"cg02998425",0,1,0,0,1
"cg02998613",2,0,0,0,2
"cg03001466",2,0,0,0,2
"cg03002267",0,0,1,0,1
"cg03003155",4,3,1,0,8
"cg03003533",0,1,0,0,1
"cg03004222",1,0,0,0,1
"cg03004249",33,15,0,0,48
"cg03005310",0,1,4,0,5
"cg03005733",1,0,0,0,1
"cg03006175",4,3,1,0,8
"cg03006531",198,146,13,0,357
"cg03007380",4,0,0,0,4
"cg03008165",0,1,0,0,1
"cg03009233",0,1,0,0,1
"cg03009437",2,0,0,0,2
"cg03012728",1,0,0,0,1
"cg03012854",0,1,2,0,3
"cg03013488",0,1,1,0,2
"cg03013659",1,0,0,0,1
"cg03014011",4,8,1,0,13
"cg03014969",9,1,0,0,10
"cg03016985",1,1,1,0,3
"cg03017195",0,1,0,0,1
"cg03017475",4,0,0,0,4
"cg03017824",4,1,0,0,5
"cg03017953",0,0,1,0,1
"cg03019046",0,0,1,0,1
"cg03019360",3,1,0,0,4
"cg03019812",1,0,1,0,2
"cg03021829",1,0,1,0,2
"cg03022934",8,4,0,0,12
"cg03024693",19,2,1,0,22
"cg03025115",0,0,1,0,1
"cg03025463",0,1,2,0,3
"cg03025569",0,1,0,0,1
"cg03026011",0,1,0,0,1
"cg03028031",0,0,2,0,2
"cg03028685",0,0,1,0,1
"cg03030433",0,4,2,0,6
"cg03031032",0,0,1,0,1
"cg03031322",3,0,0,0,3
"cg03032015",1,8,0,0,9
"cg03032620",1,0,0,0,1
"cg03032659",1,0,0,0,1
"cg03033030",1,0,0,0,1
"cg03033780",2,0,0,0,2
"cg03034172",0,1,0,0,1
"cg03035628",0,0,2,0,2
"cg03035826",1,0,0,0,1
"cg03035873",1,0,0,0,1
"cg03038791",12,1,0,0,13
"cg03039326",1,5,0,1,7
"cg03040165",40,0,1,0,41
"cg03041700",0,0,1,0,1
"cg03042396",14,17,16,0,47
"cg03042971",0,1,0,0,1
"cg03046239",1,0,0,0,1
"cg03046924",2,0,0,0,2
"cg03047171",0,0,10,0,10
"cg03047205",0,0,2,0,2
"cg03047278",0,0,1,0,1
"cg03047813",0,0,0,1,1
"cg03048064",0,0,0,1,1
"cg03048201",3,0,0,0,3
"cg03049125",0,1,1,0,2
"cg03049311",1,0,0,0,1
"cg03049568",1,0,0,0,1
"cg03051836",2,0,0,0,2
"cg03052162",1,0,0,0,1
"cg03053222",0,3,0,0,3
"cg03053575",0,1,0,0,1
"cg03053581",326,327,3,0,656
"cg03053597",0,0,1,0,1
"cg03054343",0,1,0,0,1
"cg03054424",0,0,2,0,2
"cg03054643",0,1,0,0,1
"cg03054831",22,37,6,0,65
"cg03055837",0,0,1,0,1
"cg03056129",33,8,0,0,41
"cg03057951",0,1,0,0,1
"cg03058466",0,2,0,0,2
"cg03059234",0,0,1,0,1
"cg03059287",29,24,1,0,54
"cg03060175",44,1,0,0,45
"cg03060603",0,0,2,0,2
"cg03060963",0,0,1,0,1
"cg03061237",712,56,0,0,768
"cg03062329",0,0,3,0,3
"cg03062544",0,0,1,0,1
"cg03062549",0,0,1,0,1
"cg03062952",183,8,0,0,191
"cg03064228",1,3,0,0,4
"cg03065563",5,0,0,0,5
"cg03065838",1,6,5,0,12
"cg03065888",5,4,0,0,9
"cg03067192",0,0,1,0,1
"cg03067666",0,1,0,0,1
"cg03067828",1,5,7,0,13
"cg03068646",0,1,0,0,1
"cg03068687",13,2,0,0,15
"cg03069067",0,0,1,0,1
"cg03070550",1,0,0,0,1
"cg03070826",0,1,0,0,1
"cg03071530",5,3,0,0,8
"cg03071924",1,0,0,0,1
"cg03072998",0,0,1,0,1
"cg03073691",0,1,0,0,1
"cg03075244",2,7,1,0,10
"cg03078586",1,1,0,0,2
"cg03079841",4,8,3,0,15
"cg03080105",27,2,0,0,29
"cg03080344",0,1,0,0,1
"cg03080393",10,18,5,0,33
"cg03081359",0,0,26,0,26
"cg03081371",0,4,17,0,21
"cg03082114",24,1,0,0,25
"cg03082821",0,0,1,0,1
"cg03083386",0,2,0,0,2
"cg03083790",22,2,0,0,24
"cg03083853",15,1,0,0,16
"cg03084119",0,1,0,0,1
"cg03085084",22,1,0,0,23
"cg03085377",1,0,0,0,1
"cg03085859",3,3,0,0,6
"cg03085932",1,0,0,0,1
"cg03086899",0,0,1,0,1
"cg03087507",1,1,0,0,2
"cg03087622",9,2,0,0,11
"cg03088332",1,1,0,0,2
"cg03089870",2,3,0,0,5
"cg03090284",1,0,0,0,1
"cg03090980",0,0,1,0,1
"cg03091374",0,2,0,0,2
"cg03091776",0,0,1,0,1
"cg03093345",1,0,0,0,1
"cg03093949",11,1,1,0,13
"cg03094377",8,8,0,0,16
"cg03094955",0,0,1,0,1
"cg03095288",1,0,0,0,1
"cg03095612",0,1,0,0,1
"cg03096270",1,0,2,0,3
"cg03096286",1,0,0,0,1
"cg03096746",1,1,0,0,2
"cg03097169",0,0,1,0,1
"cg03098375",0,1,0,0,1
"cg03098837",1,1,0,0,2
"cg03099683",0,3,8,0,11
"cg03099849",0,0,1,0,1
"cg03100203",1,0,0,0,1
"cg03101324",152,2,0,0,154
"cg03102548",4,5,0,0,9
"cg03102729",0,1,0,0,1
"cg03103952",3,3,0,0,6
"cg03104055",0,3,0,1,4
"cg03105473",4,1,0,0,5
"cg03105681",0,1,2,0,3
"cg03105929",0,1,0,0,1
"cg03107817",13,0,0,0,13
"cg03107920",0,1,0,0,1
"cg03108826",1,0,0,0,1
"cg03109209",4,0,0,0,4
"cg03111039",0,1,0,0,1
"cg03112665",0,1,0,0,1
"cg03113231",796,428,14,0,1238
"cg03113740",19,0,0,0,19
"cg03114255",1,0,0,0,1
"cg03114668",1,7,2,0,10
"cg03115746",44,14,0,0,58
"cg03116250",3,3,15,0,21
"cg03116329",0,0,1,0,1
"cg03116676",2,0,1,0,3
"cg03116860",0,1,0,0,1
"cg03116939",0,0,2,0,2
"cg03117097",0,1,0,0,1
"cg03117900",0,0,2,0,2
"cg03118200",0,1,1,0,2
"cg03119450",0,0,1,0,1
"cg03119454",0,0,2,0,2
"cg03120522",1,0,0,0,1
"cg03121337",0,1,1,0,2
"cg03121844",0,1,0,0,1
"cg03122455",0,0,1,0,1
"cg03123862",51,2,0,0,53
"cg03125727",1,0,0,0,1
"cg03126708",0,0,2,0,2
"cg03126713",0,1,1,0,2
"cg03126791",0,1,2,0,3
"cg03127750",2,0,0,0,2
"cg03128614",248,32,0,0,280
"cg03130292",1,0,0,0,1
"cg03130891",0,1,2,0,3
"cg03130936",0,0,2,0,2
"cg03131155",0,0,1,0,1
"cg03131159",0,1,4,0,5
"cg03131527",1,0,0,0,1
"cg03132202",172,245,6,0,423
"cg03133266",0,1,0,0,1
"cg03133725",0,0,0,1,1
"cg03133777",0,0,1,0,1
"cg03133834",1,0,0,0,1
"cg03133920",8,3,0,0,11
"cg03134235",1,0,0,0,1
"cg03136863",0,0,1,0,1
"cg03137153",0,0,1,0,1
"cg03137908",0,0,1,0,1
"cg03139414",1,0,0,0,1
"cg03139576",12,0,0,0,12
"cg03139623",0,0,1,0,1
"cg03141895",0,0,1,0,1
"cg03141971",923,117,0,0,1040
"cg03142364",1,0,1,0,2
"cg03142393",0,0,1,0,1
"cg03142711",1,1,0,0,2
"cg03143168",2,3,1,0,6
"cg03144560",0,0,1,0,1
"cg03144715",151,32,1,0,184
"cg03145290",3,0,0,0,3
"cg03145583",4,2,0,0,6
"cg03145713",0,1,2,0,3
"cg03146162",2,0,0,0,2
"cg03146332",0,0,1,0,1
"cg03146951",177,59,2,0,238
"cg03146994",0,1,0,0,1
"cg03147815",0,0,1,0,1
"cg03148140",0,0,0,1,1
"cg03148554",1,0,0,0,1
"cg03149311",0,0,1,0,1
"cg03149560",0,3,1,0,4
"cg03149706",1,0,0,0,1
"cg03150378",0,0,1,0,1
"cg03150846",1,0,0,0,1
"cg03151540",0,2,0,0,2
"cg03152734",0,0,0,1,1
"cg03152870",1,0,0,0,1
"cg03153172",90,207,245,0,542
"cg03154213",1,0,0,0,1
"cg03155147",5,3,3,0,11
"cg03155455",0,0,1,0,1
"cg03156893",0,0,2,0,2
"cg03156948",1,0,0,0,1
"cg03157284",0,1,1,0,2
"cg03157588",0,0,1,0,1
"cg03157891",2,2,1,0,5
"cg03159189",1,0,0,0,1
"cg03160057",58,390,313,0,761
"cg03161410",0,1,0,0,1
"cg03162416",1,1,0,0,2
"cg03163116",33,7,0,0,40
"cg03163767",0,1,0,0,1
"cg03163860",0,2,0,0,2
"cg03164309",0,2,0,0,2
"cg03164626",0,0,1,0,1
"cg03165002",4,0,2,0,6
"cg03167415",0,0,2,0,2
"cg03167648",1,1,0,0,2
"cg03169131",2,0,0,0,2
"cg03169257",27,19,6,0,52
"cg03169647",1,0,1,0,2
"cg03169843",853,302,10,0,1165
"cg03170665",0,1,5,0,6
"cg03171611",8,11,0,0,19
"cg03171651",0,0,2,0,2
"cg03172717",1,0,0,0,1
"cg03172837",0,4,8,0,12
"cg03172971",4,7,0,0,11
"cg03173068",24,2,0,0,26
"cg03173713",0,1,1,0,2
"cg03174091",1,0,0,0,1
"cg03174275",15,1,0,0,16
"cg03174931",4,0,0,0,4
"cg03175854",29,12,1,0,42
"cg03176305",7,3,2,0,12
"cg03177444",178,269,12,0,459
"cg03178542",4,1,0,0,5
"cg03179043",0,0,1,0,1
"cg03179419",1,0,6,0,7
"cg03179447",1,0,0,0,1
"cg03179726",166,305,28,0,499
"cg03180042",0,1,1,0,2
"cg03181118",0,5,3,0,8
"cg03181314",1,0,2,0,3
"cg03181478",1,1,0,0,2
"cg03182374",0,1,0,0,1
"cg03182688",1,0,0,0,1
"cg03183745",100,25,5,0,130
"cg03184241",7,1,0,0,8
"cg03185579",3,0,0,0,3
"cg03185726",4,0,1,0,5
"cg03185975",112,21,2,0,135
"cg03186011",522,1023,101,0,1646
"cg03186157",8,0,0,0,8
"cg03186228",0,1,0,0,1
"cg03186367",8,0,0,0,8
"cg03186436",1,0,0,0,1
"cg03187777",0,0,0,1,1
"cg03187934",0,2,1,0,3
"cg03188080",2,4,0,0,6
"cg03188382",0,0,1,0,1
"cg03189227",0,0,1,0,1
"cg03189593",96,6,0,0,102
"cg03191384",16,0,0,0,16
"cg03191860",0,1,0,0,1
"cg03193096",1,0,0,0,1
"cg03193715",3,0,0,0,3
"cg03195031",8,13,2,0,23
"cg03195665",407,679,13,0,1099
"cg03195732",1,2,1,0,4
"cg03195930",2,0,0,0,2
"cg03197110",255,122,25,0,402
"cg03198176",0,0,1,0,1
"cg03198186",9,4,2,0,15
"cg03198368",0,0,1,0,1
"cg03199005",13,0,0,0,13
"cg03199084",31,0,0,0,31
"cg03199604",0,0,1,0,1
"cg03199644",1,0,0,0,1
"cg03199955",0,0,1,0,1
"cg03199983",229,117,10,0,356
"cg03200693",0,2,1,0,3
"cg03201165",1,0,0,0,1
"cg03201926",1,0,0,0,1
"cg03202266",1,0,0,0,1
"cg03202388",2,0,0,0,2
"cg03202402",0,0,1,0,1
"cg03202847",0,0,3,0,3
"cg03203294",0,0,2,0,2
"cg03203519",6,2,0,0,8
"cg03205010",16,1,0,0,17
"cg03206304",1,0,0,0,1
"cg03206401",0,0,1,0,1
"cg03207373",2,0,0,0,2
"cg03207536",0,0,1,0,1
"cg03208024",10,6,0,0,16
"cg03209267",0,1,0,0,1
"cg03209530",0,0,1,0,1
"cg03210218",5,1,1,0,7
"cg03210905",1,0,0,0,1
"cg03211092",1,0,0,0,1
"cg03211199",0,0,1,0,1
"cg03211843",0,1,0,0,1
"cg03211936",0,0,1,0,1
"cg03213877",0,0,2,0,2
"cg03214931",0,0,1,0,1
"cg03215858",2,0,0,0,2
"cg03215942",0,0,1,0,1
"cg03216698",0,2,0,0,2
"cg03217348",0,1,0,0,1
"cg03217800",12,2,13,0,27
"cg03218029",0,1,2,0,3
"cg03219922",1,0,0,0,1
"cg03220074",9,3,0,0,12
"cg03220660",1,0,0,0,1
"cg03221539",0,0,2,0,2
"cg03221619",0,0,1,0,1
"cg03221792",0,0,1,0,1
"cg03223221",0,1,0,0,1
"cg03223989",0,1,0,0,1
"cg03224792",0,0,1,0,1
"cg03225452",0,1,0,0,1
"cg03225546",1,2,3,0,6
"cg03226121",75,31,3,0,109
"cg03226599",83,4,0,0,87
"cg03227203",0,4,7,0,11
"cg03227437",0,0,1,0,1
"cg03227505",0,0,0,1,1
"cg03227783",0,2,0,0,2
"cg03228325",0,0,1,0,1
"cg03228385",0,0,1,0,1
"cg03229010",11,0,0,0,11
"cg03230579",0,0,0,1,1
"cg03231240",18,2,1,0,21
"cg03231437",0,0,2,0,2
"cg03233087",706,72,2,0,780
"cg03233224",323,150,12,0,485
"cg03233295",108,8,0,0,116
"cg03234702",1,1,0,0,2
"cg03234806",0,2,0,0,2
"cg03236118",7,7,1,0,15
"cg03236853",1,0,0,0,1
"cg03237806",0,1,0,0,1
"cg03238019",0,0,3,0,3
"cg03238340",17,11,13,1,42
"cg03238687",11,1,0,0,12
"cg03238709",8,0,0,0,8
"cg03239335",1,0,0,0,1
"cg03241282",0,4,1,0,5
"cg03241359",0,0,0,1,1
"cg03241430",3,0,0,0,3
"cg03242238",0,0,2,1,3
"cg03243683",1,0,2,0,3
"cg03243835",3,0,0,0,3
"cg03245111",2,0,2,0,4
"cg03246590",0,0,1,0,1
"cg03246704",0,1,0,0,1
"cg03246748",38,1,0,0,39
"cg03248483",0,1,0,0,1
"cg03248772",1,0,0,0,1
"cg03248970",0,1,0,0,1
"cg03249591",5,1,0,0,6
"cg03249993",0,2,0,0,2
"cg03251327",5,0,0,0,5
"cg03252278",12,2,0,0,14
"cg03252697",0,1,0,0,1
"cg03252709",2,1,0,0,3
"cg03255182",2,0,0,0,2
"cg03255678",0,2,1,0,3
"cg03255847",0,0,1,0,1
"cg03255922",1,0,0,0,1
"cg03256024",2,0,0,0,2
"cg03256053",6,7,0,0,13
"cg03256310",1,2,0,0,3
"cg03257423",0,1,0,0,1
"cg03258279",5,5,1,0,11
"cg03258315",0,1,0,0,1
"cg03258364",2,5,2,0,9
"cg03258577",0,0,2,0,2
"cg03259038",0,0,1,0,1
"cg03259207",0,0,1,0,1
"cg03259234",0,1,1,0,2
"cg03259243",0,1,0,0,1
"cg03260259",0,0,2,0,2
"cg03260574",0,1,1,0,2
"cg03261528",0,0,1,0,1
"cg03262260",0,0,1,0,1
"cg03263237",0,3,3,0,6
"cg03263543",1,0,0,0,1
"cg03264414",0,1,0,0,1
"cg03264585",1,0,0,0,1
"cg03266123",21,1,0,0,22
"cg03266200",0,0,1,0,1
"cg03267151",0,0,1,0,1
"cg03272020",17,21,84,0,122
"cg03272147",2,0,0,0,2
"cg03272958",112,321,276,0,709
"cg03274695",0,1,0,0,1
"cg03274876",1,0,0,0,1
"cg03275895",0,0,1,0,1
"cg03275946",1,0,0,0,1
"cg03277658",1,0,0,0,1
"cg03278407",2,2,3,0,7
"cg03278564",1,0,0,0,1
"cg03278795",0,0,1,0,1
"cg03278877",5,2,0,0,7
"cg03279185",5,10,4,0,19
"cg03280523",171,262,40,0,473
"cg03280759",46,7,2,0,55
"cg03281229",0,0,1,0,1
"cg03281682",1,0,0,0,1
"cg03281705",79,2,0,0,81
"cg03282153",0,2,1,0,3
"cg03282689",194,275,42,0,511
"cg03283464",0,2,1,0,3
"cg03284281",0,1,0,0,1
"cg03285039",1,0,0,0,1
"cg03285130",1,0,0,0,1
"cg03286037",1,0,0,0,1
"cg03287616",225,15,0,0,240
"cg03287929",1,0,0,0,1
"cg03288419",1,0,0,0,1
"cg03288512",0,0,1,1,2
"cg03288847",1,0,0,0,1
"cg03289750",2,1,1,0,4
"cg03289801",1,9,12,0,22
"cg03289899",0,0,1,0,1
"cg03290511",0,0,3,0,3
"cg03291865",0,1,0,0,1
"cg03292040",0,0,1,0,1
"cg03293158",1,0,0,0,1
"cg03294557",0,0,1,0,1
"cg03295956",2,0,1,0,3
"cg03298015",0,1,2,0,3
"cg03298800",1,0,0,0,1
"cg03298999",1,0,0,0,1
"cg03299095",1,0,0,0,1
"cg03299216",1,0,0,0,1
"cg03299531",0,0,1,0,1
"cg03300099",0,0,1,0,1
"cg03300268",0,0,2,0,2
"cg03300705",10,2,0,0,12
"cg03300898",0,1,2,0,3
"cg03301934",0,1,1,0,2
"cg03301976",2,11,0,0,13
"cg03302287",0,0,1,0,1
"cg03302811",0,0,1,0,1
"cg03304017",0,0,1,0,1
"cg03304528",1,0,0,0,1
"cg03308240",0,0,1,0,1
"cg03308881",328,27,0,0,355
"cg03309545",4,2,4,0,10
"cg03309758",1,1,0,0,2
"cg03310480",0,1,0,0,1
"cg03310517",0,0,2,0,2
"cg03310592",11,0,0,0,11
"cg03311682",1056,289,17,0,1362
"cg03311789",0,0,1,0,1
"cg03311836",2,1,0,0,3
"cg03313163",1,0,0,0,1
"cg03313643",0,0,2,0,2
"cg03315270",26,5,0,0,31
"cg03316030",10,0,0,0,10
"cg03316107",0,2,1,0,3
"cg03316243",17,0,0,0,17
"cg03316360",3,0,0,0,3
"cg03317430",0,1,0,0,1
"cg03318082",0,0,1,0,1
"cg03318222",123,608,13,0,744
"cg03318654",0,0,1,0,1
"cg03319865",1,0,0,0,1
"cg03320607",0,0,1,0,1
"cg03320844",0,0,1,0,1
"cg03323020",0,0,2,0,2
"cg03323695",1,0,1,0,2
"cg03325085",1,0,0,0,1
"cg03328265",4,2,2,0,8
"cg03328961",0,0,1,0,1
"cg03329052",0,2,11,1,14
"cg03329408",81,165,2,0,248
"cg03330071",0,0,2,0,2
"cg03330168",0,1,5,0,6
"cg03331224",0,0,1,0,1
"cg03332581",0,1,3,0,4
"cg03333361",1,3,0,0,4
"cg03333727",119,27,11,0,157
"cg03334473",0,1,0,0,1
"cg03334602",1,0,0,0,1
"cg03335262",4,1,1,0,6
"cg03335386",0,0,1,0,1
"cg03336272",5,0,0,0,5
"cg03338185",7,0,0,0,7
"cg03338691",4,0,0,0,4
"cg03339790",3,0,3,0,6
"cg03340338",2,2,0,0,4
"cg03342149",0,2,2,0,4
"cg03342174",0,0,3,0,3
"cg03342862",188,143,25,0,356
"cg03343515",0,1,0,0,1
"cg03344283",0,0,1,0,1
"cg03344484",0,3,5,0,8
"cg03344490",2,2,2,1,7
"cg03344608",32,54,9,0,95
"cg03344770",0,1,0,0,1
"cg03345206",0,2,0,0,2
"cg03345757",4,4,3,0,11
"cg03346179",0,1,0,0,1
"cg03346667",2,1,0,0,3
"cg03347215",0,0,1,0,1
"cg03347306",0,0,2,0,2
"cg03347381",1,0,5,0,6
"cg03348902",0,0,0,1,1
"cg03349173",174,5,0,0,179
"cg03349905",25,15,5,0,45
"cg03350017",1044,179,5,0,1228
"cg03352907",0,0,2,0,2
"cg03353000",0,1,0,0,1
"cg03353040",0,0,1,0,1
"cg03353474",21,2,0,0,23
"cg03353863",3,2,5,0,10
"cg03353889",0,0,2,0,2
"cg03355239",11,4,0,0,15
"cg03355241",1,12,5,0,18
"cg03355562",2,9,0,0,11
"cg03356493",0,2,0,0,2
"cg03356806",0,0,1,0,1
"cg03359043",0,5,1,0,6
"cg03360519",1,5,0,0,6
"cg03360716",1,1,0,0,2
"cg03361274",0,0,1,0,1
"cg03361548",0,0,1,0,1
"cg03361633",0,0,1,0,1
"cg03362209",1,0,0,0,1
"cg03362494",15,0,0,0,15
"cg03364150",0,1,0,0,1
"cg03366073",0,1,1,0,2
"cg03367349",0,0,1,0,1
"cg03367558",2,0,0,0,2
"cg03368665",1,1,0,0,2
"cg03370150",1,0,0,0,1
"cg03370391",6,1,0,0,7
"cg03371014",0,0,1,0,1
"cg03371783",2,0,0,0,2
"cg03371833",1,0,1,0,2
"cg03372353",24,13,0,0,37
"cg03373895",0,0,1,0,1
"cg03373960",79,2,0,0,81
"cg03374552",0,1,5,0,6
"cg03374865",0,0,1,0,1
"cg03375061",1,0,0,0,1
"cg03375635",1,0,0,0,1
"cg03375913",0,0,1,0,1
"cg03376497",3,6,0,0,9
"cg03377789",31,1,0,0,32
"cg03378720",4,0,0,0,4
"cg03379034",2,0,0,0,2
"cg03380430",0,1,0,0,1
"cg03380759",2,0,0,0,2
"cg03381237",1,0,0,0,1
"cg03381717",1,0,0,0,1
"cg03383789",2,2,8,0,12
"cg03384154",0,3,5,0,8
"cg03384892",0,0,1,0,1
"cg03385000",0,0,1,0,1
"cg03386347",1,0,0,0,1
"cg03386794",6,2,0,0,8
"cg03387050",3,0,0,0,3
"cg03388324",1,0,0,0,1
"cg03388431",0,0,1,0,1
"cg03388440",0,0,1,0,1
"cg03388569",2,0,1,0,3
"cg03388667",14,3,0,0,17
"cg03389217",1,0,0,0,1
"cg03389650",0,0,1,0,1
"cg03390760",0,0,2,0,2
"cg03391642",2,1,1,0,4
"cg03391813",2,0,0,0,2
"cg03391911",0,0,1,0,1
"cg03393267",0,0,0,1,1
"cg03393472",172,58,6,0,236
"cg03395495",0,1,2,0,3
"cg03395546",1,0,0,0,1
"cg03396060",3,2,0,0,5
"cg03396218",1,0,0,0,1
"cg03396325",57,11,1,0,69
"cg03397819",1,0,0,0,1
"cg03397923",1,0,0,0,1
"cg03398666",19,17,2,0,38
"cg03399898",0,2,2,0,4
"cg03399963",0,0,1,0,1
"cg03400264",0,0,1,0,1
"cg03400403",0,1,1,0,2
"cg03400512",257,276,28,0,561
"cg03400583",0,0,1,0,1
"cg03401477",106,7,0,0,113
"cg03402384",0,1,0,0,1
"cg03403081",0,3,0,0,3
"cg03403963",1,0,1,0,2
"cg03405491",0,1,0,0,1
"cg03406925",0,0,1,0,1
"cg03407622",19,0,0,0,19
"cg03407828",0,1,0,0,1
"cg03407889",0,1,1,0,2
"cg03409338",0,1,0,0,1
"cg03410097",684,48,1,0,733
"cg03410272",8,1,1,0,10
"cg03410407",4,1,6,0,11
"cg03410772",0,1,0,0,1
"cg03411341",0,5,0,0,5
"cg03413073",0,0,2,0,2
"cg03413134",0,0,1,0,1
"cg03415216",1,1,0,0,2
"cg03417272",2,2,0,0,4
"cg03417697",0,1,0,0,1
"cg03418095",72,33,4,0,109
"cg03418136",1,2,15,0,18
"cg03418237",0,1,0,0,1
"cg03418713",0,0,1,0,1
"cg03418835",0,2,0,0,2
"cg03418856",1,0,0,0,1
"cg03420881",3,1,0,0,4
"cg03421069",20,2,0,0,22
"cg03421616",11,3,0,0,14
"cg03422213",0,2,10,1,13
"cg03423638",1,0,0,0,1
"cg03423935",0,0,1,0,1
"cg03424505",0,0,1,0,1
"cg03425504",0,0,1,0,1
"cg03425700",0,1,1,0,2
"cg03425731",1,0,0,0,1
"cg03426342",0,1,0,0,1
"cg03426413",0,1,2,0,3
"cg03426470",0,0,1,0,1
"cg03426759",0,0,2,0,2
"cg03427771",0,0,1,0,1
"cg03428217",1,0,0,0,1
"cg03428951",0,0,2,0,2
"cg03429255",0,7,11,0,18
"cg03429785",0,2,0,0,2
"cg03431489",0,0,1,0,1
"cg03432151",0,1,0,0,1
"cg03433597",0,0,1,0,1
"cg03434128",0,1,0,0,1
"cg03434223",17,3,0,0,20
"cg03435771",1,0,0,0,1
"cg03436138",2,0,0,0,2
"cg03437666",2,0,0,0,2
"cg03438024",4,0,0,0,4
"cg03438101",1,0,0,0,1
"cg03438446",44,5,0,0,49
"cg03439105",0,0,1,0,1
"cg03439264",3,2,1,0,6
"cg03439324",0,1,0,0,1
"cg03439544",8,0,0,0,8
"cg03439587",0,1,4,0,5
"cg03439646",4,0,0,0,4
"cg03439898",7,2,5,0,14
"cg03440127",0,0,1,0,1
"cg03440221",84,23,1,0,108
"cg03440535",2,3,4,0,9
"cg03440891",0,0,1,0,1
"cg03441539",0,0,1,0,1
"cg03442103",0,0,1,1,2
"cg03442510",0,0,0,1,1
"cg03442863",0,0,1,0,1
"cg03444687",2,1,1,0,4
"cg03445191",1,0,0,0,1
"cg03445527",0,0,1,0,1
"cg03446092",13,2,0,0,15
"cg03446694",12,0,0,0,12
"cg03448626",0,1,4,0,5
"cg03450794",0,0,2,0,2
"cg03451586",0,1,0,0,1
"cg03452623",0,3,19,0,22
"cg03453333",0,0,4,0,4
"cg03453513",0,1,0,0,1
"cg03454364",1,2,3,0,6
"cg03454927",2,2,0,0,4
"cg03455137",1,0,0,0,1
"cg03457010",1,0,0,0,1
"cg03457062",0,0,1,0,1
"cg03457344",167,13,0,0,180
"cg03458633",1,0,0,0,1
"cg03458763",0,1,0,0,1
"cg03458836",3,0,0,0,3
"cg03460997",68,54,36,0,158
"cg03461361",234,291,49,0,574
"cg03462115",1,0,0,0,1
"cg03464136",0,0,1,0,1
"cg03464473",0,1,7,0,8
"cg03464560",1,0,0,0,1
"cg03465179",0,0,1,0,1
"cg03465714",2,0,0,0,2
"cg03466123",2,3,2,0,7
"cg03466598",0,0,1,0,1
"cg03466644",0,1,0,0,1
"cg03467079",0,0,1,1,2
"cg03468290",12,9,9,0,30
"cg03468397",0,0,1,0,1
"cg03468468",0,0,1,0,1
"cg03470514",3,1,0,0,4
"cg03471929",1,0,0,0,1
"cg03472514",1,4,1,0,6
"cg03473290",1,0,0,0,1
"cg03473821",3,0,0,0,3
"cg03473993",95,13,1,0,109
"cg03474461",211,8,0,0,219
"cg03474742",3,0,2,0,5
"cg03474937",1,0,0,0,1
"cg03475491",0,0,2,0,2
"cg03475788",0,0,1,0,1
"cg03475833",0,1,0,0,1
"cg03477302",0,0,1,0,1
"cg03477506",0,0,1,0,1
"cg03478070",1,0,0,0,1
"cg03478247",1,0,0,0,1
"cg03478330",1,0,0,0,1
"cg03478356",2,0,0,0,2
"cg03479491",22,10,1,0,33
"cg03480871",1,0,0,0,1
"cg03481158",2,0,0,0,2
"cg03481215",1,2,0,0,3
"cg03481658",0,0,1,0,1
"cg03481961",1,0,0,0,1
"cg03482074",0,0,1,0,1
"cg03483035",0,1,0,0,1
"cg03483046",0,1,0,0,1
"cg03487064",9,8,8,0,25
"cg03487611",0,0,1,0,1
"cg03488113",0,0,1,0,1
"cg03489642",14,32,16,0,62
"cg03490923",1,1,2,0,4
"cg03491980",194,32,0,0,226
"cg03492460",7,0,0,0,7
"cg03492641",0,0,2,0,2
"cg03493030",0,0,1,0,1
"cg03493087",0,1,0,0,1
"cg03493505",0,2,3,0,5
"cg03493513",114,5,0,0,119
"cg03494430",0,0,1,0,1
"cg03494828",0,0,1,0,1
"cg03495126",1,0,0,0,1
"cg03495350",0,1,0,0,1
"cg03495632",1,1,3,0,5
"cg03497133",0,0,1,0,1
"cg03497872",0,0,1,0,1
"cg03499257",0,0,1,0,1
"cg03499704",1,0,0,0,1
"cg03500117",18,6,1,0,25
"cg03500535",1,0,0,0,1
"cg03500547",10,0,0,0,10
"cg03500585",2,5,1,0,8
"cg03500977",0,0,1,0,1
"cg03501204",147,1,0,0,148
"cg03503122",634,60,1,0,695
"cg03503812",15,1,0,0,16
"cg03504446",1,0,0,0,1
"cg03505125",1,0,0,0,1
"cg03505448",0,1,0,0,1
"cg03505616",1,0,0,0,1
"cg03505772",0,0,1,0,1
"cg03506134",1,0,0,0,1
"cg03506428",0,0,1,0,1
"cg03506916",2,0,0,0,2
"cg03507085",1,0,0,0,1
"cg03507875",0,1,0,0,1
"cg03508348",0,1,0,0,1
"cg03509467",0,0,1,0,1
"cg03511173",3,16,0,0,19
"cg03511692",1,1,0,0,2
"cg03511766",234,338,62,0,634
"cg03511982",1,0,0,0,1
"cg03512577",0,0,1,0,1
"cg03513387",0,1,0,0,1
"cg03513482",354,72,1,0,427
"cg03515816",0,10,1,0,11
"cg03515901",0,0,1,0,1
"cg03516394",195,23,1,0,219
"cg03516636",316,428,18,0,762
"cg03516663",0,1,0,0,1
"cg03517311",1,0,0,0,1
"cg03517849",0,1,0,0,1
"cg03518493",3,0,0,0,3
"cg03519138",0,0,1,0,1
"cg03520265",1,0,0,0,1
"cg03520496",4,0,0,0,4
"cg03520542",0,2,0,0,2
"cg03521775",0,0,4,0,4
"cg03522020",0,0,1,0,1
"cg03522837",0,3,3,0,6
"cg03523522",0,0,1,0,1
"cg03523524",0,0,1,0,1
"cg03524848",0,0,1,0,1
"cg03524996",0,0,1,0,1
"cg03525266",0,0,2,0,2
"cg03525847",166,338,77,0,581
"cg03525852",0,0,1,0,1
"cg03526614",2,0,1,0,3
"cg03528016",0,0,1,0,1
"cg03529195",0,0,1,0,1
"cg03529641",124,365,43,0,532
"cg03530393",4,0,0,0,4
"cg03530721",0,0,1,0,1
"cg03531177",3,1,1,0,5
"cg03532005",0,0,1,0,1
"cg03533051",0,0,1,0,1
"cg03533091",6,15,11,0,32
"cg03533151",3,2,7,0,12
"cg03533355",1,1,0,0,2
"cg03533632",2,0,0,0,2
"cg03533702",0,0,1,0,1
"cg03533881",0,0,1,0,1
"cg03534008",1,2,4,0,7
"cg03534542",0,0,4,0,4
"cg03534746",0,0,0,1,1
"cg03535417",0,0,8,0,8
"cg03535559",0,1,0,0,1
"cg03536465",72,15,1,0,88
"cg03536632",0,1,0,0,1
"cg03536686",1,0,1,0,2
"cg03536898",6,0,0,0,6
"cg03537595",0,1,0,0,1
"cg03537740",0,1,0,0,1
"cg03538169",1,0,0,0,1
"cg03538221",0,2,0,0,2
"cg03538787",7,1,0,0,8
"cg03539808",1,0,0,0,1
"cg03540894",0,0,0,1,1
"cg03541799",4,0,0,0,4
"cg03541864",2,1,0,0,3
"cg03541952",0,2,0,0,2
"cg03542003",0,1,0,0,1
"cg03542754",0,3,0,0,3
"cg03542788",15,2,0,0,17
"cg03543533",0,1,1,0,2
"cg03544399",263,196,23,0,482
"cg03544445",4,0,0,0,4
"cg03546619",1,0,0,0,1
"cg03547800",2,0,0,0,2
"cg03547809",0,1,0,0,1
"cg03551051",11,0,0,0,11
"cg03551406",1,0,0,0,1
"cg03552472",0,0,1,0,1
"cg03552804",0,0,2,0,2
"cg03553246",0,1,0,0,1
"cg03553404",1,0,0,0,1
"cg03554069",1,0,0,0,1
"cg03554431",0,0,2,0,2
"cg03554660",1,0,0,0,1
"cg03554878",5,0,0,0,5
"cg03555811",1,0,0,0,1
"cg03555836",0,1,0,0,1
"cg03556020",0,3,0,0,3
"cg03556366",17,2,1,0,20
"cg03556986",5,0,0,0,5
"cg03557835",9,1,0,0,10
"cg03557897",1,0,0,0,1
"cg03558269",0,0,1,0,1
"cg03558326",1,0,0,0,1
"cg03558873",1,0,0,0,1
"cg03560861",2,0,1,0,3
"cg03560936",40,0,0,0,40
"cg03561276",1,0,0,0,1
"cg03562350",1,0,0,0,1
"cg03562791",0,1,0,0,1
"cg03563307",0,0,1,0,1
"cg03564405",1,1,0,0,2
"cg03564497",0,0,1,0,1
"cg03565539",8,1,0,0,9
"cg03566142",1,0,0,0,1
"cg03566191",1,0,0,0,1
"cg03567106",270,11,0,0,281
"cg03567151",0,0,2,0,2
"cg03567199",12,0,0,0,12
"cg03567814",18,4,9,0,31
"cg03568622",0,0,1,0,1
"cg03569285",0,6,0,0,6
"cg03570279",3,0,0,0,3
"cg03571344",14,18,2,0,34
"cg03572700",0,0,1,0,1
"cg03573109",3,1,0,0,4
"cg03573683",2,0,0,0,2
"cg03574471",24,3,0,0,27
"cg03574712",6,18,7,0,31
"cg03575380",0,0,1,0,1
"cg03575489",0,0,1,0,1
"cg03575854",2,0,0,0,2
"cg03575974",0,1,0,0,1
"cg03576716",18,1,1,0,20
"cg03576863",47,2,0,0,49
"cg03578552",145,94,2,0,241
"cg03579551",1,2,2,0,5
"cg03579624",0,0,0,1,1
"cg03579885",3,7,13,0,23
"cg03580759",0,0,4,0,4
"cg03581801",0,1,0,0,1
"cg03582691",2,0,0,0,2
"cg03582982",242,273,55,0,570
"cg03583311",1,0,0,0,1
"cg03583841",1,0,0,0,1
"cg03584683",11,0,0,0,11
"cg03585211",3,5,0,0,8
"cg03585822",4,0,0,0,4
"cg03585823",2,1,0,0,3
"cg03586127",150,247,9,0,406
"cg03588189",0,1,0,0,1
"cg03588460",0,0,1,0,1
"cg03588707",0,0,1,0,1
"cg03589733",68,1,0,0,69
"cg03590418",0,0,1,0,1
"cg03590545",1,0,0,0,1
"cg03592166",3,0,2,0,5
"cg03592654",0,1,0,0,1
"cg03593791",0,0,0,2,2
"cg03594447",1,0,2,0,3
"cg03595083",0,1,0,0,1
"cg03595383",3,0,0,0,3
"cg03595540",298,764,15,0,1077
"cg03596320",1,0,0,0,1
"cg03597068",4,6,0,0,10
"cg03597463",0,0,1,0,1
"cg03597525",0,0,2,0,2
"cg03598021",0,1,0,0,1
"cg03598122",0,0,2,0,2
"cg03598287",134,175,18,0,327
"cg03598498",3,0,2,0,5
"cg03598513",2,0,0,0,2
"cg03598919",0,1,0,0,1
"cg03599600",0,1,0,0,1
"cg03600195",1,0,0,0,1
"cg03601322",2,6,0,0,8
"cg03601368",329,1329,143,0,1801
"cg03602162",2,0,0,0,2
"cg03602215",1,0,0,0,1
"cg03603114",0,0,1,0,1
"cg03603296",0,0,2,0,2
"cg03605117",27,10,1,0,38
"cg03606093",152,392,176,0,720
"cg03606333",24,6,0,0,30
"cg03607071",0,3,3,0,6
"cg03607170",0,0,1,0,1
"cg03607327",0,0,1,0,1
"cg03607916",0,0,1,0,1
"cg03608712",0,0,1,0,1
"cg03609398",0,2,2,0,4
"cg03609614",0,1,0,0,1
"cg03610168",1,0,0,0,1
"cg03610323",151,294,30,0,475
"cg03611536",0,0,1,0,1
"cg03611733",60,322,232,0,614
"cg03612017",1,2,1,0,4
"cg03612445",0,1,0,0,1
"cg03612452",0,1,1,0,2
"cg03612700",0,1,6,0,7
"cg03612765",1,0,0,0,1
"cg03613455",2,1,0,0,3
"cg03613782",1,0,0,0,1
"cg03615605",0,0,1,0,1
"cg03616559",0,0,1,0,1
"cg03617106",3,0,0,0,3
"cg03617314",1,0,0,0,1
"cg03617465",1,0,0,0,1
"cg03619051",4,0,0,0,4
"cg03620559",1,2,10,0,13
"cg03620600",7,0,0,0,7
"cg03621799",0,1,0,0,1
"cg03622142",4,1,0,0,5
"cg03622199",0,0,3,0,3
"cg03623097",10,1,0,0,11
"cg03623288",22,1,0,0,23
"cg03623837",11,3,10,0,24
"cg03623968",1,0,0,0,1
"cg03624576",0,2,0,0,2
"cg03625285",0,1,0,0,1
"cg03625762",0,0,1,0,1
"cg03625947",13,0,0,0,13
"cg03627705",1,0,0,0,1
"cg03627944",11,0,0,0,11
"cg03628349",0,0,2,0,2
"cg03628374",242,131,3,0,376
"cg03629907",95,3,0,0,98
"cg03630056",0,1,0,0,1
"cg03631064",9,4,1,0,14
"cg03631455",0,2,12,0,14
"cg03632289",19,12,1,0,32
"cg03632308",0,0,1,0,1
"cg03632935",0,6,0,0,6
"cg03633803",0,0,4,0,4
"cg03634234",0,0,1,0,1
"cg03634394",0,1,0,0,1
"cg03634397",1,1,0,0,2
"cg03636916",0,0,1,0,1
"cg03637019",1,0,0,0,1
"cg03637559",1,0,0,0,1
"cg03637821",0,1,0,0,1
"cg03638088",1,0,0,0,1
"cg03638211",0,0,1,0,1
"cg03638432",2,0,0,0,2
"cg03638453",0,8,0,0,8
"cg03639749",0,0,0,1,1
"cg03640215",0,0,1,0,1
"cg03640293",0,0,1,0,1
"cg03640565",1,1,0,0,2
"cg03640807",0,0,2,0,2
"cg03644703",3,0,0,0,3
"cg03644884",2,0,0,0,2
"cg03645061",0,0,1,0,1
"cg03646297",3,1,5,0,9
"cg03647317",1,2,15,0,18
"cg03647367",0,1,0,0,1
"cg03647452",227,70,4,0,301
"cg03648636",0,0,1,0,1
"cg03649470",0,0,1,0,1
"cg03650068",0,0,1,0,1
"cg03650294",12,0,0,0,12
"cg03651182",2,0,0,0,2
"cg03651416",0,1,0,0,1
"cg03651973",0,0,3,0,3
"cg03652595",0,0,2,0,2
"cg03653377",0,0,4,0,4
"cg03653845",130,7,0,0,137
"cg03654106",0,0,6,0,6
"cg03655147",9,1,0,0,10
"cg03656877",3,0,0,0,3
"cg03657549",0,0,1,0,1
"cg03658235",0,0,1,0,1
"cg03658699",905,94,2,0,1001
"cg03658982",11,7,0,0,18
"cg03659851",0,3,0,0,3
"cg03659854",6,0,1,0,7
"cg03660606",1,1,2,0,4
"cg03661019",0,2,0,0,2
"cg03661752",0,0,2,0,2
"cg03661876",0,1,1,0,2
"cg03662302",0,1,0,0,1
"cg03663072",42,37,34,0,113
"cg03663137",0,0,1,0,1
"cg03664585",6,0,0,0,6
"cg03664776",1,0,0,0,1
"cg03664992",1,0,0,0,1
"cg03665249",7,1,0,0,8
"cg03665457",0,0,1,0,1
"cg03665832",0,1,0,0,1
"cg03666506",0,0,1,0,1
"cg03667086",1,0,0,0,1
"cg03668399",4,0,0,0,4
"cg03668558",0,0,1,0,1
"cg03668629",1,2,0,0,3
"cg03668687",0,1,1,0,2
"cg03669037",1,0,0,0,1
"cg03670773",49,2,0,0,51
"cg03671148",0,1,4,0,5
"cg03672284",0,1,1,0,2
"cg03672499",1,1,0,0,2
"cg03672679",1,0,0,0,1
"cg03672716",0,6,0,1,7
"cg03673295",0,0,2,0,2
"cg03673671",0,0,1,0,1
"cg03674663",126,106,6,0,238
"cg03675307",4,0,0,0,4
"cg03675348",1,1,0,0,2
"cg03676257",0,1,1,0,2
"cg03677596",0,3,5,0,8
"cg03678340",0,1,1,0,2
"cg03678938",0,1,0,0,1
"cg03679581",0,0,1,0,1
"cg03679734",0,0,1,0,1
"cg03680769",2,0,0,0,2
"cg03681405",6,0,0,0,6
"cg03681544",1,3,3,0,7
"cg03681561",5,1,0,0,6
"cg03682192",0,1,0,0,1
"cg03682421",1,0,0,0,1
"cg03683984",0,1,0,0,1
"cg03684352",3,0,0,0,3
"cg03684644",0,0,1,0,1
"cg03686088",0,0,1,0,1
"cg03686228",1,0,0,0,1
"cg03686950",0,2,0,0,2
"cg03687894",0,4,0,0,4
"cg03688085",1,0,0,0,1
"cg03689656",4,2,0,0,6
"cg03690763",0,3,13,0,16
"cg03692412",1,0,0,0,1
"cg03693197",0,0,6,0,6
"cg03693403",2,0,0,0,2
"cg03693553",0,0,1,0,1
"cg03694243",1,0,0,0,1
"cg03694293",0,0,1,0,1
"cg03694517",384,21,0,0,405
"cg03694795",98,22,0,0,120
"cg03695739",0,1,0,0,1
"cg03695756",0,1,6,0,7
"cg03695909",2,2,0,0,4
"cg03696126",5,1,0,0,6
"cg03697076",0,0,0,1,1
"cg03698372",0,0,1,0,1
"cg03698666",7,0,0,0,7
"cg03698741",1,0,0,0,1
"cg03699196",39,3,0,0,42
"cg03699393",1,0,0,0,1
"cg03699426",2,0,0,0,2
"cg03700344",0,1,0,0,1
"cg03701884",360,889,111,0,1360
"cg03702043",0,3,0,0,3
"cg03702117",1,0,0,0,1
"cg03702299",1,2,0,0,3
"cg03702392",0,0,1,0,1
"cg03702965",60,97,57,0,214
"cg03703402",1,1,0,0,2
"cg03703977",244,37,1,0,282
"cg03704667",0,1,0,0,1
"cg03704894",2,0,0,0,2
"cg03705405",0,1,0,0,1
"cg03705718",0,0,1,0,1
"cg03706273",1,0,0,0,1
"cg03706395",1,2,8,0,11
"cg03706826",0,0,1,0,1
"cg03706855",1,0,0,0,1
"cg03707374",234,28,2,0,264
"cg03708014",1,0,0,0,1
"cg03708787",0,2,0,0,2
"cg03708877",1,0,0,0,1
"cg03709291",0,0,1,0,1
"cg03710705",0,0,1,0,1
"cg03711050",4,3,0,0,7
"cg03711562",0,0,1,0,1
"cg03712061",6,0,0,0,6
"cg03712442",1,6,12,0,19
"cg03712487",0,0,1,0,1
"cg03712823",0,1,0,0,1
"cg03713201",1,0,1,0,2
"cg03713826",26,1,0,0,27
"cg03713849",2,0,3,0,5
"cg03714504",10,1,0,0,11
"cg03716045",1,0,0,0,1
"cg03716582",0,0,3,0,3
"cg03716738",0,1,4,0,5
"cg03718042",246,56,4,0,306
"cg03718050",0,0,1,0,1
"cg03718414",0,0,1,0,1
"cg03718853",0,1,0,0,1
"cg03720854",0,0,1,0,1
"cg03720898",32,5,0,0,37
"cg03721045",1,0,0,0,1
"cg03722425",0,0,1,0,1
"cg03722709",12,2,0,0,14
"cg03722812",0,0,1,0,1
"cg03723787",0,4,1,0,5
"cg03724299",0,1,0,0,1
"cg03724782",0,1,0,0,1
"cg03724794",1,0,0,0,1
"cg03725064",414,38,1,0,453
"cg03725115",3,4,0,0,7
"cg03725134",0,3,0,0,3
"cg03726004",19,1,0,0,20
"cg03726791",1,0,1,0,2
"cg03727341",4,0,0,0,4
"cg03727662",15,2,0,0,17
"cg03728197",0,1,0,0,1
"cg03729035",8,7,0,0,15
"cg03729265",1,1,0,0,2
"cg03729455",0,0,1,0,1
"cg03729462",4,2,2,0,8
"cg03730137",3,1,0,0,4
"cg03730280",113,7,0,0,120
"cg03730314",0,1,0,0,1
"cg03731473",0,0,1,0,1
"cg03731727",1,0,0,0,1
"cg03732118",0,0,2,0,2
"cg03732447",12,5,0,0,17
"cg03732638",0,1,1,0,2
"cg03732753",0,1,1,0,2
"cg03735077",0,1,0,0,1
"cg03736201",97,6,0,0,103
"cg03736919",4,2,3,0,9
"cg03736928",0,0,1,0,1
"cg03737209",923,109,2,0,1034
"cg03737788",0,2,0,0,2
"cg03738365",31,8,0,0,39
"cg03738389",1,0,0,0,1
"cg03739382",0,1,0,0,1
"cg03740169",14,11,1,0,26
"cg03740682",13,3,0,0,16
"cg03742551",1,0,0,0,1
"cg03742947",0,1,0,0,1
"cg03743096",0,0,1,0,1
"cg03745414",0,0,1,0,1
"cg03746115",0,0,1,0,1
"cg03746126",0,1,0,0,1
"cg03746136",17,0,0,0,17
"cg03746159",0,0,1,0,1
"cg03746482",0,3,0,0,3
"cg03746520",1,1,0,0,2
"cg03747513",0,2,0,0,2
"cg03747805",16,0,0,0,16
"cg03749599",0,2,0,0,2
"cg03749917",19,3,0,0,22
"cg03750084",0,5,2,0,7
"cg03751734",314,137,2,0,453
"cg03751816",0,1,0,0,1
"cg03751829",0,1,0,0,1
"cg03751973",0,0,4,0,4
"cg03752386",0,1,0,0,1
"cg03753099",14,1,0,0,15
"cg03753817",1,0,0,0,1
"cg03754000",9,0,0,0,9
"cg03754989",0,0,1,0,1
"cg03755702",0,0,1,0,1
"cg03756171",0,1,0,0,1
"cg03757017",0,2,0,0,2
"cg03757398",0,0,1,0,1
"cg03757653",0,1,0,0,1
"cg03757730",8,13,7,0,28
"cg03757938",0,6,6,0,12
"cg03758761",2,0,1,0,3
"cg03760158",548,693,5,0,1246
"cg03760226",0,1,0,0,1
"cg03760336",0,1,0,0,1
"cg03761810",0,2,0,0,2
"cg03761815",0,0,1,0,1
"cg03762258",21,0,0,0,21
"cg03762349",2,1,0,0,3
"cg03762771",0,1,3,0,4
"cg03763942",0,0,1,0,1
"cg03764088",2,0,0,0,2
"cg03764959",1,2,1,0,4
"cg03765260",31,2,0,0,33
"cg03766753",0,0,1,0,1
"cg03767562",45,2,0,0,47
"cg03768400",0,0,1,0,1
"cg03768717",0,0,1,0,1
"cg03769492",0,1,0,0,1
"cg03770710",12,0,0,0,12
"cg03770877",0,0,4,0,4
"cg03771512",0,0,1,0,1
"cg03772165",1,0,0,0,1
"cg03772227",1,0,0,0,1
"cg03773163",0,1,2,0,3
"cg03773196",0,0,1,0,1
"cg03773869",3,0,0,0,3
"cg03774040",0,0,1,0,1
"cg03774704",1,0,0,0,1
"cg03776850",0,2,0,0,2
"cg03776935",0,0,1,0,1
"cg03779499",0,6,2,0,8
"cg03780264",0,1,1,0,2
"cg03780426",1,0,0,0,1
"cg03781452",19,1,0,0,20
"cg03781688",3,0,0,0,3
"cg03781861",1,2,0,0,3
"cg03782074",1,0,0,0,1
"cg03782437",1,0,1,0,2
"cg03783284",1,0,0,0,1
"cg03783948",1,0,0,0,1
"cg03784055",0,0,1,0,1
"cg03784353",1,0,2,0,3
"cg03787744",0,0,1,0,1
"cg03788504",0,1,0,0,1
"cg03788995",1,0,0,0,1
"cg03789601",2,4,0,0,6
"cg03789791",0,0,1,0,1
"cg03792296",0,0,1,0,1
"cg03792876",0,0,2,0,2
"cg03793486",52,28,3,0,83
"cg03793551",1,1,0,0,2
"cg03794219",8,6,4,0,18
"cg03794288",0,0,3,0,3
"cg03794346",0,0,1,0,1
"cg03794522",0,1,0,0,1
"cg03794590",0,0,1,0,1
"cg03795157",0,0,0,1,1
"cg03796122",234,296,4,0,534
"cg03797305",0,0,1,0,1
"cg03797593",1,0,0,0,1
"cg03799333",5,0,0,0,5
"cg03800588",43,10,3,0,56
"cg03800648",0,0,1,0,1
"cg03800797",1,0,0,0,1
"cg03801429",1,0,0,0,1
"cg03801613",0,0,1,0,1
"cg03801816",0,1,0,0,1
"cg03802352",7,1,0,0,8
"cg03802907",0,1,0,0,1
"cg03803150",2,16,0,0,18
"cg03803610",2,0,0,0,2
"cg03803701",0,1,0,0,1
"cg03804282",2,0,0,0,2
"cg03804556",148,15,0,0,163
"cg03804706",0,0,2,0,2
"cg03805126",16,0,0,0,16
"cg03805694",1,4,0,0,5
"cg03806211",44,0,0,0,44
"cg03807510",1,0,0,0,1
"cg03807919",1,4,0,0,5
"cg03808043",260,1,0,0,261
"cg03808981",0,1,1,0,2
"cg03809995",0,0,2,0,2
"cg03810219",1,1,1,0,3
"cg03811478",0,3,0,0,3
"cg03813153",0,0,1,0,1
"cg03813885",0,0,1,0,1
"cg03813951",0,0,3,0,3
"cg03814231",3,0,0,0,3
"cg03815456",0,0,1,0,1
"cg03815800",0,1,0,0,1
"cg03816081",0,0,1,0,1
"cg03816420",1,3,2,0,6
"cg03818021",0,1,0,0,1
"cg03818569",1,0,0,0,1
"cg03819869",1,0,0,0,1
"cg03820689",0,1,0,0,1
"cg03820986",2,0,0,0,2
"cg03822643",1,0,0,0,1
"cg03824562",1,1,0,0,2
"cg03825238",591,409,4,0,1004
"cg03825670",0,0,2,0,2
"cg03826587",0,0,1,0,1
"cg03826683",168,35,2,0,205
"cg03827298",0,6,0,0,6
"cg03827626",0,0,1,0,1
"cg03827813",3,1,0,0,4
"cg03828459",1,0,0,0,1
"cg03828745",2,0,1,0,3
"cg03829216",0,2,0,0,2
"cg03829464",1,0,1,0,2
"cg03830082",3,0,0,0,3
"cg03831047",1,0,0,0,1
"cg03831054",3,2,1,0,6
"cg03831856",0,1,0,0,1
"cg03832191",0,2,7,0,9
"cg03832220",1,0,0,0,1
"cg03832762",0,0,1,0,1
"cg03833060",0,0,1,0,1
"cg03833400",0,1,0,0,1
"cg03833512",10,0,0,0,10
"cg03834174",0,1,0,0,1
"cg03837032",194,479,64,0,737
"cg03837726",0,1,0,0,1
"cg03838062",1,0,0,0,1
"cg03838823",13,0,0,0,13
"cg03839382",0,0,1,0,1
"cg03839406",2,0,0,0,2
"cg03840351",1,3,1,0,5
"cg03840594",0,2,0,0,2
"cg03840908",3,2,0,0,5
"cg03841541",0,0,1,0,1
"cg03841781",0,2,0,0,2
"cg03842980",94,5,0,0,99
"cg03843022",0,0,1,0,1
"cg03843317",1,0,0,0,1
"cg03844506",1,3,0,0,4
"cg03844762",51,90,13,0,154
"cg03845870",1,0,0,0,1
"cg03847293",2,0,2,0,4
"cg03847716",0,0,1,0,1
"cg03847776",0,1,0,0,1
"cg03847924",17,4,1,0,22
"cg03848111",3,1,0,0,4
"cg03849262",2,5,1,0,8
"cg03850117",0,2,0,0,2
"cg03850597",8,11,6,0,25
"cg03850694",1,1,0,0,2
"cg03850937",226,90,5,0,321
"cg03851467",6,4,0,0,10
"cg03851508",2,0,0,0,2
"cg03851975",3,1,0,0,4
"cg03852468",0,0,3,1,4
"cg03852551",0,0,1,0,1
"cg03855436",1,0,0,0,1
"cg03855590",1,0,0,0,1
"cg03855659",0,0,1,0,1
"cg03856026",0,2,0,0,2
"cg03856389",2,0,0,0,2
"cg03856624",0,0,1,0,1
"cg03856714",1,0,0,0,1
"cg03857535",0,1,0,0,1
"cg03858152",3,3,1,0,7
"cg03858853",0,1,1,0,2
"cg03859106",156,181,1,0,338
"cg03859186",0,2,0,0,2
"cg03859282",16,5,0,0,21
"cg03859561",0,1,0,0,1
"cg03859733",1,0,0,0,1
"cg03860400",0,1,0,0,1
"cg03860530",0,1,0,0,1
"cg03861427",0,1,0,0,1
"cg03862120",4,0,0,0,4
"cg03862705",0,0,1,0,1
"cg03862760",0,0,1,0,1
"cg03863628",338,15,2,0,355
"cg03863700",1,0,0,0,1
"cg03863721",26,0,0,0,26
"cg03863979",140,14,0,0,154
"cg03864342",990,104,2,0,1096
"cg03865944",184,487,47,0,718
"cg03865947",9,2,0,0,11
"cg03866011",0,1,0,0,1
"cg03866982",0,0,1,0,1
"cg03868881",15,1,0,0,16
"cg03869508",0,0,1,0,1
"cg03869932",2,0,1,0,3
"cg03870360",0,2,0,0,2
"cg03870689",0,3,0,0,3
"cg03871162",1,0,0,0,1
"cg03871275",3,5,0,0,8
"cg03872598",0,1,5,0,6
"cg03875006",0,1,6,0,7
"cg03875082",0,0,5,0,5
"cg03876503",2,0,1,0,3
"cg03876616",5,1,0,0,6
"cg03876732",0,1,0,0,1
"cg03877070",21,7,1,0,29
"cg03877142",3,4,0,0,7
"cg03877948",1,0,0,0,1
"cg03879261",27,2,1,0,30
"cg03880785",5,0,0,0,5
"cg03880988",91,0,0,0,91
"cg03881524",1,0,0,0,1
"cg03883150",1,0,0,0,1
"cg03885020",0,1,0,0,1
"cg03885144",282,281,2,0,565
"cg03885247",0,1,14,0,15
"cg03885414",0,5,7,0,12
"cg03886242",0,1,0,0,1
"cg03886596",0,1,1,0,2
"cg03886823",1,0,0,0,1
"cg03886989",0,0,1,0,1
"cg03887417",0,0,1,0,1
"cg03887614",2,4,0,0,6
"cg03887676",0,4,2,0,6
"cg03887724",1,1,0,0,2
"cg03888185",1,0,0,0,1
"cg03888520",0,0,1,0,1
"cg03888843",0,0,1,0,1
"cg03889470",7,1,0,0,8
"cg03889742",0,1,0,0,1
"cg03890059",0,0,1,0,1
"cg03890730",1,0,2,0,3
"cg03890814",13,15,1,0,29
"cg03890840",7,0,0,0,7
"cg03890998",2,2,0,0,4
"cg03891050",1,0,0,0,1
"cg03891220",0,0,1,0,1
"cg03891652",0,1,1,0,2
"cg03891905",5,20,15,0,40
"cg03892203",7,0,0,0,7
"cg03893030",165,415,39,0,619
"cg03893333",58,1,0,0,59
"cg03893642",48,9,1,0,58
"cg03894892",0,0,1,0,1
"cg03895270",0,1,0,0,1
"cg03895289",0,0,1,0,1
"cg03895344",0,0,1,0,1
"cg03895880",0,1,0,0,1
"cg03896217",16,2,0,0,18
"cg03898229",1,0,0,0,1
"cg03898239",11,0,0,0,11
"cg03898302",0,1,0,0,1
"cg03898562",10,1,0,0,11
"cg03898962",1,0,0,0,1
"cg03898993",11,6,4,0,21
"cg03899708",0,2,0,0,2
"cg03900085",0,0,2,0,2
"cg03900446",0,3,2,0,5
"cg03900826",0,2,1,0,3
"cg03900861",0,1,0,0,1
"cg03900934",1,0,0,0,1
"cg03901777",37,0,0,0,37
"cg03902462",1,0,0,0,1
"cg03902905",719,654,11,0,1384
"cg03903094",1,0,1,0,2
"cg03903765",1,1,0,0,2
"cg03903988",0,1,0,0,1
"cg03904518",0,0,1,0,1
"cg03905547",7,0,0,0,7
"cg03905640",0,0,1,0,1
"cg03905986",1,1,0,0,2
"cg03906073",1,2,0,0,3
"cg03907698",1,0,0,0,1
"cg03907879",0,0,1,0,1
"cg03907995",2,0,0,0,2
"cg03908242",71,96,18,0,185
"cg03909086",0,4,4,2,10
"cg03909202",0,0,1,0,1
"cg03909284",454,111,2,0,567
"cg03909471",0,1,0,0,1
"cg03909504",0,2,0,0,2
"cg03909844",0,0,1,0,1
"cg03910582",0,0,1,0,1
"cg03911006",0,11,11,0,22
"cg03911306",0,0,4,0,4
"cg03912011",1,1,0,0,2
"cg03912609",0,1,0,0,1
"cg03913000",16,11,2,0,29
"cg03915738",0,1,0,0,1
"cg03916477",1,0,0,0,1
"cg03916783",0,1,0,0,1
"cg03917867",442,117,90,0,649
"cg03918255",0,2,0,0,2
"cg03918417",7,1,0,0,8
"cg03919242",1,1,0,0,2
"cg03919257",23,8,1,0,32
"cg03919419",26,1,0,0,27
"cg03919779",0,1,0,0,1
"cg03920566",0,1,0,0,1
"cg03921008",9,0,0,0,9
"cg03921823",5,7,14,0,26
"cg03923117",1,0,0,0,1
"cg03923878",1,0,0,0,1
"cg03924954",0,3,0,0,3
"cg03925208",0,1,2,0,3
"cg03925879",1,0,0,0,1
"cg03926968",7,1,0,0,8
"cg03927014",0,0,1,0,1
"cg03927472",2,1,0,0,3
"cg03929089",2,3,1,0,6
"cg03929761",2,0,0,0,2
"cg03929825",2,0,0,0,2
"cg03930849",0,0,2,0,2
"cg03931416",0,1,1,0,2
"cg03931739",1,1,0,0,2
"cg03932171",1,0,0,0,1
"cg03932453",1,0,0,0,1
"cg03933520",0,0,1,0,1
"cg03933786",330,83,1,0,414
"cg03934257",0,0,2,0,2
"cg03935072",84,10,1,0,95
"cg03935381",1,2,1,0,4
"cg03937214",0,0,2,0,2
"cg03937865",0,1,2,0,3
"cg03939087",1,0,0,0,1
"cg03939105",0,0,1,0,1
"cg03939762",0,1,0,0,1
"cg03940024",0,2,1,0,3
"cg03941975",0,0,1,0,1
"cg03942592",31,0,0,0,31
"cg03942643",0,1,0,0,1
"cg03943127",0,0,1,0,1
"cg03943293",6,2,5,0,13
"cg03944122",0,0,2,0,2
"cg03945693",0,1,0,0,1
"cg03946106",104,3,0,0,107
"cg03947350",0,2,0,0,2
"cg03948648",3,1,4,0,8
"cg03949031",0,3,0,0,3
"cg03949551",2,0,0,0,2
"cg03951180",2,0,0,0,2
"cg03952984",2,0,0,0,2
"cg03953077",0,4,0,0,4
"cg03953086",4,1,1,0,6
"cg03953305",0,1,0,2,3
"cg03954173",0,1,0,0,1
"cg03955354",0,1,0,0,1
"cg03956243",0,2,0,0,2
"cg03956267",0,1,0,0,1
"cg03956426",0,0,1,0,1
"cg03957420",4,0,0,0,4
"cg03958104",1,0,0,0,1
"cg03958705",1,3,0,0,4
"cg03958928",2,1,0,0,3
"cg03958956",0,0,1,0,1
"cg03959486",0,1,0,0,1
"cg03959625",0,0,4,0,4
"cg03960217",0,0,2,0,2
"cg03960701",0,2,0,0,2
"cg03960747",0,0,6,0,6
"cg03960936",0,0,1,0,1
"cg03961836",2,0,0,0,2
"cg03962178",2,1,3,0,6
"cg03962473",0,0,0,1,1
"cg03962558",0,1,3,0,4
"cg03962604",2,0,0,0,2
"cg03963784",141,172,101,0,414
"cg03963843",1,8,0,0,9
"cg03965414",646,27,1,0,674
"cg03966568",0,0,1,0,1
"cg03967418",8,5,0,0,13
"cg03967823",2,0,2,0,4
"cg03969305",1,1,0,0,2
"cg03970961",0,1,0,0,1
"cg03971484",1,2,12,0,15
"cg03971626",2,0,0,0,2
"cg03972852",9,2,0,0,11
"cg03973590",0,1,0,0,1
"cg03974275",61,28,5,0,94
"cg03974506",0,0,1,0,1
"cg03975135",0,0,1,0,1
"cg03976830",2,0,0,0,2
"cg03977083",0,1,0,0,1
"cg03977236",610,44,0,0,654
"cg03977295",0,1,0,0,1
"cg03977310",0,0,2,0,2
"cg03977696",1,0,0,0,1
"cg03977822",0,0,1,0,1
"cg03978137",2,0,0,0,2
"cg03978365",0,0,0,1,1
"cg03978761",5,0,0,0,5
"cg03978795",1,3,0,0,4
"cg03979149",1,1,2,0,4
"cg03979284",1,0,0,0,1
"cg03979695",0,1,0,0,1
"cg03980226",0,1,0,0,1
"cg03980764",0,0,1,0,1
"cg03982016",7,2,1,0,10
"cg03982998",6,1,0,0,7
"cg03983639",77,24,3,0,104
"cg03983684",9,0,0,0,9
"cg03983808",3,0,0,0,3
"cg03984295",1,0,2,0,3
"cg03984340",11,4,1,0,16
"cg03984750",1,6,1,0,8
"cg03985484",0,0,3,0,3
"cg03986311",0,1,0,0,1
"cg03986400",12,0,0,0,12
"cg03986973",12,0,0,0,12
"cg03987558",0,0,2,0,2
"cg03987573",80,9,0,0,89
"cg03987660",0,0,3,0,3
"cg03987813",0,0,4,0,4
"cg03987985",246,12,0,0,258
"cg03988952",1,2,0,0,3
"cg03989694",0,0,2,0,2
"cg03989876",0,1,0,0,1
"cg03989907",2,0,0,0,2
"cg03989959",0,0,0,2,2
"cg03990436",1,0,0,0,1
"cg03990879",1,0,0,0,1
"cg03991721",0,0,0,1,1
"cg03992052",1,1,0,0,2
"cg03992651",3,3,2,0,8
"cg03994617",1,0,0,0,1
"cg03995515",0,1,0,0,1
"cg03996098",183,275,170,0,628
"cg03996123",1,0,0,0,1
"cg03996670",1,0,0,0,1
"cg03997071",1,0,0,0,1
"cg03997232",0,1,0,0,1
"cg03997296",0,3,0,0,3
"cg03997755",1,0,0,0,1
"cg03997970",1,0,0,0,1
"cg03999583",1,0,1,0,2
"cg04000975",0,1,0,0,1
"cg04002203",22,15,0,0,37
"cg04002472",0,0,3,1,4
"cg04002935",60,9,0,0,69
"cg04004780",2,0,0,0,2
"cg04005334",1,0,1,0,2
"cg04006010",10,4,0,0,14
"cg04006206",167,47,4,0,218
"cg04006374",1,0,0,0,1
"cg04008601",0,0,1,0,1
"cg04009144",18,0,0,0,18
"cg04010325",14,19,8,0,41
"cg04010872",0,0,1,0,1
"cg04011253",0,0,1,0,1
"cg04011620",1,0,0,0,1
"cg04012282",0,1,0,0,1
"cg04012618",1,0,0,0,1
"cg04015177",0,5,5,0,10
"cg04015782",2,0,0,0,2
"cg04016144",2,8,0,0,10
"cg04016428",1,8,4,0,13
"cg04016765",1,0,0,0,1
"cg04016798",99,254,10,0,363
"cg04016992",1,0,0,0,1
"cg04017836",0,1,1,0,2
"cg04018668",0,0,1,0,1
"cg04019148",1,0,0,0,1
"cg04019371",11,4,0,0,15
"cg04019954",59,3,0,0,62
"cg04020115",427,12,0,0,439
"cg04021884",0,1,0,0,1
"cg04023335",0,0,1,0,1
"cg04023502",3,0,0,0,3
"cg04023663",2,3,2,0,7
"cg04023872",1,0,0,0,1
"cg04024413",0,1,0,0,1
"cg04025244",0,0,1,0,1
"cg04025307",7,1,6,0,14
"cg04025498",866,91,0,0,957
"cg04026763",63,58,1,0,122
"cg04026937",0,2,0,0,2
"cg04027757",1,0,6,0,7
"cg04027778",1,0,0,0,1
"cg04028541",0,1,0,0,1
"cg04028999",1,1,1,0,3
"cg04029134",2,1,0,0,3
"cg04029532",1,2,0,0,3
"cg04031354",52,198,6,0,256
"cg04031454",24,1,0,0,25
"cg04033650",1,0,0,0,1
"cg04033761",0,1,0,0,1
"cg04034441",1,0,0,0,1
"cg04034458",2,0,0,0,2
"cg04034517",2,0,0,0,2
"cg04034688",0,1,0,0,1
"cg04034846",0,0,1,0,1
"cg04035252",0,1,0,0,1
"cg04035953",3,2,3,0,8
"cg04036088",24,2,0,0,26
"cg04037649",0,0,1,0,1
"cg04037841",2,0,1,0,3
"cg04038601",0,0,2,0,2
"cg04039777",0,0,1,0,1
"cg04041159",0,1,0,0,1
"cg04041880",0,1,0,0,1
"cg04042800",55,14,0,0,69
"cg04043334",12,0,0,0,12
"cg04044564",2,3,0,0,5
"cg04044616",1,0,0,0,1
"cg04045436",0,2,0,0,2
"cg04046320",1,0,0,0,1
"cg04046420",0,0,1,0,1
"cg04047050",0,0,3,0,3
"cg04047355",1,0,0,0,1
"cg04047414",3,0,0,0,3
"cg04047663",6,3,0,0,9
"cg04048141",0,0,1,0,1
"cg04048218",0,1,0,0,1
"cg04048642",0,0,1,0,1
"cg04048775",12,0,0,0,12
"cg04048887",177,323,21,0,521
"cg04049102",1,0,0,0,1
"cg04049637",0,1,0,0,1
"cg04052606",1,0,0,0,1
"cg04052810",0,1,0,0,1
"cg04053763",1,0,0,0,1
"cg04054469",1,0,0,0,1
"cg04054982",2,0,0,0,2
"cg04056813",13,2,1,0,16
"cg04056966",10,2,0,0,12
"cg04057188",0,0,0,1,1
"cg04057469",0,1,0,0,1
"cg04058113",0,0,1,0,1
"cg04058177",1,0,0,0,1
"cg04060888",17,2,0,0,19
"cg04060904",19,4,0,0,23
"cg04061225",76,9,2,0,87
"cg04061361",0,2,0,0,2
"cg04061622",12,10,0,0,22
"cg04062303",107,18,0,0,125
"cg04063547",0,0,1,0,1
"cg04065727",0,0,1,0,1
"cg04065867",1,0,0,0,1
"cg04067157",0,1,0,0,1
"cg04068248",6,10,3,0,19
"cg04068595",1,0,0,0,1
"cg04068754",24,1,0,0,25
"cg04069867",0,2,0,0,2
"cg04069952",0,1,0,0,1
"cg04070194",0,0,1,0,1
"cg04070211",1,0,0,0,1
"cg04071200",1,0,0,0,1
"cg04071630",6,1,0,0,7
"cg04071701",2,0,0,0,2
"cg04072156",28,7,0,0,35
"cg04072843",1,0,0,0,1
"cg04073061",0,0,1,0,1
"cg04073404",0,0,1,0,1
"cg04073582",0,0,3,0,3
"cg04074157",0,2,11,0,13
"cg04075233",1,0,0,0,1
"cg04075783",0,1,0,0,1
"cg04075866",2,0,0,0,2
"cg04076763",180,77,4,0,261
"cg04077732",2,5,4,0,11
"cg04078634",88,12,1,0,101
"cg04079206",0,1,0,0,1
"cg04080291",630,79,0,0,709
"cg04080517",0,0,2,0,2
"cg04081097",0,2,1,0,3
"cg04082898",18,1,1,0,20
"cg04083575",0,0,1,0,1
"cg04083921",19,7,1,0,27
"cg04084111",0,0,1,0,1
"cg04084436",1,0,0,0,1
"cg04084675",2,0,0,0,2
"cg04085263",702,288,1,0,991
"cg04086442",17,10,0,0,27
"cg04086761",9,0,0,0,9
"cg04086858",0,1,0,0,1
"cg04087434",0,1,0,0,1
"cg04089197",518,28,0,0,546
"cg04089320",1,0,0,0,1
"cg04090307",1,0,0,0,1
"cg04091454",252,231,29,0,512
"cg04091628",381,15,0,0,396
"cg04092009",16,6,0,0,22
"cg04092883",2,4,5,1,12
"cg04093821",239,63,1,0,303
"cg04094508",6,2,0,0,8
"cg04094633",0,1,0,0,1
"cg04095711",0,0,1,0,1
"cg04095717",0,2,0,0,2
"cg04095790",0,0,1,0,1
"cg04095921",1,0,0,0,1
"cg04096697",0,0,1,0,1
"cg04097312",118,12,1,0,131
"cg04098293",0,1,6,0,7
"cg04099186",1,0,0,0,1
"cg04099375",107,22,1,0,130
"cg04099436",0,1,0,0,1
"cg04100169",150,402,29,0,581
"cg04104228",0,0,2,0,2
"cg04104235",10,0,0,0,10
"cg04104789",0,2,0,0,2
"cg04105065",1,0,0,0,1
"cg04105121",0,1,1,0,2
"cg04105290",1,0,0,0,1
"cg04105559",0,0,4,0,4
"cg04106649",1,0,0,0,1
"cg04106782",1,0,0,0,1
"cg04107318",1,0,0,0,1
"cg04107679",0,7,6,0,13
"cg04107699",0,0,5,0,5
"cg04107754",1,1,1,0,3
"cg04107761",0,0,1,0,1
"cg04108181",17,2,0,0,19
"cg04108660",8,2,0,0,10
"cg04109556",0,1,5,0,6
"cg04110531",0,0,3,0,3
"cg04112787",0,1,0,0,1
"cg04113920",0,1,0,0,1
"cg04113957",0,0,1,0,1
"cg04114510",0,1,0,0,1
"cg04114537",128,70,22,0,220
"cg04114637",0,0,1,0,1
"cg04114723",119,245,43,0,407
"cg04114982",0,3,0,0,3
"cg04115104",0,2,0,0,2
"cg04116790",27,0,0,0,27
"cg04117433",4,0,0,0,4
"cg04117566",1,0,0,0,1
"cg04118834",1,0,0,0,1
"cg04119701",0,1,0,0,1
"cg04119833",3,0,0,0,3
"cg04120680",1,0,1,0,2
"cg04120842",0,0,1,0,1
"cg04122161",0,1,0,0,1
"cg04122556",16,23,1,0,40
"cg04122773",534,504,11,0,1049
"cg04123433",2,0,2,0,4
"cg04123665",0,2,7,0,9
"cg04123941",0,0,1,0,1
"cg04124260",1,1,0,0,2
"cg04125003",1,0,0,0,1
"cg04125223",0,1,0,0,1
"cg04125302",0,1,0,0,1
"cg04126584",1,0,0,0,1
"cg04127255",5,1,0,0,6
"cg04127706",1,0,0,0,1
"cg04127742",0,0,1,0,1
"cg04128281",41,12,1,0,54
"cg04128776",2,5,1,0,8
"cg04128804",0,1,0,0,1
"cg04129948",3,0,1,0,4
"cg04130127",1,1,4,0,6
"cg04130484",0,0,2,0,2
"cg04131153",1,2,0,0,3
"cg04131442",399,46,0,0,445
"cg04134069",3,0,0,0,3
"cg04134845",0,0,1,0,1
"cg04134958",1,0,0,0,1
"cg04135434",2,2,0,0,4
"cg04135678",6,1,2,0,9
"cg04136061",2,0,0,0,2
"cg04136111",2,0,0,0,2
"cg04137142",2,0,0,0,2
"cg04138899",1,0,0,0,1
"cg04139514",1,2,0,0,3
"cg04140045",23,6,0,0,29
"cg04140590",1,0,0,0,1
"cg04140670",13,0,0,0,13
"cg04141107",0,0,1,0,1
"cg04143547",32,22,5,0,59
"cg04143592",0,0,1,0,1
"cg04144075",383,10,3,0,396
"cg04144462",1,0,0,0,1
"cg04144604",73,3,0,0,76
"cg04144686",0,1,1,0,2
"cg04145565",0,1,1,0,2
"cg04146151",0,1,5,0,6
"cg04146553",133,313,5,0,451
"cg04147016",3,0,0,0,3
"cg04147689",3,1,0,0,4
"cg04149171",148,33,1,0,182
"cg04149381",1,0,0,0,1
"cg04150263",0,0,3,0,3
"cg04151958",34,0,0,0,34
"cg04152341",0,2,0,0,2
"cg04152675",2,3,1,0,6
"cg04153241",0,0,0,1,1
"cg04153595",0,0,1,0,1
"cg04153614",0,0,1,0,1
"cg04154034",1,0,0,0,1
"cg04154986",0,3,0,0,3
"cg04155052",72,2,0,0,74
"cg04155147",0,1,0,0,1
"cg04155316",28,0,1,0,29
"cg04156191",0,0,1,0,1
"cg04157194",1,0,0,0,1
"cg04157726",2,0,0,0,2
"cg04158140",4,0,0,0,4
"cg04158589",0,0,1,0,1
"cg04158967",331,321,40,0,692
"cg04159789",2,0,0,0,2
"cg04159905",0,0,1,0,1
"cg04160046",0,0,3,0,3
"cg04160876",1,0,0,0,1
"cg04162328",2,0,1,0,3
"cg04162727",1,0,0,0,1
"cg04163637",104,59,5,0,168
"cg04164640",0,6,10,0,16
"cg04164814",1,0,0,0,1
"cg04165263",6,0,2,0,8
"cg04165935",0,0,0,1,1
"cg04167239",0,1,0,0,1
"cg04167725",1,1,0,0,2
"cg04167804",17,15,1,0,33
"cg04167811",91,37,2,0,130
"cg04168185",1,0,0,0,1
"cg04168554",0,1,0,0,1
"cg04169534",0,0,1,0,1
"cg04169922",3,0,0,0,3
"cg04170184",6,0,0,0,6
"cg04171367",0,0,6,0,6
"cg04171829",0,1,0,0,1
"cg04172561",0,1,0,0,1
"cg04172848",2,2,3,0,7
"cg04172899",0,0,5,0,5
"cg04173072",3,0,0,0,3
"cg04174466",3,1,0,0,4
"cg04175109",47,8,0,0,55
"cg04175497",1,0,0,0,1
"cg04175890",1,1,0,0,2
"cg04175957",0,0,1,0,1
"cg04177118",1,0,0,0,1
"cg04177156",2,0,3,0,5
"cg04178011",0,0,1,0,1
"cg04178446",0,1,0,0,1
"cg04178995",3,0,0,0,3
"cg04179670",1,0,0,0,1
"cg04181013",0,2,0,0,2
"cg04181079",0,1,1,0,2
"cg04181121",14,0,0,0,14
"cg04181701",0,0,1,0,1
"cg04182362",0,2,0,0,2
"cg04182591",0,1,0,0,1
"cg04182594",0,0,0,1,1
"cg04182795",4,3,1,0,8
"cg04182927",1,0,0,0,1
"cg04183232",1,1,0,0,2
"cg04184107",203,9,0,0,212
"cg04185461",0,0,1,0,1
"cg04185470",0,1,1,0,2
"cg04186622",0,1,0,0,1
"cg04187433",18,1,0,0,19
"cg04188095",4,0,1,0,5
"cg04188562",338,167,0,0,505
"cg04188667",0,1,0,0,1
"cg04189149",0,0,2,0,2
"cg04191142",23,8,1,0,32
"cg04191199",0,1,0,0,1
"cg04191837",0,0,2,0,2
"cg04192616",0,0,1,0,1
"cg04192760",4,1,2,0,7
"cg04192879",0,1,0,0,1
"cg04193835",1,0,1,0,2
"cg04194479",0,0,1,0,1
"cg04194728",1,0,1,0,2
"cg04195340",207,29,0,0,236
"cg04195831",0,0,1,0,1
"cg04196064",0,0,2,0,2
"cg04196546",0,0,1,0,1
"cg04197155",160,444,49,0,653
"cg04197482",0,0,2,0,2
"cg04197657",0,2,0,0,2
"cg04198231",0,0,4,0,4
"cg04198535",0,1,0,0,1
"cg04199563",12,6,0,0,18
"cg04199720",0,0,1,0,1
"cg04200026",1,1,0,0,2
"cg04200524",1,0,2,0,3
"cg04200704",1,0,0,0,1
"cg04204040",0,0,1,0,1
"cg04204079",2,1,0,0,3
"cg04204557",1,0,0,0,1
"cg04206284",1,0,0,0,1
"cg04206351",0,0,1,0,1
"cg04206644",1,0,0,0,1
"cg04206742",18,0,0,0,18
"cg04207317",1,0,0,0,1
"cg04207510",7,8,0,0,15
"cg04207888",1,1,4,0,6
"cg04209051",0,0,1,0,1
"cg04210186",2,8,3,0,13
"cg04210254",0,0,1,0,1
"cg04210498",2,0,1,0,3
"cg04211236",20,0,0,0,20
"cg04211946",0,0,1,0,1
"cg04212047",0,1,0,0,1
"cg04212253",0,1,0,0,1
"cg04213235",0,0,1,0,1
"cg04213582",0,1,0,0,1
"cg04213959",1,0,1,0,2
"cg04214399",221,324,11,0,556
"cg04214566",2,1,0,0,3
"cg04215672",6,3,9,0,18
"cg04216589",3,5,0,0,8
"cg04216650",2,2,0,0,4
"cg04217096",6,0,0,0,6
"cg04218030",6,2,0,0,8
"cg04220230",0,3,4,0,7
"cg04220285",1,4,3,0,8
"cg04220881",0,0,1,0,1
"cg04221836",0,0,2,0,2
"cg04223135",0,1,0,0,1
"cg04224084",570,8,0,0,578
"cg04224927",5,2,1,0,8
"cg04225046",1,0,0,0,1
"cg04225538",0,1,2,1,4
"cg04225592",1,0,0,0,1
"cg04226033",0,0,2,0,2
"cg04226766",645,113,4,0,762
"cg04227007",0,25,0,0,25
"cg04227238",3,0,0,0,3
"cg04228021",2,1,0,0,3
"cg04228794",5,0,0,0,5
"cg04228903",1,0,1,0,2
"cg04229253",0,0,1,0,1
"cg04231427",0,0,1,0,1
"cg04231937",0,4,0,0,4
"cg04232731",1,0,0,0,1
"cg04232788",0,1,0,0,1
"cg04233381",0,1,0,0,1
"cg04234260",0,0,2,0,2
"cg04234412",0,2,0,0,2
"cg04235343",19,7,1,0,27
"cg04235388",0,0,1,0,1
"cg04237127",40,32,1,0,73
"cg04237429",1,3,0,0,4
"cg04238737",31,35,1,0,67
"cg04239536",5,0,0,0,5
"cg04239838",0,8,2,0,10
"cg04239911",0,0,0,1,1
"cg04240603",121,273,291,0,685
"cg04240971",2,1,0,0,3
"cg04241858",0,0,1,0,1
"cg04244155",0,0,2,0,2
"cg04244572",0,1,0,0,1
"cg04245228",0,1,0,0,1
"cg04246864",0,0,1,0,1
"cg04247553",1,0,0,0,1
"cg04248512",1,0,0,0,1
"cg04250131",1,1,0,0,2
"cg04250587",2,4,1,0,7
"cg04250904",0,2,0,0,2
"cg04251543",4,3,0,0,7
"cg04251731",0,0,1,0,1
"cg04251802",0,1,0,0,1
"cg04252529",180,5,0,0,185
"cg04252616",0,0,1,0,1
"cg04252957",6,0,0,0,6
"cg04253343",1,0,0,0,1
"cg04254389",470,17,0,0,487
"cg04254414",0,1,0,0,1
"cg04254693",0,1,0,0,1
"cg04255357",1,0,0,0,1
"cg04256609",0,1,0,0,1
"cg04256888",16,0,0,0,16
"cg04257117",0,2,0,0,2
"cg04258333",19,5,1,0,25
"cg04258811",1,3,2,0,6
"cg04259560",1,0,0,0,1
"cg04259687",0,0,1,0,1
"cg04259703",0,0,1,0,1
"cg04259971",0,0,6,0,6
"cg04260000",2,4,2,0,8
"cg04261102",62,437,19,0,518
"cg04261247",0,0,1,0,1
"cg04262197",1,0,0,0,1
"cg04262805",0,1,0,0,1
"cg04262892",15,0,0,0,15
"cg04263092",0,2,0,0,2
"cg04263163",0,0,1,0,1
"cg04263391",1,1,0,0,2
"cg04264289",0,0,1,0,1
"cg04264766",0,3,0,0,3
"cg04265051",1,0,0,0,1
"cg04265227",0,0,2,0,2
"cg04265425",0,1,0,0,1
"cg04265908",0,1,1,0,2
"cg04266248",0,0,1,0,1
"cg04267173",0,1,0,0,1
"cg04268211",5,5,2,0,12
"cg04268390",0,1,0,0,1
"cg04268722",1,0,2,0,3
"cg04269602",0,0,1,0,1
"cg04269791",0,1,0,0,1
"cg04269878",1,0,0,0,1
"cg04269879",1,0,0,0,1
"cg04270339",0,1,0,0,1
"cg04271801",0,1,0,0,1
"cg04272014",0,1,0,0,1
"cg04272309",0,1,2,0,3
"cg04272710",0,1,0,0,1
"cg04272712",0,0,3,0,3
"cg04272838",0,0,1,0,1
"cg04275570",10,1,0,0,11
"cg04276396",0,0,1,0,1
"cg04276750",0,0,1,0,1
"cg04277319",3,2,0,0,5
"cg04278212",0,3,9,0,12
"cg04280377",0,0,1,0,1
"cg04281142",3,3,0,0,6
"cg04281426",1,0,1,0,2
"cg04281569",0,0,1,0,1
"cg04282146",1,2,1,0,4
"cg04282206",0,0,1,0,1
"cg04283307",0,1,0,0,1
"cg04283488",20,5,0,0,25
"cg04284150",1,1,0,0,2
"cg04284164",0,0,2,0,2
"cg04284169",32,57,3,0,92
"cg04285194",1,1,0,0,2
"cg04285895",2,1,0,0,3
"cg04286068",0,0,1,0,1
"cg04286297",0,0,1,0,1
"cg04286307",3,1,0,0,4
"cg04286540",2,0,0,0,2
"cg04286558",2,1,0,0,3
"cg04287075",0,0,1,0,1
"cg04287080",1,0,0,0,1
"cg04287168",1,0,0,0,1
"cg04287983",2,15,0,0,17
"cg04288544",0,1,0,0,1
"cg04288795",0,0,1,0,1
"cg04289061",0,0,1,0,1
"cg04289078",62,39,14,0,115
"cg04289820",0,0,1,0,1
"cg04290085",0,1,0,0,1
"cg04290108",0,1,1,0,2
"cg04290483",650,850,101,0,1601
"cg04290528",0,0,1,0,1
"cg04291221",0,2,0,0,2
"cg04291685",7,0,0,0,7
"cg04292301",0,0,1,0,1
"cg04292830",1,1,4,0,6
"cg04293325",765,344,9,0,1118
"cg04293489",110,2,0,0,112
"cg04293703",0,0,1,0,1
"cg04293891",1,0,0,0,1
"cg04294908",1,0,0,0,1
"cg04295202",3,0,0,0,3
"cg04296126",2,0,0,0,2
"cg04298189",0,1,0,0,1
"cg04298591",0,1,0,0,1
"cg04300014",1,0,0,0,1
"cg04300298",0,1,0,0,1
"cg04300717",0,0,1,0,1
"cg04300778",0,0,1,0,1
"cg04304019",0,2,0,0,2
"cg04304353",0,2,2,0,4
"cg04305725",3,2,0,0,5
"cg04306343",2,3,1,0,6
"cg04307457",16,600,36,0,652
"cg04307491",2,0,0,0,2
"cg04307553",365,312,12,0,689
"cg04309037",85,9,0,0,94
"cg04309404",0,1,0,0,1
"cg04310266",1,0,0,0,1
"cg04311362",0,11,0,0,11
"cg04311722",1,0,0,0,1
"cg04312752",1,0,0,0,1
"cg04313066",324,13,1,0,338
"cg04313941",0,1,0,0,1
"cg04315682",2,0,0,0,2
"cg04315695",0,0,1,0,1
"cg04315923",1,0,0,0,1
"cg04317573",1,0,1,0,2
"cg04317940",2,0,0,0,2
"cg04318012",0,1,0,0,1
"cg04318144",10,7,0,0,17
"cg04318458",0,0,3,0,3
"cg04318657",0,1,0,0,1
"cg04319694",0,1,1,0,2
"cg04320257",0,0,0,1,1
"cg04320595",0,0,1,0,1
"cg04320787",10,9,0,0,19
"cg04322149",0,1,0,0,1
"cg04322176",0,1,0,0,1
"cg04323915",0,0,4,0,4
"cg04324487",0,0,3,0,3
"cg04324509",1,1,0,0,2
"cg04324591",0,1,0,0,1
"cg04325507",1,2,0,0,3
"cg04326562",3,0,0,0,3
"cg04328694",10,0,0,0,10
"cg04329952",1,1,0,0,2
"cg04330145",0,0,2,0,2
"cg04331667",32,0,0,0,32
"cg04333296",5,1,0,0,6
"cg04334235",0,0,1,0,1
"cg04334499",243,62,10,0,315
"cg04334885",0,1,0,0,1
"cg04336159",0,3,0,0,3
"cg04336624",0,1,0,0,1
"cg04336926",0,0,1,0,1
"cg04338134",0,0,1,0,1
"cg04339694",5,1,0,0,6
"cg04340203",0,0,2,0,2
"cg04340415",0,3,3,0,6
"cg04341745",2,0,0,0,2
"cg04342169",3,0,0,0,3
"cg04343775",2,0,0,0,2
"cg04343883",0,1,0,0,1
"cg04344018",1,4,1,0,6
"cg04344486",542,90,22,0,654
"cg04344532",0,1,0,0,1
"cg04345503",0,0,2,0,2
"cg04345559",277,294,34,0,605
"cg04345908",0,1,0,0,1
"cg04346410",0,2,2,0,4
"cg04349008",0,1,0,0,1
"cg04349117",0,2,1,0,3
"cg04349561",0,0,2,0,2
"cg04349689",0,2,1,0,3
"cg04351185",153,5,0,0,158
"cg04351258",0,1,0,0,1
"cg04351583",0,0,0,1,1
"cg04352310",3,0,0,0,3
"cg04352763",17,0,0,0,17
"cg04352979",1,1,0,0,2
"cg04353359",0,0,1,0,1
"cg04353863",2,0,0,0,2
"cg04354671",1,1,0,0,2
"cg04357016",1,0,0,0,1
"cg04357272",0,1,2,0,3
"cg04357469",6,1,0,0,7
"cg04357841",0,0,1,0,1
"cg04358923",0,1,1,0,2
"cg04359702",1,5,0,0,6
"cg04360673",4,0,3,0,7
"cg04360691",1,0,0,0,1
"cg04362112",0,0,1,0,1
"cg04362315",690,328,6,0,1024
"cg04362716",13,15,16,0,44
"cg04363536",15,2,0,0,17
"cg04363674",56,3,1,0,60
"cg04364973",0,1,2,0,3
"cg04365180",374,36,0,0,410
"cg04365202",1,0,0,0,1
"cg04365481",0,0,2,0,2
"cg04367731",0,0,1,0,1
"cg04368257",0,1,0,0,1
"cg04368707",3,0,0,0,3
"cg04368832",14,0,0,0,14
"cg04368849",0,0,4,0,4
"cg04368877",1,0,0,0,1
"cg04369574",0,1,0,0,1
"cg04369908",2,3,1,1,7
"cg04371338",23,3,0,0,26
"cg04371950",14,0,0,0,14
"cg04373117",4,8,4,0,16
"cg04373285",0,0,1,0,1
"cg04373359",1,0,0,0,1
"cg04373587",0,0,1,0,1
"cg04373707",0,0,1,0,1
"cg04373760",1,0,2,0,3
"cg04374190",0,1,0,0,1
"cg04374231",0,1,0,0,1
"cg04375245",1,0,0,0,1
"cg04375472",0,0,0,1,1
"cg04376403",0,0,0,1,1
"cg04376514",1,0,0,0,1
"cg04376820",0,0,1,0,1
"cg04376905",0,1,0,0,1
"cg04376997",1,0,0,0,1
"cg04377131",186,45,0,0,231
"cg04377849",321,117,3,0,441
"cg04378182",6,0,0,0,6
"cg04379416",173,424,62,0,659
"cg04381153",7,0,0,0,7
"cg04382358",1,0,5,1,7
"cg04382416",2,1,0,0,3
"cg04383038",94,3,1,0,98
"cg04384973",4,0,0,0,4
"cg04385420",1,0,0,0,1
"cg04385519",4,0,0,0,4
"cg04385818",0,0,1,0,1
"cg04386405",2,2,0,0,4
"cg04386450",0,0,1,0,1
"cg04387073",2,1,0,0,3
"cg04387575",0,4,7,0,11
"cg04388075",660,120,28,0,808
"cg04388409",0,1,1,0,2
"cg04389328",0,1,0,0,1
"cg04389417",3,1,0,0,4
"cg04389917",0,0,1,0,1
"cg04390328",2,0,0,0,2
"cg04390831",0,1,0,0,1
"cg04390980",1,0,0,0,1
"cg04392032",1,0,0,0,1
"cg04392209",1,0,0,0,1
"cg04392220",0,0,1,0,1
"cg04392293",41,172,2,0,215
"cg04392381",0,1,0,0,1
"cg04392578",92,43,7,0,142
"cg04392742",20,12,2,0,34
"cg04393452",27,10,1,0,38
"cg04393631",0,0,1,0,1
"cg04393693",0,0,1,0,1
"cg04394186",0,1,0,0,1
"cg04394346",1,0,0,0,1
"cg04394795",0,0,2,0,2
"cg04395230",0,1,1,0,2
"cg04396462",4,5,5,0,14
"cg04396850",7,0,0,0,7
"cg04396911",1,0,0,0,1
"cg04398419",0,1,0,0,1
"cg04398932",0,0,0,1,1
"cg04399113",5,1,0,0,6
"cg04399140",490,57,1,0,548
"cg04400496",1,0,0,0,1
"cg04400862",0,0,1,0,1
"cg04402828",0,0,1,0,1
"cg04403139",62,21,2,0,85
"cg04403474",1,0,0,0,1
"cg04404455",0,1,0,0,1
"cg04404756",0,1,0,0,1
"cg04406925",2,1,0,0,3
"cg04406981",0,0,6,0,6
"cg04407233",0,0,1,0,1
"cg04407400",69,5,0,0,74
"cg04407872",1,1,0,0,2
"cg04408200",0,1,0,0,1
"cg04410039",6,0,0,0,6
"cg04410368",0,1,0,0,1
"cg04412481",0,5,9,0,14
"cg04413089",3,0,8,0,11
"cg04413302",3,1,0,0,4
"cg04414307",0,0,1,0,1
"cg04418330",1,0,0,0,1
"cg04420319",0,0,0,1,1
"cg04420516",0,1,1,0,2
"cg04421424",1,0,0,0,1
"cg04422277",0,1,0,0,1
"cg04422618",1,0,0,0,1
"cg04422637",3,2,0,0,5
"cg04423572",971,95,0,0,1066
"cg04424010",3,0,0,0,3
"cg04424597",6,11,26,0,43
"cg04424945",5,1,0,0,6
"cg04425209",3,1,2,0,6
"cg04426297",0,0,1,0,1
"cg04426326",1,0,0,0,1
"cg04426553",0,0,1,0,1
"cg04427469",0,0,1,0,1
"cg04427512",919,155,2,0,1076
"cg04428718",0,0,5,0,5
"cg04429778",0,4,7,0,11
"cg04430529",4,6,0,0,10
"cg04431387",0,0,1,0,1
"cg04431844",0,1,0,0,1
"cg04431876",0,2,1,0,3
"cg04432360",0,0,5,0,5
"cg04432768",0,0,1,0,1
"cg04433266",1,0,0,0,1
"cg04433306",0,1,0,0,1
"cg04433380",6,0,0,0,6
"cg04433647",1,0,0,0,1
"cg04434356",1,0,0,0,1
"cg04434463",1,1,1,0,3
"cg04434759",0,0,1,0,1
"cg04435222",7,0,0,0,7
"cg04435241",0,1,0,0,1
"cg04435637",6,1,0,0,7
"cg04436431",90,2,0,0,92
"cg04436459",4,4,0,0,8
"cg04437358",5,23,7,0,35
"cg04437648",1,0,0,0,1
"cg04437922",0,0,1,0,1
"cg04438194",0,3,1,0,4
"cg04438688",0,0,1,0,1
"cg04438968",0,1,0,0,1
"cg04440194",0,1,0,0,1
"cg04441017",14,0,0,0,14
"cg04441780",0,1,0,0,1
"cg04441791",0,1,0,0,1
"cg04442042",14,0,0,0,14
"cg04442485",1,0,0,0,1
"cg04442796",0,1,0,0,1
"cg04444095",0,1,0,0,1
"cg04444119",0,3,5,0,8
"cg04444369",0,0,0,1,1
"cg04444410",4,0,0,0,4
"cg04444447",0,1,5,0,6
"cg04444583",60,45,5,0,110
"cg04445656",0,0,1,0,1
"cg04445715",0,1,0,0,1
"cg04446279",14,0,0,0,14
"cg04446453",12,21,12,0,45
"cg04446501",1,0,0,0,1
"cg04447001",9,2,0,0,11
"cg04447216",2,1,0,0,3
"cg04447722",1,0,0,0,1
"cg04447859",1,1,0,0,2
"cg04448345",112,84,2,0,198
"cg04448476",0,1,1,0,2
"cg04449523",0,1,0,0,1
"cg04451031",0,0,1,0,1
"cg04451494",1,0,1,0,2
"cg04451798",0,0,0,2,2
"cg04451960",0,1,0,0,1
"cg04453511",19,12,7,0,38
"cg04453594",0,0,1,0,1
"cg04454882",1,0,0,0,1
"cg04455399",0,0,1,0,1
"cg04455759",1,0,0,0,1
"cg04455950",1,0,0,0,1
"cg04456547",2,5,2,0,9
"cg04456897",3,0,0,0,3
"cg04457003",0,1,0,0,1
"cg04458127",2,2,0,0,4
"cg04459579",10,2,0,0,12
"cg04459585",4,0,0,0,4
"cg04459703",1,0,0,0,1
"cg04460361",1,0,0,0,1
"cg04460459",17,3,0,0,20
"cg04460961",307,29,1,0,337
"cg04461050",0,1,0,0,1
"cg04461101",5,2,0,0,7
"cg04461477",1,1,0,0,2
"cg04461926",0,1,0,0,1
"cg04462340",5,1,0,0,6
"cg04462343",0,0,1,0,1
"cg04462547",2,0,0,0,2
"cg04462931",0,2,1,2,5
"cg04463155",6,1,0,0,7
"cg04463265",0,1,0,0,1
"cg04463380",0,1,0,0,1
"cg04463825",0,1,0,0,1
"cg04465904",5,4,0,0,9
"cg04466394",3,2,0,0,5
"cg04466685",0,0,1,0,1
"cg04466995",1,0,0,0,1
"cg04467140",0,2,0,0,2
"cg04467487",0,0,1,0,1
"cg04467954",18,8,0,0,26
"cg04469686",0,0,1,0,1
"cg04470497",6,0,0,0,6
"cg04470971",1,0,0,0,1
"cg04471822",1,0,0,0,1
"cg04472083",7,7,4,0,18
"cg04472100",0,1,0,0,1
"cg04472905",2,0,0,0,2
"cg04472909",34,2,0,0,36
"cg04473167",0,3,2,0,5
"cg04473217",0,0,2,0,2
"cg04473235",8,1,0,0,9
"cg04474262",0,0,3,0,3
"cg04474298",1,0,0,0,1
"cg04474903",90,11,0,0,101
"cg04476174",0,1,0,0,1
"cg04477336",0,0,1,0,1
"cg04477683",0,1,0,0,1
"cg04478223",0,1,0,0,1
"cg04479860",0,9,1,0,10
"cg04479971",113,6,0,0,119
"cg04480767",4,0,1,0,5
"cg04482072",0,0,1,0,1
"cg04482971",807,209,0,0,1016
"cg04483062",1,0,0,0,1
"cg04483163",3,0,0,0,3
"cg04483277",0,1,0,0,1
"cg04483720",1,0,0,0,1
"cg04483754",0,0,1,0,1
"cg04484136",0,0,2,0,2
"cg04484313",2,0,0,0,2
"cg04485911",0,0,0,1,1
"cg04486281",0,0,1,0,1
"cg04487008",0,0,0,1,1
"cg04487150",0,0,1,0,1
"cg04487158",0,0,1,0,1
"cg04487720",0,2,0,0,2
"cg04487904",0,0,1,0,1
"cg04488036",1,4,0,0,5
"cg04488372",21,1,0,0,22
"cg04488373",0,2,0,0,2
"cg04488529",2,0,0,0,2
"cg04489279",106,9,1,0,116
"cg04490207",1,0,1,0,2
"cg04491917",0,1,1,0,2
"cg04492479",1,0,0,0,1
"cg04492721",0,0,2,0,2
"cg04492929",0,0,6,0,6
"cg04492982",2,0,0,0,2
"cg04493247",0,1,1,0,2
"cg04493401",0,0,1,0,1
"cg04493931",0,0,1,0,1
"cg04494122",0,0,1,0,1
"cg04494251",18,0,0,0,18
"cg04494270",2,0,1,0,3
"cg04496485",0,1,0,0,1
"cg04496967",2,0,0,0,2
"cg04497902",1,0,0,0,1
"cg04498159",56,32,5,0,93
"cg04499455",0,0,1,0,1
"cg04499506",0,0,1,0,1
"cg04501372",0,1,0,0,1
"cg04502407",1,0,0,0,1
"cg04502601",51,97,19,0,167
"cg04502857",53,1,0,0,54
"cg04503318",0,1,0,0,1
"cg04504062",3,4,0,0,7
"cg04504217",46,2,0,0,48
"cg04504408",1,0,0,0,1
"cg04504820",2,0,0,0,2
"cg04506308",4,1,0,0,5
"cg04506563",7,2,1,0,10
"cg04507562",0,1,0,0,1
"cg04508711",1,0,0,0,1
"cg04509365",155,245,4,0,404
"cg04509430",1,0,0,0,1
"cg04509446",4,4,7,0,15
"cg04509615",1,0,0,0,1
"cg04512780",1,0,0,0,1
"cg04514080",1,0,0,0,1
"cg04514626",0,1,0,0,1
"cg04514834",1,0,0,0,1
"cg04515702",5,2,0,0,7
"cg04516379",68,7,0,0,75
"cg04516854",36,2,0,0,38
"cg04517416",1,4,2,0,7
"cg04518725",0,0,1,0,1
"cg04522374",6,4,0,0,10
"cg04523090",0,1,0,0,1
"cg04523320",0,1,0,0,1
"cg04523867",3,1,0,0,4
"cg04523929",0,1,0,0,1
"cg04524109",1,0,0,0,1
"cg04524177",1,0,0,0,1
"cg04525398",0,3,1,0,4
"cg04525773",0,0,1,0,1
"cg04525977",5,1,0,0,6
"cg04526209",0,3,0,0,3
"cg04526574",1,1,0,0,2
"cg04526737",1,0,0,0,1
"cg04527202",0,1,0,0,1
"cg04527335",2,0,0,0,2
"cg04529486",0,1,0,0,1
"cg04529865",1,0,1,0,2
"cg04530845",0,0,2,0,2
"cg04532421",7,2,0,0,9
"cg04533214",14,5,0,0,19
"cg04533218",4,5,1,0,10
"cg04533302",0,0,1,0,1
"cg04534008",1,1,0,0,2
"cg04534026",29,0,0,0,29
"cg04535665",1,0,1,0,2
"cg04535924",0,1,0,0,1
"cg04536319",2,3,1,0,6
"cg04537170",13,6,0,0,19
"cg04537707",0,1,1,0,2
"cg04538307",0,1,1,0,2
"cg04539338",0,0,1,0,1
"cg04541523",0,1,0,0,1
"cg04542047",97,8,0,0,105
"cg04544917",0,0,1,0,1
"cg04544946",3,1,1,0,5
"cg04547423",28,2,0,0,30
"cg04548076",0,0,1,0,1
"cg04549749",7,0,0,0,7
"cg04550079",0,1,0,0,1
"cg04552319",0,2,5,0,7
"cg04553015",2,0,0,0,2
"cg04553246",1,0,0,0,1
"cg04553327",1,0,0,0,1
"cg04553690",0,0,1,0,1
"cg04556645",1,0,0,0,1
"cg04556766",0,0,1,0,1
"cg04557184",0,1,0,0,1
"cg04558302",7,1,2,0,10
"cg04558749",69,0,0,0,69
"cg04559010",2,0,0,0,2
"cg04559632",0,0,1,0,1
"cg04560531",2,10,0,0,12
"cg04561094",2,0,1,0,3
"cg04562330",948,73,0,0,1021
"cg04562384",1,0,0,0,1
"cg04562396",1,0,0,0,1
"cg04562441",0,1,0,0,1
"cg04562588",7,0,0,0,7
"cg04563215",13,5,1,0,19
"cg04563543",17,0,0,0,17
"cg04563766",1,0,0,0,1
"cg04564312",0,0,1,0,1
"cg04565674",0,1,0,0,1
"cg04566648",0,1,0,0,1
"cg04566796",0,1,0,0,1
"cg04567009",0,0,1,0,1
"cg04567887",0,0,2,0,2
"cg04568549",3,0,0,0,3
"cg04568613",0,3,0,1,4
"cg04568991",0,0,1,0,1
"cg04569313",0,2,0,0,2
"cg04570155",7,1,0,0,8
"cg04570452",0,1,1,0,2
"cg04571233",0,3,15,0,18
"cg04571415",0,1,0,0,1
"cg04571847",1,0,0,0,1
"cg04572206",0,0,0,1,1
"cg04573471",1,0,0,0,1
"cg04573771",3,0,0,0,3
"cg04574083",2,0,0,0,2
"cg04574182",18,13,3,0,34
"cg04575393",1,1,0,0,2
"cg04575609",0,1,0,0,1
"cg04576182",1691,86,0,0,1777
"cg04576213",0,1,2,2,5
"cg04576847",3,1,0,0,4
"cg04577051",0,0,1,0,1
"cg04577146",2,0,0,0,2
"cg04577369",0,0,1,0,1
"cg04577395",29,36,0,0,65
"cg04578002",1,0,0,0,1
"cg04578229",0,0,1,0,1
"cg04578304",1,0,0,0,1
"cg04578903",0,0,1,0,1
"cg04579171",3,0,0,0,3
"cg04581073",2,0,0,0,2
"cg04581466",5,1,0,0,6
"cg04582861",0,1,0,0,1
"cg04585227",1,0,1,0,2
"cg04586348",4,0,0,0,4
"cg04587626",0,1,0,0,1
"cg04587814",1,0,0,0,1
"cg04588204",35,9,1,0,45
"cg04588248",21,0,0,0,21
"cg04589658",0,2,9,0,11
"cg04591308",16,1,0,0,17
"cg04591623",55,2,0,0,57
"cg04592208",0,0,1,0,1
"cg04592226",0,0,1,0,1
"cg04592320",4,0,0,0,4
"cg04593426",0,1,1,0,2
"cg04594503",0,1,0,0,1
"cg04595393",1,0,0,0,1
"cg04595504",0,0,1,0,1
"cg04595569",1,1,1,0,3
"cg04596842",0,0,1,0,1
"cg04597526",0,1,0,0,1
"cg04598105",68,11,3,0,82
"cg04600643",1,0,2,0,3
"cg04600766",1,0,0,0,1
"cg04601296",0,0,1,0,1
"cg04602421",5,1,0,0,6
"cg04602755",1,1,0,0,2
"cg04603290",2,1,2,0,5
"cg04603700",0,1,0,0,1
"cg04603811",0,0,1,0,1
"cg04604806",0,0,2,0,2
"cg04606294",0,0,1,0,1
"cg04606471",682,158,3,0,843
"cg04606582",0,0,1,0,1
"cg04606672",0,0,1,0,1
"cg04606981",8,0,0,0,8
"cg04607024",0,0,1,0,1
"cg04608406",0,0,2,0,2
"cg04609439",51,40,2,0,93
"cg04610631",0,0,6,0,6
"cg04611407",289,208,21,0,518
"cg04611493",3,0,0,0,3
"cg04611798",5,0,0,0,5
"cg04612016",0,0,1,0,1
"cg04612747",1,0,0,0,1
"cg04612869",232,186,40,0,458
"cg04613165",0,0,1,0,1
"cg04613634",0,0,1,0,1
"cg04613945",96,275,11,0,382
"cg04614203",0,0,1,0,1
"cg04614339",0,0,1,0,1
"cg04616222",0,0,1,0,1
"cg04616757",0,0,1,0,1
"cg04616769",0,0,1,0,1
"cg04617012",1,0,0,0,1
"cg04618078",0,0,1,0,1
"cg04618340",1,2,0,0,3
"cg04620693",1,0,0,0,1
"cg04621640",1,0,0,0,1
"cg04621962",2,0,0,0,2
"cg04622074",0,0,1,0,1
"cg04622595",1,0,0,0,1
"cg04623205",1,0,0,0,1
"cg04623221",1,0,0,0,1
"cg04623265",0,0,1,0,1
"cg04624074",10,7,4,0,21
"cg04624172",542,181,0,0,723
"cg04625300",0,0,2,0,2
"cg04626162",1,0,0,0,1
"cg04626855",2,0,0,0,2
"cg04626974",1,0,0,0,1
"cg04627531",2,0,0,0,2
"cg04627621",0,1,0,0,1
"cg04627849",0,1,5,0,6
"cg04628742",2,0,0,0,2
"cg04629211",1,2,0,0,3
"cg04629912",0,0,1,0,1
"cg04629951",0,1,1,0,2
"cg04630271",0,0,3,0,3
"cg04630539",0,1,0,0,1
"cg04631584",1,1,0,0,2
"cg04631766",6,1,3,0,10
"cg04632779",10,3,0,0,13
"cg04634656",0,0,2,0,2
"cg04634710",1,0,0,0,1
"cg04635154",0,0,1,0,1
"cg04636881",146,8,0,0,154
"cg04637809",0,2,2,0,4
"cg04638428",1,0,0,0,1
"cg04638667",5,0,0,0,5
"cg04639980",1,0,0,0,1
"cg04642330",0,0,1,0,1
"cg04643038",0,3,13,0,16
"cg04643524",1,0,0,0,1
"cg04644049",1,2,8,0,11
"cg04644817",1,1,1,0,3
"cg04644978",0,0,2,0,2
"cg04645331",0,0,1,0,1
"cg04645495",0,2,0,0,2
"cg04646170",1,0,0,0,1
"cg04646842",112,9,1,0,122
"cg04648048",11,12,5,0,28
"cg04648922",1,0,0,0,1
"cg04649852",0,1,0,0,1
"cg04650133",2,0,0,0,2
"cg04651601",4,0,0,0,4
"cg04652208",0,0,1,0,1
"cg04652896",6,0,0,0,6
"cg04653052",4,1,0,0,5
"cg04653337",110,46,6,0,162
"cg04655596",0,1,3,0,4
"cg04657057",0,0,1,0,1
"cg04657419",0,1,0,0,1
"cg04658691",3,0,0,0,3
"cg04659537",0,0,1,0,1
"cg04660984",4,0,3,0,7
"cg04661002",0,0,1,0,1
"cg04662015",0,1,0,0,1
"cg04662184",0,0,1,0,1
"cg04662567",1,0,1,0,2
"cg04662828",0,2,0,0,2
"cg04662837",0,0,1,0,1
"cg04663292",7,0,0,0,7
"cg04663556",29,8,0,0,37
"cg04663901",66,0,0,0,66
"cg04665287",0,1,0,0,1
"cg04665696",0,0,0,1,1
"cg04665930",0,1,0,0,1
"cg04668301",11,3,0,0,14
"cg04669405",0,0,2,0,2
"cg04669470",0,1,0,0,1
"cg04670031",0,1,0,0,1
"cg04670739",0,2,2,0,4
"cg04671206",23,16,0,0,39
"cg04671591",0,0,1,0,1
"cg04673565",0,0,1,0,1
"cg04674267",2,0,3,0,5
"cg04674357",0,0,1,0,1
"cg04674736",0,1,0,0,1
"cg04675342",120,166,17,0,303
"cg04675747",0,1,1,0,2
"cg04676113",7,1,0,0,8
"cg04676302",0,0,1,0,1
"cg04676388",3,1,0,0,4
"cg04676446",0,0,2,0,2
"cg04676559",0,0,1,0,1
"cg04677840",2,0,0,0,2
"cg04678715",1,2,0,0,3
"cg04678955",0,6,0,0,6
"cg04678989",1,0,0,0,1
"cg04679532",3,0,0,0,3
"cg04680516",556,91,2,0,649
"cg04680743",9,8,1,0,18
"cg04681293",1,0,0,0,1
"cg04681579",0,0,1,0,1
"cg04682458",1,0,0,0,1
"cg04683048",0,1,0,0,1
"cg04683418",7,0,0,0,7
"cg04684411",0,0,1,0,1
"cg04685392",1,2,0,0,3
"cg04685842",0,1,0,0,1
"cg04685954",3,2,0,0,5
"cg04686114",0,1,0,0,1
"cg04687357",789,36,1,0,826
"cg04687379",1,0,1,0,2
"cg04687555",3,0,0,0,3
"cg04687833",0,0,2,0,2
"cg04688024",4,1,1,0,6
"cg04688580",0,1,0,0,1
"cg04689167",0,1,1,0,2
"cg04689451",123,118,13,0,254
"cg04689919",0,0,1,0,1
"cg04690023",7,9,3,0,19
"cg04690045",1,1,3,0,5
"cg04690184",0,1,0,0,1
"cg04690674",5,0,0,0,5
"cg04691018",0,0,1,0,1
"cg04691277",0,1,0,0,1
"cg04691944",1,0,1,0,2
"cg04692023",0,0,1,0,1
"cg04692156",0,0,0,1,1
"cg04693379",93,3,0,0,96
"cg04693423",14,4,0,0,18
"cg04693782",0,1,0,0,1
"cg04694239",182,50,1,0,233
"cg04695058",0,1,0,0,1
"cg04695373",1,0,0,0,1
"cg04696494",1,0,0,0,1
"cg04696654",0,1,3,0,4
"cg04696837",0,0,1,0,1
"cg04696881",2,0,0,0,2
"cg04697208",7,1,0,0,8
"cg04697755",0,1,0,0,1
"cg04697775",0,2,0,0,2
"cg04698655",1,0,0,0,1
"cg04699462",0,0,1,0,1
"cg04699668",0,0,1,0,1
"cg04701181",1,3,0,0,4
"cg04701490",1,0,0,0,1
"cg04701987",69,6,0,0,75
"cg04702079",4,0,0,0,4
"cg04702315",0,0,0,1,1
"cg04702396",0,0,1,0,1
"cg04703951",0,0,3,0,3
"cg04704085",0,0,1,0,1
"cg04704495",0,4,1,0,5
"cg04705068",8,0,0,0,8
"cg04706172",0,0,1,0,1
"cg04706400",0,0,1,0,1
"cg04707036",0,2,0,0,2
"cg04708216",0,0,1,0,1
"cg04709020",1,0,1,0,2
"cg04709062",1,0,0,0,1
"cg04709822",0,0,1,0,1
"cg04709890",1,1,0,0,2
"cg04710097",2,0,0,0,2
"cg04710226",0,0,1,0,1
"cg04711526",1,0,0,0,1
"cg04712723",0,0,1,0,1
"cg04713169",1,0,0,0,1
"cg04713267",5,0,0,0,5
"cg04713789",0,0,1,0,1
"cg04714550",1,0,0,0,1
"cg04714590",0,1,0,0,1
"cg04715880",1,0,1,0,2
"cg04717450",134,447,1,0,582
"cg04717613",5,0,0,0,5
"cg04718231",2,0,1,1,4
"cg04718234",12,9,11,0,32
"cg04718747",4,1,0,0,5
"cg04719164",1,0,0,0,1
"cg04720065",0,0,1,0,1
"cg04721775",2,6,8,0,16
"cg04721785",0,0,0,1,1
"cg04721884",15,2,0,0,17
"cg04722177",0,1,0,0,1
"cg04722795",0,0,1,0,1
"cg04722801",1,0,0,0,1
"cg04723170",0,1,0,0,1
"cg04723390",1,0,0,0,1
"cg04724133",2,0,0,0,2
"cg04724426",1,0,0,0,1
"cg04724873",2,0,0,0,2
"cg04725313",59,1,0,0,60
"cg04727017",0,19,1,0,20
"cg04727367",1,5,1,0,7
"cg04728180",1,1,0,0,2
"cg04728223",0,0,1,0,1
"cg04728413",20,548,117,0,685
"cg04728727",1,0,0,0,1
"cg04729609",100,108,0,0,208
"cg04730029",0,0,1,0,1
"cg04730254",0,2,0,0,2
"cg04730314",1,1,1,0,3
"cg04730365",0,1,0,0,1
"cg04730459",248,145,13,0,406
"cg04730691",1,0,0,0,1
"cg04730930",0,0,1,0,1
"cg04731120",1,1,1,0,3
"cg04733533",0,0,2,0,2
"cg04733758",0,2,1,0,3
"cg04733773",3,0,0,0,3
"cg04733787",0,0,3,0,3
"cg04734841",1,0,0,0,1
"cg04735352",28,5,1,0,34
"cg04735481",0,0,3,0,3
"cg04736486",1,0,0,0,1
"cg04737042",0,0,1,0,1
"cg04737133",12,7,3,0,22
"cg04737369",0,3,2,0,5
"cg04737405",0,0,1,0,1
"cg04737832",0,1,0,0,1
"cg04738692",0,1,0,0,1
"cg04739156",0,1,0,0,1
"cg04740477",1,0,0,0,1
"cg04740939",0,0,1,0,1
"cg04741068",1,0,0,0,1
"cg04741128",2,2,1,0,5
"cg04742671",0,1,2,0,3
"cg04743860",8,2,0,0,10
"cg04743972",21,0,0,0,21
"cg04744717",0,0,1,0,1
"cg04745778",0,0,1,0,1
"cg04745934",0,1,0,0,1
"cg04746406",82,98,3,0,183
"cg04746632",0,3,0,0,3
"cg04746799",166,383,182,0,731
"cg04747231",0,1,0,0,1
"cg04747341",0,1,3,0,4
"cg04747510",1,0,0,0,1
"cg04748098",183,4,0,0,187
"cg04748637",0,0,1,0,1
"cg04748929",3,0,0,0,3
"cg04749066",0,0,1,0,1
"cg04749117",0,0,1,0,1
"cg04750436",1,0,0,0,1
"cg04751631",0,0,1,0,1
"cg04751736",151,51,3,0,205
"cg04752053",0,0,1,0,1
"cg04752186",1,8,9,0,18
"cg04752396",0,0,0,1,1
"cg04752534",3,0,0,0,3
"cg04753233",0,1,0,0,1
"cg04753936",0,1,0,0,1
"cg04755999",1,5,1,0,7
"cg04756127",2,0,7,0,9
"cg04756287",118,53,18,0,189
"cg04756316",0,2,0,0,2
"cg04756650",3,1,1,0,5
"cg04757284",0,0,1,0,1
"cg04757410",309,214,7,0,530
"cg04757661",24,12,1,0,37
"cg04758185",0,0,1,0,1
"cg04759651",0,0,1,0,1
"cg04760604",0,0,1,0,1
"cg04760687",861,723,119,0,1703
"cg04761781",28,9,0,0,37
"cg04764012",0,1,0,0,1
"cg04765207",0,0,1,0,1
"cg04765296",0,1,2,0,3
"cg04767174",0,0,0,2,2
"cg04767204",1,0,0,0,1
"cg04767208",1,0,0,0,1
"cg04767885",0,1,0,0,1
"cg04768713",4,1,1,0,6
"cg04768745",0,1,1,0,2
"cg04769879",0,2,0,0,2
"cg04770282",1,1,0,0,2
"cg04770983",0,0,1,0,1
"cg04771729",0,0,1,0,1
"cg04773376",2,0,0,0,2
"cg04774481",4,0,0,0,4
"cg04774770",1,0,2,0,3
"cg04775059",1,0,0,0,1
"cg04775824",1,0,0,0,1
"cg04776304",0,2,2,0,4
"cg04776356",0,0,1,0,1
"cg04776597",1,4,0,0,5
"cg04776718",1,0,0,0,1
"cg04777312",0,1,0,0,1
"cg04777578",1,0,0,0,1
"cg04777644",0,3,0,0,3
"cg04778165",1,0,0,0,1
"cg04778411",0,0,4,0,4
"cg04779070",616,795,60,0,1471
"cg04779410",0,0,1,0,1
"cg04781587",0,3,3,0,6
"cg04781764",1,0,0,0,1
"cg04782552",6,1,0,0,7
"cg04783151",3,2,0,0,5
"cg04783695",0,0,1,0,1
"cg04784196",791,43,1,0,835
"cg04784724",0,0,1,0,1
"cg04784839",0,2,1,0,3
"cg04784940",0,1,0,0,1
"cg04786201",0,0,3,0,3
"cg04786204",0,1,0,0,1
"cg04788267",0,1,0,0,1
"cg04788959",10,0,0,0,10
"cg04789318",0,1,0,0,1
"cg04789482",1,0,2,0,3
"cg04789860",0,0,1,0,1
"cg04790129",0,0,1,0,1
"cg04790271",13,9,5,0,27
"cg04791162",1,0,0,0,1
"cg04791410",1,1,0,0,2
"cg04791421",262,15,0,0,277
"cg04791505",0,0,1,0,1
"cg04791523",0,1,0,0,1
"cg04791747",0,1,3,0,4
"cg04792167",1,1,0,0,2
"cg04792352",106,20,1,0,127
"cg04792447",1,0,0,0,1
"cg04792530",0,1,0,0,1
"cg04792642",443,10,0,0,453
"cg04793091",0,1,6,0,7
"cg04793118",0,1,2,0,3
"cg04793637",0,0,5,0,5
"cg04794627",0,0,1,0,1
"cg04795638",52,1,1,0,54
"cg04795724",1,0,0,0,1
"cg04795850",4,0,0,0,4
"cg04797166",0,2,1,0,3
"cg04797197",0,1,0,0,1
"cg04797224",1,0,0,0,1
"cg04798865",1,0,0,0,1
"cg04798984",207,303,63,0,573
"cg04799204",0,0,2,0,2
"cg04799493",312,77,8,0,397
"cg04800988",1,2,0,0,3
"cg04801401",166,224,31,0,421
"cg04801974",0,0,1,0,1
"cg04802959",1,0,0,0,1
"cg04803509",1,1,3,1,6
"cg04805512",3,0,0,0,3
"cg04805558",0,0,1,0,1
"cg04805794",5,0,0,0,5
"cg04806485",11,0,0,0,11
"cg04806936",24,22,3,0,49
"cg04807694",0,1,0,0,1
"cg04807739",1,0,0,0,1
"cg04808427",0,1,0,0,1
"cg04809026",3,0,0,0,3
"cg04809347",2,0,0,0,2
"cg04810755",1,0,1,0,2
"cg04810794",1,0,0,0,1
"cg04811682",0,2,1,0,3
"cg04813004",4,0,0,0,4
"cg04813104",0,0,1,0,1
"cg04813559",0,1,0,0,1
"cg04814317",1,0,0,0,1
"cg04815486",0,0,0,1,1
"cg04815645",0,1,0,0,1
"cg04816278",0,1,1,0,2
"cg04816348",0,1,0,0,1
"cg04816979",0,0,0,1,1
"cg04817258",0,0,3,0,3
"cg04819193",0,0,1,0,1
"cg04819691",13,0,0,0,13
"cg04819808",0,1,0,0,1
"cg04820078",40,127,29,0,196
"cg04821026",2,2,0,2,6
"cg04821387",0,0,2,0,2
"cg04821895",0,0,2,0,2
"cg04822213",4,4,1,0,9
"cg04823299",1,0,0,0,1
"cg04824818",178,88,3,0,269
"cg04824852",0,1,0,0,1
"cg04826176",167,14,0,0,181
"cg04826882",0,0,1,0,1
"cg04827282",1,0,0,0,1
"cg04827595",1,0,3,0,4
"cg04827640",0,0,2,0,2
"cg04828041",133,20,1,0,154
"cg04828530",0,0,4,0,4
"cg04828714",154,398,176,0,728
"cg04828993",0,1,0,0,1
"cg04829416",5,0,0,0,5
"cg04829566",11,0,0,0,11
"cg04830191",15,0,0,0,15
"cg04830420",1,0,0,0,1
"cg04831495",0,2,11,0,13
"cg04831589",90,335,210,0,635
"cg04831885",0,1,0,0,1
"cg04832019",0,1,1,0,2
"cg04832545",0,2,1,0,3
"cg04833898",0,1,0,0,1
"cg04834113",1,0,0,0,1
"cg04834909",0,0,1,0,1
"cg04835598",779,761,34,0,1574
"cg04835613",1,0,0,0,1
"cg04835653",1,0,2,0,3
"cg04835841",0,1,1,0,2
"cg04836080",1,1,0,0,2
"cg04836794",2,0,0,0,2
"cg04836819",0,0,1,0,1
"cg04837381",5,0,0,0,5
"cg04837923",0,1,0,0,1
"cg04838579",0,0,1,0,1
"cg04838627",3,0,0,0,3
"cg04839289",0,0,1,0,1
"cg04840032",0,1,0,0,1
"cg04841997",0,0,3,0,3
"cg04844666",1,0,0,0,1
"cg04845613",28,5,1,0,34
"cg04845915",0,2,0,0,2
"cg04846348",1,0,0,0,1
"cg04849429",0,1,0,0,1
"cg04850659",0,0,1,0,1
"cg04852271",0,0,5,0,5
"cg04858016",0,0,2,0,2
"cg04859385",2,2,0,0,4
"cg04860082",100,2,0,0,102
"cg04860622",270,165,9,0,444
"cg04861024",1,0,0,0,1
"cg04861944",0,1,0,0,1
"cg04862890",0,1,1,0,2
"cg04862906",0,1,0,0,1
"cg04864532",0,1,0,0,1
"cg04865050",6,19,0,0,25
"cg04865692",0,2,0,0,2
"cg04865814",126,29,2,0,157
"cg04865889",0,1,0,0,1
"cg04866518",0,2,2,0,4
"cg04867593",1,0,0,0,1
"cg04867743",0,0,1,0,1
"cg04868554",0,0,1,0,1
"cg04868734",5,0,0,0,5
"cg04869735",20,1,0,0,21
"cg04870415",0,2,4,0,6
"cg04871201",212,12,0,0,224
"cg04871364",0,1,0,0,1
"cg04872027",0,1,0,0,1
"cg04874292",0,1,0,0,1
"cg04874673",2,2,5,0,9
"cg04874825",0,1,15,0,16
"cg04875591",2,0,0,0,2
"cg04875995",0,0,4,0,4
"cg04876245",2,0,0,0,2
"cg04876377",0,1,0,0,1
"cg04876597",0,1,0,0,1
"cg04876693",1,0,0,0,1
"cg04878119",0,5,18,0,23
"cg04879235",0,1,0,0,1
"cg04879818",1,0,0,0,1
"cg04880133",0,0,1,0,1
"cg04880683",0,0,1,0,1
"cg04880724",0,9,0,0,9
"cg04880834",0,0,1,0,1
"cg04881008",0,0,1,0,1
"cg04882870",0,0,1,0,1
"cg04883157",0,1,1,0,2
"cg04883232",3,0,0,0,3
"cg04883403",0,0,1,0,1
"cg04883911",0,0,1,0,1
"cg04884171",239,6,0,0,245
"cg04884395",307,576,4,0,887
"cg04884842",0,1,0,0,1
"cg04885303",6,2,0,0,8
"cg04885343",4,0,0,0,4
"cg04885678",1,0,0,0,1
"cg04885935",0,0,1,0,1
"cg04886382",10,7,8,0,25
"cg04886436",1,0,1,0,2
"cg04886662",0,1,2,0,3
"cg04887076",0,0,1,0,1
"cg04887080",0,0,1,0,1
"cg04888425",1,0,1,0,2
"cg04889521",0,1,0,0,1
"cg04890328",4,0,0,0,4
"cg04891071",2,6,0,0,8
"cg04891165",0,1,0,0,1
"cg04891883",22,0,0,0,22
"cg04893543",9,0,0,0,9
"cg04893833",1,0,0,0,1
"cg04895580",0,0,1,0,1
"cg04895666",8,2,1,0,11
"cg04895735",0,1,1,0,2
"cg04896534",0,1,0,0,1
"cg04896997",2,0,0,0,2
"cg04898518",0,0,1,0,1
"cg04898773",1,1,0,0,2
"cg04898877",0,0,1,0,1
"cg04898939",0,1,0,0,1
"cg04899153",0,3,4,0,7
"cg04899586",0,7,8,0,15
"cg04899944",2,0,0,0,2
"cg04900893",10,0,6,0,16
"cg04901179",1,0,0,0,1
"cg04901407",2,0,0,0,2
"cg04902364",0,2,0,0,2
"cg04902542",3,2,0,0,5
"cg04902592",0,4,1,0,5
"cg04902930",8,21,3,0,32
"cg04903146",0,0,1,0,1
"cg04903439",0,2,0,0,2
"cg04903884",0,0,1,0,1
"cg04904527",20,3,0,0,23
"cg04905173",2,0,0,0,2
"cg04905635",1,0,0,0,1
"cg04906467",7,0,0,0,7
"cg04907849",1,2,1,0,4
"cg04908013",39,3,0,0,42
"cg04908382",6,7,3,0,16
"cg04909554",21,64,11,0,96
"cg04909938",0,0,1,0,1
"cg04910041",0,0,1,0,1
"cg04910313",0,0,1,0,1
"cg04910429",0,0,1,0,1
"cg04910619",1,2,0,0,3
"cg04911669",0,2,0,0,2
"cg04911728",1,0,0,0,1
"cg04912588",5,1,0,0,6
"cg04913005",2,0,1,0,3
"cg04913666",2,0,0,0,2
"cg04913815",0,1,7,0,8
"cg04914191",0,0,1,0,1
"cg04915440",0,0,1,0,1
"cg04916430",1,0,0,0,1
"cg04917409",4,2,0,0,6
"cg04917615",0,1,0,0,1
"cg04917688",248,114,1,0,363
"cg04920194",4,0,0,0,4
"cg04920535",0,0,2,0,2
"cg04922188",1,1,2,0,4
"cg04922361",0,0,3,0,3
"cg04922606",0,1,0,0,1
"cg04923016",8,15,7,0,30
"cg04923484",12,4,0,0,16
"cg04923859",0,0,1,0,1
"cg04926244",0,2,0,0,2
"cg04926295",20,5,0,0,25
"cg04927033",0,1,0,0,1
"cg04927329",0,0,1,0,1
"cg04927622",10,2,0,0,12
"cg04927689",0,0,1,0,1
"cg04928539",0,1,0,0,1
"cg04932465",179,61,0,0,240
"cg04933655",1,0,0,0,1
"cg04935289",3,3,0,0,6
"cg04936639",1,3,0,0,4
"cg04936951",0,2,0,0,2
"cg04937155",0,0,1,0,1
"cg04937723",154,176,28,0,358
"cg04938780",0,0,1,0,1
"cg04939306",1,0,0,0,1
"cg04940129",0,1,0,0,1
"cg04940526",8,0,1,0,9
"cg04940733",6,0,0,0,6
"cg04941033",0,1,0,0,1
"cg04941236",26,2,1,0,29
"cg04941520",1,4,3,0,8
"cg04942431",1,0,0,0,1
"cg04942808",0,0,1,0,1
"cg04943357",0,0,1,0,1
"cg04943440",92,32,4,0,128
"cg04943612",1,0,0,0,1
"cg04943636",0,1,0,0,1
"cg04944200",1,1,0,0,2
"cg04944278",2,0,0,0,2
"cg04944296",41,0,0,0,41
"cg04944454",2,0,0,0,2
"cg04944595",0,0,6,0,6
"cg04944611",8,5,0,0,13
"cg04944980",0,0,2,0,2
"cg04946917",0,0,1,0,1
"cg04947339",0,1,2,0,3
"cg04947680",0,1,1,0,2
"cg04948915",1,0,1,0,2
"cg04948956",11,1,0,0,12
"cg04949106",0,0,2,0,2
"cg04949308",0,1,0,0,1
"cg04951112",0,0,1,0,1
"cg04951688",31,4,0,0,35
"cg04952061",191,4,0,0,195
"cg04952282",1,0,0,0,1
"cg04953155",1,0,0,0,1
"cg04953411",3,1,0,0,4
"cg04953579",0,0,2,0,2
"cg04954113",0,0,4,0,4
"cg04954203",3,4,18,0,25
"cg04954237",2,1,0,0,3
"cg04956282",0,1,0,0,1
"cg04959516",3,0,0,0,3
"cg04960260",0,1,0,0,1
"cg04960798",880,570,16,0,1466
"cg04961445",1,0,0,0,1
"cg04961665",0,0,1,0,1
"cg04962134",8,2,4,0,14
"cg04963523",575,32,2,0,609
"cg04963553",7,2,0,0,9
"cg04963560",0,0,2,0,2
"cg04963757",0,1,0,0,1
"cg04964332",0,1,0,0,1
"cg04964733",372,190,14,0,576
"cg04965463",2,2,0,0,4
"cg04966140",5,2,0,0,7
"cg04966550",3,4,4,0,11
"cg04967502",10,1,0,0,11
"cg04967610",1,7,0,0,8
"cg04967965",4,3,1,0,8
"cg04968079",0,1,0,0,1
"cg04968084",2,0,0,0,2
"cg04968835",0,0,2,0,2
"cg04968875",0,1,0,0,1
"cg04969790",0,0,1,0,1
"cg04970106",1,1,1,0,3
"cg04970839",4,2,0,0,6
"cg04972759",0,0,1,0,1
"cg04972766",0,0,0,1,1
"cg04973663",0,0,1,0,1
"cg04973781",1,0,0,0,1
"cg04974599",0,0,1,0,1
"cg04975143",0,2,0,0,2
"cg04975481",0,1,0,0,1
"cg04976697",2,0,0,0,2
"cg04976994",0,0,5,0,5
"cg04977760",20,1,0,0,21
"cg04978343",1,0,0,0,1
"cg04978709",0,0,1,0,1
"cg04979063",1,0,2,0,3
"cg04979234",0,0,1,0,1
"cg04980253",0,0,1,0,1
"cg04980281",0,1,0,0,1
"cg04980515",0,1,0,0,1
"cg04981665",54,2,0,0,56
"cg04981792",0,0,1,0,1
"cg04981952",0,0,2,0,2
"cg04983459",1,0,0,0,1
"cg04984825",10,1,0,0,11
"cg04985020",119,10,0,0,129
"cg04985626",77,38,0,0,115
"cg04986781",2,0,0,0,2
"cg04987181",1,2,0,0,3
"cg04987823",0,2,2,0,4
"cg04988048",0,0,1,0,1
"cg04988869",1,0,2,0,3
"cg04989054",3,1,0,0,4
"cg04989533",1,0,0,0,1
"cg04990074",1,0,0,0,1
"cg04990241",0,0,1,0,1
"cg04990609",556,19,5,0,580
"cg04991282",2,1,0,0,3
"cg04991883",0,0,1,0,1
"cg04992752",3,1,0,0,4
"cg04993041",12,0,0,0,12
"cg04993339",0,0,1,0,1
"cg04993364",2,0,0,0,2
"cg04993414",1,0,0,0,1
"cg04994925",0,0,1,0,1
"cg04995722",0,1,0,0,1
"cg04995773",1,0,0,0,1
"cg04996097",6,12,0,0,18
"cg04998054",3,0,0,0,3
"cg04998160",0,3,0,0,3
"cg04998690",0,0,1,0,1
"cg04998941",0,0,1,0,1
"cg05000199",5,7,1,0,13
"cg05000466",5,3,4,0,12
"cg05000694",0,0,1,0,1
"cg05001044",3,0,2,1,6
"cg05002041",0,1,0,0,1
"cg05002642",14,12,0,0,26
"cg05003062",0,1,5,0,6
"cg05004405",1,0,1,0,2
"cg05005521",4,0,0,0,4
"cg05005577",0,3,0,0,3
"cg05008061",250,15,0,0,265
"cg05008218",0,0,1,0,1
"cg05010032",0,1,0,0,1
"cg05010114",0,0,1,0,1
"cg05010309",62,0,0,0,62
"cg05010513",1,0,0,0,1
"cg05010752",0,0,1,0,1
"cg05011276",0,1,0,0,1
"cg05011784",1,0,0,0,1
"cg05011904",0,0,2,0,2
"cg05012044",88,30,1,0,119
"cg05012125",0,0,1,0,1
"cg05012158",0,1,3,0,4
"cg05012624",151,227,31,0,409
"cg05013504",0,1,0,0,1
"cg05013661",1,0,2,0,3
"cg05013695",1,0,0,0,1
"cg05013913",4,0,0,0,4
"cg05014211",0,1,0,0,1
"cg05014752",1,0,0,0,1
"cg05016131",0,1,3,0,4
"cg05016335",0,0,1,0,1
"cg05017760",180,181,8,0,369
"cg05018275",0,0,1,0,1
"cg05019220",80,4,0,0,84
"cg05019235",0,1,2,0,3
"cg05019381",13,0,0,0,13
"cg05019583",0,0,1,0,1
"cg05019866",0,1,0,0,1
"cg05019905",1,1,0,0,2
"cg05020203",1,1,4,0,6
"cg05020956",2,0,0,0,2
"cg05021394",0,1,1,0,2
"cg05021686",9,0,0,0,9
"cg05022379",3,0,0,0,3
"cg05022491",4,2,0,0,6
"cg05022557",1,0,0,0,1
"cg05023043",0,1,3,0,4
"cg05024102",0,2,0,0,2
"cg05024121",0,0,1,0,1
"cg05024628",0,0,1,0,1
"cg05025392",178,4,0,0,182
"cg05025575",0,0,1,0,1
"cg05025913",7,0,0,0,7
"cg05026658",0,0,3,0,3
"cg05026859",0,1,0,0,1
"cg05028588",1,0,0,0,1
"cg05029551",0,1,0,0,1
"cg05029625",0,0,1,0,1
"cg05029645",1,0,0,0,1
"cg05029692",0,1,0,0,1
"cg05030129",0,0,5,0,5
"cg05030772",0,0,1,0,1
"cg05031301",4,0,0,0,4
"cg05031741",0,0,1,0,1
"cg05031797",0,0,1,0,1
"cg05033764",0,1,0,0,1
"cg05033924",1,0,1,0,2
"cg05033936",0,0,1,0,1
"cg05035620",0,0,3,0,3
"cg05035980",2,0,0,0,2
"cg05036183",24,8,0,0,32
"cg05036279",0,0,1,0,1
"cg05036337",0,0,1,0,1
"cg05036439",1,0,0,0,1
"cg05037643",0,0,2,0,2
"cg05038757",2,1,0,0,3
"cg05040624",5,5,2,0,12
"cg05040649",0,0,1,0,1
"cg05041475",0,0,1,0,1
"cg05041728",0,1,0,0,1
"cg05042213",779,45,1,0,825
"cg05042606",0,0,1,0,1
"cg05042749",1,0,0,0,1
"cg05043564",0,0,1,0,1
"cg05043853",47,13,0,0,60
"cg05043952",0,0,1,0,1
"cg05044764",1,0,0,0,1
"cg05045104",40,1,0,0,41
"cg05045338",0,0,1,0,1
"cg05046305",1,0,0,0,1
"cg05047706",7,1,1,0,9
"cg05048927",152,7,0,0,159
"cg05048982",0,0,1,0,1
"cg05049028",143,34,0,0,177
"cg05049094",0,0,1,0,1
"cg05049681",0,1,0,0,1
"cg05049933",1,0,0,0,1
"cg05050047",8,0,0,0,8
"cg05050531",196,363,17,0,576
"cg05051118",0,0,3,0,3
"cg05051262",2,4,0,0,6
"cg05051571",0,0,1,0,1
"cg05052363",0,0,1,0,1
"cg05052470",511,935,49,0,1495
"cg05052520",16,2,0,0,18
"cg05053751",4,4,6,0,14
"cg05053829",7,16,21,0,44
"cg05054149",4,3,0,0,7
"cg05054663",0,3,0,0,3
"cg05054944",405,162,6,0,573
"cg05055623",0,4,4,0,8
"cg05055827",14,1,1,0,16
"cg05057230",0,1,0,0,1
"cg05057374",3,0,0,0,3
"cg05057833",1,0,0,0,1
"cg05058508",1,1,0,0,2
"cg05058672",1,0,0,0,1
"cg05058886",33,3,0,0,36
"cg05059224",7,2,0,0,9
"cg05059451",2,0,0,0,2
"cg05059458",0,0,2,0,2
"cg05059799",1,0,0,0,1
"cg05059874",2,2,2,0,6
"cg05060577",1,0,0,0,1
"cg05061132",1,0,0,0,1
"cg05061813",58,2,0,0,60
"cg05061846",3,0,0,0,3
"cg05062080",1,0,0,0,1
"cg05062291",0,0,1,0,1
"cg05062550",1,0,0,0,1
"cg05062653",0,0,4,0,4
"cg05062741",1,0,0,0,1
"cg05062854",1,2,3,0,6
"cg05063536",0,0,1,0,1
"cg05063748",0,0,1,0,1
"cg05063856",0,1,2,0,3
"cg05064054",1,0,0,0,1
"cg05064668",0,0,1,0,1
"cg05064683",0,1,2,0,3
"cg05065372",1,0,0,0,1
"cg05065559",2,0,0,0,2
"cg05065669",1,0,3,0,4
"cg05066387",2,7,5,0,14
"cg05066804",4,1,1,0,6
"cg05067286",0,0,1,0,1
"cg05067766",0,1,0,0,1
"cg05068035",1,1,1,0,3
"cg05068096",11,1,0,0,12
"cg05068146",0,1,0,0,1
"cg05068597",5,5,1,0,11
"cg05070737",183,162,4,0,349
"cg05071183",0,1,0,0,1
"cg05072063",282,260,7,0,549
"cg05072552",2,0,0,0,2
"cg05073880",68,382,233,0,683
"cg05075454",1,0,0,0,1
"cg05075473",0,0,1,0,1
"cg05076082",0,1,0,0,1
"cg05077566",2,2,0,0,4
"cg05077705",2,0,0,0,2
"cg05077872",0,1,0,0,1
"cg05078156",22,0,0,0,22
"cg05079548",1,0,0,0,1
"cg05080699",0,1,0,0,1
"cg05081006",340,421,72,0,833
"cg05081498",0,0,0,1,1
"cg05081820",1,2,0,0,3
"cg05082550",1,0,0,0,1
"cg05083038",12,8,1,0,21
"cg05083147",0,1,0,0,1
"cg05084358",6,5,1,0,12
"cg05085627",0,4,11,0,15
"cg05085749",0,0,3,0,3
"cg05086178",0,0,1,0,1
"cg05088017",1,0,0,0,1
"cg05088152",2,0,0,0,2
"cg05088515",3,0,1,1,5
"cg05089903",0,0,1,0,1
"cg05091817",0,0,2,0,2
"cg05091921",98,18,0,0,116
"cg05092008",0,0,1,0,1
"cg05092304",3,2,1,0,6
"cg05092459",4,0,0,0,4
"cg05093071",165,22,3,0,190
"cg05093318",0,0,1,0,1
"cg05093469",9,6,0,0,15
"cg05095422",1,0,0,0,1
"cg05097306",0,0,1,0,1
"cg05097696",4,5,2,0,11
"cg05097953",0,0,1,0,1
"cg05098815",4,0,0,0,4
"cg05099196",1,0,0,0,1
"cg05099605",1,5,0,0,6
"cg05101432",0,1,1,0,2
"cg05101765",2,0,0,0,2
"cg05101809",2,0,0,0,2
"cg05102135",3,6,5,1,15
"cg05102300",182,6,0,0,188
"cg05102422",0,1,0,0,1
"cg05103956",118,110,8,0,236
"cg05104351",11,7,1,0,19
"cg05104993",0,2,4,0,6
"cg05105016",4,0,0,0,4
"cg05105632",0,0,1,0,1
"cg05105713",0,0,1,0,1
"cg05105722",2,0,0,0,2
"cg05105919",3,0,0,0,3
"cg05106286",0,0,1,0,1
"cg05107246",0,2,1,0,3
"cg05107361",1,0,0,0,1
"cg05107564",0,0,1,0,1
"cg05107686",2,3,3,0,8
"cg05109487",0,0,1,0,1
"cg05109566",0,1,0,0,1
"cg05110392",0,1,0,1,2
"cg05110739",0,0,2,0,2
"cg05111037",29,1,0,0,30
"cg05111475",0,0,1,0,1
"cg05112224",0,0,2,0,2
"cg05113711",1,0,0,0,1
"cg05113755",0,1,0,0,1
"cg05114858",14,2,0,0,16
"cg05115161",0,5,0,0,5
"cg05115705",2,1,0,0,3
"cg05115953",1,0,0,0,1
"cg05117809",5,0,0,0,5
"cg05118621",1,2,0,0,3
"cg05119245",0,1,0,0,1
"cg05119900",3,0,0,0,3
"cg05120668",0,0,1,0,1
"cg05121035",0,0,1,0,1
"cg05121200",0,0,1,0,1
"cg05121388",0,1,0,0,1
"cg05122441",1,0,0,0,1
"cg05122611",0,1,0,0,1
"cg05123257",0,0,1,0,1
"cg05123368",0,0,1,0,1
"cg05123378",4,6,5,1,16
"cg05123943",0,0,2,0,2
"cg05126797",12,9,12,0,33
"cg05126892",1,0,0,0,1
"cg05127456",0,1,0,0,1
"cg05127653",3,0,0,0,3
"cg05127924",0,0,1,0,1
"cg05128550",0,0,1,0,1
"cg05129479",0,0,1,0,1
"cg05130405",0,0,1,0,1
"cg05131102",38,17,0,0,55
"cg05131142",0,0,7,0,7
"cg05131479",0,1,0,0,1
"cg05132568",0,0,1,0,1
"cg05133090",0,0,1,0,1
"cg05133756",0,1,1,0,2
"cg05134987",0,0,1,0,1
"cg05135419",0,1,0,0,1
"cg05135593",0,0,1,0,1
"cg05136032",6,0,0,0,6
"cg05136139",1,1,0,0,2
"cg05136268",0,1,1,0,2
"cg05137199",10,2,0,0,12
"cg05137662",0,0,2,0,2
"cg05139028",1,0,0,0,1
"cg05139472",46,43,17,0,106
"cg05139559",39,22,1,0,62
"cg05140231",1,1,2,0,4
"cg05140643",1,6,0,0,7
"cg05141384",0,7,0,0,7
"cg05141428",0,0,2,0,2
"cg05143252",0,4,4,0,8
"cg05143364",0,1,0,0,1
"cg05144642",3,2,2,1,8
"cg05145251",0,0,1,0,1
"cg05146436",0,1,0,0,1
"cg05147582",2,0,0,0,2
"cg05147714",2,1,0,0,3
"cg05149720",1,0,0,0,1
"cg05150023",1,0,0,0,1
"cg05151348",56,2,0,0,58
"cg05152653",1,0,0,0,1
"cg05153550",1,0,0,0,1
"cg05153791",6,0,0,0,6
"cg05154530",1,0,0,0,1
"cg05154896",26,0,0,0,26
"cg05155770",0,1,0,0,1
"cg05155809",0,1,0,0,1
"cg05156200",0,2,0,0,2
"cg05156353",0,1,2,0,3
"cg05156453",4,7,4,0,15
"cg05156464",1,0,0,0,1
"cg05157171",2,2,3,0,7
"cg05157470",5,5,3,0,13
"cg05157833",0,0,2,0,2
"cg05158692",0,0,1,0,1
"cg05159925",0,2,0,0,2
"cg05160193",0,0,1,0,1
"cg05161264",1,0,1,0,2
"cg05161332",0,0,1,0,1
"cg05162788",0,1,0,0,1
"cg05164495",0,1,1,0,2
"cg05164937",0,0,0,1,1
"cg05164968",0,0,1,0,1
"cg05165316",0,1,0,0,1
"cg05165445",3,4,0,0,7
"cg05165665",1,0,0,0,1
"cg05167898",122,124,0,0,246
"cg05168280",20,1,1,0,22
"cg05168404",0,0,2,0,2
"cg05169812",3,4,13,0,20
"cg05170746",6,0,0,0,6
"cg05170856",0,0,3,0,3
"cg05171487",0,0,1,0,1
"cg05171687",3,1,0,0,4
"cg05172141",0,1,0,0,1
"cg05172609",0,1,0,0,1
"cg05173079",1,1,0,0,2
"cg05173611",0,0,1,0,1
"cg05174252",1,0,0,0,1
"cg05175158",2,0,0,0,2
"cg05176234",0,0,1,0,1
"cg05176429",0,1,0,0,1
"cg05177160",2,0,0,0,2
"cg05178291",0,0,1,0,1
"cg05178316",0,1,0,0,1
"cg05179035",0,1,0,0,1
"cg05179125",0,2,1,0,3
"cg05179820",0,1,0,0,1
"cg05179993",0,1,0,0,1
"cg05180512",821,81,2,0,904
"cg05181565",0,1,0,0,1
"cg05183538",0,0,1,0,1
"cg05184256",0,0,1,0,1
"cg05184308",1,3,0,0,4
"cg05185519",10,8,0,0,18
"cg05186611",1,0,0,0,1
"cg05188127",2,0,0,0,2
"cg05188403",0,8,7,0,15
"cg05188645",1,0,0,0,1
"cg05188963",1,0,1,0,2
"cg05189730",0,1,0,0,1
"cg05191435",0,0,1,0,1
"cg05192639",13,7,3,0,23
"cg05192974",0,0,1,0,1
"cg05193282",0,1,0,0,1
"cg05194689",374,14,0,0,388
"cg05195083",0,1,0,0,1
"cg05195085",0,0,3,0,3
"cg05195250",1,1,0,0,2
"cg05196355",12,1,0,0,13
"cg05196410",1,0,0,0,1
"cg05196941",1,0,0,0,1
"cg05198149",7,1,0,0,8
"cg05198442",512,35,1,0,548
"cg05199983",17,5,0,0,22
"cg05200707",0,1,0,0,1
"cg05201185",2,0,0,0,2
"cg05201317",34,3,0,0,37
"cg05201324",0,1,0,0,1
"cg05201332",0,1,0,0,1
"cg05201677",857,71,1,0,929
"cg05202483",1,0,0,0,1
"cg05203040",1,0,0,0,1
"cg05203671",1,7,0,0,8
"cg05203949",14,3,0,0,17
"cg05204540",5,1,0,0,6
"cg05204717",0,1,2,0,3
"cg05205601",3,9,13,0,25
"cg05205623",0,0,1,0,1
"cg05205695",1,0,0,0,1
"cg05207077",0,0,6,0,6
"cg05207255",392,13,0,0,405
"cg05207305",0,1,2,0,3
"cg05207394",1,0,0,0,1
"cg05207520",3,4,4,0,11
"cg05207973",0,1,0,0,1
"cg05208007",1,0,0,0,1
"cg05209192",0,0,1,0,1
"cg05209452",0,2,1,1,4
"cg05211171",0,1,1,0,2
"cg05211558",0,0,1,0,1
"cg05211996",0,1,0,0,1
"cg05212465",29,9,0,0,38
"cg05213267",1,0,0,0,1
"cg05216628",0,1,0,0,1
"cg05218054",0,2,4,0,6
"cg05218514",0,2,0,0,2
"cg05220713",0,2,1,0,3
"cg05220873",0,1,0,0,1
"cg05221103",7,0,0,0,7
"cg05221349",0,1,1,0,2
"cg05221514",0,0,1,0,1
"cg05221654",0,2,1,0,3
"cg05221678",0,2,4,0,6
"cg05222072",9,1,0,0,10
"cg05222119",0,0,7,0,7
"cg05222354",4,0,0,0,4
"cg05222807",304,28,0,0,332
"cg05224329",15,4,0,0,19
"cg05224614",0,0,1,0,1
"cg05224642",4,0,0,0,4
"cg05225065",0,0,1,0,1
"cg05226315",0,1,0,0,1
"cg05227111",0,0,1,0,1
"cg05227989",76,456,31,0,563
"cg05229275",81,13,1,0,95
"cg05229709",2,0,1,0,3
"cg05230009",0,0,16,0,16
"cg05230099",0,0,0,1,1
"cg05230906",0,1,0,0,1
"cg05231098",7,0,0,0,7
"cg05231478",0,13,0,0,13
"cg05231834",7,0,0,0,7
"cg05232596",1,0,1,0,2
"cg05233863",7,0,0,0,7
"cg05233955",0,0,1,0,1
"cg05234634",8,14,1,0,23
"cg05235047",0,0,1,0,1
"cg05235840",0,0,1,0,1
"cg05236297",1,0,0,0,1
"cg05236530",0,1,0,0,1
"cg05236621",0,0,1,0,1
"cg05237260",0,1,1,0,2
"cg05238434",1,0,0,0,1
"cg05238668",12,2,0,0,14
"cg05239817",0,0,1,0,1
"cg05240537",0,0,1,0,1
"cg05240970",148,17,1,0,166
"cg05241157",0,3,4,0,7
"cg05241308",0,0,1,0,1
"cg05241619",45,2,0,0,47
"cg05242576",1,0,0,0,1
"cg05243815",1,0,0,0,1
"cg05247780",0,0,13,0,13
"cg05248067",0,3,0,0,3
"cg05248351",1,0,0,0,1
"cg05249084",0,0,1,0,1
"cg05250797",0,0,2,0,2
"cg05251187",1,0,0,0,1
"cg05252143",11,5,2,0,18
"cg05252279",2,0,1,0,3
"cg05252322",0,0,1,0,1
"cg05252434",1,0,0,0,1
"cg05254246",0,2,0,0,2
"cg05254706",0,1,0,0,1
"cg05255537",0,4,3,0,7
"cg05256172",158,4,5,0,167
"cg05256663",1,1,0,0,2
"cg05256967",3,4,1,0,8
"cg05257719",1,0,0,0,1
"cg05258757",0,1,0,0,1
"cg05259262",21,2,0,0,23
"cg05259506",4,0,0,0,4
"cg05259545",0,1,0,0,1
"cg05260995",0,1,0,0,1
"cg05261549",0,1,3,0,4
"cg05262218",4,12,7,0,23
"cg05262743",0,0,1,0,1
"cg05262755",1,2,1,0,4
"cg05263953",195,76,2,0,273
"cg05264472",1,5,0,0,6
"cg05266537",7,9,1,0,17
"cg05267740",1003,902,137,0,2042
"cg05268824",0,0,1,0,1
"cg05269246",1,0,0,0,1
"cg05269678",0,1,0,0,1
"cg05269976",0,0,1,0,1
"cg05271121",2,0,0,0,2
"cg05271507",2,0,1,0,3
"cg05272216",0,0,1,0,1
"cg05273006",0,0,1,0,1
"cg05274446",10,1,0,0,11
"cg05274503",137,346,86,0,569
"cg05274940",39,3,0,0,42
"cg05275182",0,0,1,0,1
"cg05275236",0,1,0,0,1
"cg05275720",0,0,1,0,1
"cg05276302",0,1,0,0,1
"cg05277095",12,0,0,0,12
"cg05277407",0,0,1,0,1
"cg05277466",0,1,0,0,1
"cg05278186",0,0,1,0,1
"cg05278296",0,1,0,0,1
"cg05280336",1,0,1,0,2
"cg05280343",1,0,0,0,1
"cg05281623",244,23,0,0,267
"cg05281965",0,0,2,0,2
"cg05282072",3,0,0,0,3
"cg05282249",3,0,0,0,3
"cg05282303",0,0,1,0,1
"cg05282555",0,0,1,0,1
"cg05282889",4,1,0,0,5
"cg05282905",67,29,5,0,101
"cg05283090",1,0,0,0,1
"cg05283091",0,1,0,1,2
"cg05283172",0,0,1,0,1
"cg05283804",1,0,0,0,1
"cg05284042",1,0,0,0,1
"cg05285188",0,0,1,0,1
"cg05285768",182,256,5,0,443
"cg05286501",1,0,0,0,1
"cg05286689",1,0,0,0,1
"cg05286791",288,11,0,0,299
"cg05287321",0,0,1,0,1
"cg05287481",7,0,0,0,7
"cg05287601",1,0,0,0,1
"cg05288324",0,7,4,0,11
"cg05288475",1,1,0,0,2
"cg05289000",132,120,21,0,273
"cg05289966",0,0,1,0,1
"cg05290462",0,0,1,0,1
"cg05290901",1,0,0,0,1
"cg05291119",0,0,3,0,3
"cg05291710",7,13,3,0,23
"cg05292501",0,2,0,0,2
"cg05292837",1,0,0,0,1
"cg05293762",35,2,0,0,37
"cg05293990",0,1,1,0,2
"cg05294259",307,88,1,0,396
"cg05294592",0,0,1,0,1
"cg05295028",1,0,0,0,1
"cg05295427",1,0,0,0,1
"cg05295941",0,0,1,0,1
"cg05297066",168,240,61,0,469
"cg05298120",0,2,0,0,2
"cg05298375",0,0,6,0,6
"cg05298460",0,1,0,0,1
"cg05300266",0,0,4,0,4
"cg05300773",24,0,0,0,24
"cg05300942",0,0,1,0,1
"cg05301034",0,0,3,0,3
"cg05302426",37,24,0,0,61
"cg05302445",1,0,0,0,1
"cg05302585",8,1,0,0,9
"cg05303293",0,1,0,0,1
"cg05303739",0,0,2,0,2
"cg05304005",1,0,0,0,1
"cg05304057",0,0,1,0,1
"cg05304785",0,0,1,0,1
"cg05304929",2,0,0,0,2
"cg05305060",172,138,3,0,313
"cg05305413",0,0,1,0,1
"cg05305702",3,0,0,0,3
"cg05305986",0,1,1,0,2
"cg05306782",1,0,0,0,1
"cg05306903",1,0,0,0,1
"cg05307055",3,6,0,0,9
"cg05308062",0,1,0,0,1
"cg05308904",0,0,1,0,1
"cg05308936",1,0,1,0,2
"cg05309453",13,7,0,0,20
"cg05310646",193,12,0,0,205
"cg05310990",4,0,0,0,4
"cg05311465",3,0,0,0,3
"cg05311526",0,0,1,0,1
"cg05311665",0,0,1,0,1
"cg05313279",1,0,0,0,1
"cg05313677",0,0,1,0,1
"cg05315112",0,0,1,0,1
"cg05315510",2,5,2,0,9
"cg05316120",0,0,1,0,1
"cg05317204",8,0,0,0,8
"cg05319648",1,0,0,0,1
"cg05321683",1,1,0,0,2
"cg05321926",0,2,1,0,3
"cg05323468",0,0,4,0,4
"cg05323560",0,0,1,1,2
"cg05324519",0,1,0,0,1
"cg05324803",1,11,0,0,12
"cg05325061",0,0,2,0,2
"cg05325567",0,0,5,0,5
"cg05328014",0,2,0,0,2
"cg05328986",1,0,0,0,1
"cg05329434",0,0,1,0,1
"cg05330291",1,0,0,0,1
"cg05331252",108,158,32,0,298
"cg05331993",0,2,0,0,2
"cg05332489",0,0,1,0,1
"cg05332772",0,0,1,0,1
"cg05334072",0,0,1,0,1
"cg05334414",0,1,1,0,2
"cg05334554",0,0,1,0,1
"cg05335344",387,237,27,0,651
"cg05336281",1,0,0,0,1
"cg05336395",1,0,0,0,1
"cg05336611",0,1,1,0,2
"cg05337192",2,0,0,0,2
"cg05337998",0,1,2,0,3
"cg05338672",0,0,1,0,1
"cg05339070",2,0,0,0,2
"cg05339199",22,2,0,0,24
"cg05339237",0,0,2,0,2
"cg05339574",0,1,0,0,1
"cg05340403",0,0,1,0,1
"cg05340577",688,826,36,0,1550
"cg05342808",0,0,1,0,1
"cg05342813",0,4,3,0,7
"cg05343105",1,0,0,0,1
"cg05345577",50,9,0,0,59
"cg05346350",2,0,0,0,2
"cg05347537",1,0,0,0,1
"cg05347948",108,53,6,0,167
"cg05349363",0,2,0,0,2
"cg05349828",0,0,1,2,3
"cg05351267",0,1,0,0,1
"cg05351304",4,1,0,0,5
"cg05351778",1,0,1,0,2
"cg05352003",1,0,1,0,2
"cg05353133",0,1,1,0,2
"cg05353454",0,0,2,0,2
"cg05354594",97,157,24,0,278
"cg05354882",0,0,1,0,1
"cg05354998",4,0,0,0,4
"cg05355055",24,1,0,0,25
"cg05355073",0,0,1,0,1
"cg05357107",0,0,1,0,1
"cg05357338",0,0,1,0,1
"cg05357674",0,0,1,0,1
"cg05357932",2,0,0,0,2
"cg05359345",1,1,0,0,2
"cg05360160",0,1,0,0,1
"cg05360649",2,0,0,0,2
"cg05362011",0,1,0,0,1
"cg05362835",0,0,1,0,1
"cg05363065",0,0,5,0,5
"cg05364634",0,0,2,0,2
"cg05364761",0,0,1,0,1
"cg05365350",5,1,0,0,6
"cg05365600",2,0,0,0,2
"cg05366380",2,2,0,0,4
"cg05367916",1,12,0,1,14
"cg05368949",1,0,0,0,1
"cg05369965",107,147,3,0,257
"cg05371015",7,0,0,0,7
"cg05371322",0,1,0,0,1
"cg05371438",0,0,1,0,1
"cg05371565",18,17,15,0,50
"cg05371918",0,0,1,0,1
"cg05372365",0,0,2,0,2
"cg05372597",0,2,0,0,2
"cg05372957",0,0,1,0,1
"cg05373705",0,0,2,0,2
"cg05376477",1,7,2,0,10
"cg05376982",0,1,0,0,1
"cg05377165",0,1,0,0,1
"cg05377193",0,0,1,0,1
"cg05377415",34,3,0,0,37
"cg05377815",36,10,2,0,48
"cg05378190",2,0,0,0,2
"cg05378695",0,0,1,0,1
"cg05379002",57,14,1,0,72
"cg05380167",0,0,1,0,1
"cg05380304",2,0,0,0,2
"cg05380508",0,0,1,0,1
"cg05382973",12,2,1,0,15
"cg05383811",1,0,0,0,1
"cg05384917",0,1,0,0,1
"cg05385128",0,1,0,0,1
"cg05385777",0,5,0,0,5
"cg05385973",0,0,1,0,1
"cg05387083",15,0,0,0,15
"cg05388057",22,5,0,0,27
"cg05388076",0,1,0,0,1
"cg05388715",0,0,1,0,1
"cg05389034",0,1,0,0,1
"cg05389247",100,6,0,0,106
"cg05389467",1,0,0,0,1
"cg05390069",86,376,115,0,577
"cg05390075",1,0,1,0,2
"cg05390117",2,0,2,0,4
"cg05390511",1,0,0,0,1
"cg05390643",0,1,0,0,1
"cg05390924",3,0,1,0,4
"cg05391097",0,3,3,0,6
"cg05391112",3,1,0,0,4
"cg05392008",1,0,1,0,2
"cg05394752",7,1,0,0,8
"cg05395293",0,0,1,0,1
"cg05395323",2,0,0,0,2
"cg05395761",0,1,0,0,1
"cg05395973",0,0,1,0,1
"cg05396112",0,0,1,0,1
"cg05396793",4,0,1,0,5
"cg05397091",0,1,0,0,1
"cg05397362",95,17,0,0,112
"cg05397535",1,0,0,0,1
"cg05397740",0,1,0,0,1
"cg05397870",0,1,0,0,1
"cg05397934",1,0,0,0,1
"cg05398260",0,1,0,0,1
"cg05402314",4,0,0,0,4
"cg05402378",0,1,0,0,1
"cg05403297",7,0,0,0,7
"cg05403431",209,129,6,0,344
"cg05403433",0,0,1,0,1
"cg05403832",2,12,12,0,26
"cg05405674",14,8,1,0,23
"cg05407003",1,2,0,0,3
"cg05407106",1,0,1,0,2
"cg05407191",0,0,1,0,1
"cg05407265",0,0,1,0,1
"cg05408313",21,4,1,0,26
"cg05408674",0,1,0,0,1
"cg05408886",158,159,12,0,329
"cg05409340",0,3,5,0,8
"cg05410950",0,0,2,0,2
"cg05411032",1,0,0,0,1
"cg05411732",4,0,0,0,4
"cg05412139",0,4,0,0,4
"cg05413351",1,0,0,0,1
"cg05415729",0,0,2,0,2
"cg05416055",1,0,0,0,1
"cg05416693",10,4,0,0,14
"cg05417596",1,0,0,0,1
"cg05418246",59,16,0,0,75
"cg05418495",0,0,1,0,1
"cg05418652",0,0,2,0,2
"cg05420166",0,0,1,0,1
"cg05420450",3,0,0,0,3
"cg05421036",2,1,0,0,3
"cg05421143",1,0,0,0,1
"cg05422394",0,0,1,0,1
"cg05422548",2,0,0,0,2
"cg05423723",1,2,0,0,3
"cg05426042",10,0,0,0,10
"cg05426700",0,0,1,0,1
"cg05426853",1,0,0,0,1
"cg05427663",0,0,2,0,2
"cg05428299",1,1,0,0,2
"cg05428452",0,0,1,0,1
"cg05428888",85,10,0,0,95
"cg05429374",0,2,0,0,2
"cg05429466",3,0,0,0,3
"cg05429769",8,7,3,0,18
"cg05430359",0,6,12,0,18
"cg05430387",7,0,0,0,7
"cg05430705",7,3,1,0,11
"cg05431517",2,0,0,0,2
"cg05431656",3,0,0,0,3
"cg05432505",1,0,0,0,1
"cg05432512",0,0,1,0,1
"cg05433004",50,1,0,0,51
"cg05433102",0,0,1,0,1
"cg05433511",4,0,0,0,4
"cg05435398",0,0,1,0,1
"cg05436043",0,1,0,0,1
"cg05436077",1,0,0,0,1
"cg05437087",593,18,0,0,611
"cg05437633",1,0,0,0,1
"cg05438244",0,0,1,0,1
"cg05439258",0,0,3,0,3
"cg05439803",13,7,0,0,20
"cg05439936",1,0,0,0,1
"cg05440980",0,0,1,0,1
"cg05442111",4,0,0,0,4
"cg05442665",0,1,0,0,1
"cg05442782",1,3,0,0,4
"cg05443389",334,73,3,0,410
"cg05443540",1,0,0,0,1
"cg05443937",0,2,0,0,2
"cg05444312",0,0,1,0,1
"cg05444785",0,0,2,0,2
"cg05445006",120,349,73,0,542
"cg05445137",123,59,3,0,185
"cg05445398",1,0,0,0,1
"cg05447498",0,0,1,0,1
"cg05450314",0,1,0,0,1
"cg05450525",3,0,0,0,3
"cg05451250",1,0,0,0,1
"cg05452136",0,0,2,0,2
"cg05453016",3,1,0,0,4
"cg05453042",8,0,0,0,8
"cg05453194",0,0,1,0,1
"cg05453319",12,1,0,0,13
"cg05454064",0,2,0,0,2
"cg05454323",0,1,0,0,1
"cg05455387",16,0,0,0,16
"cg05456482",90,158,3,0,251
"cg05456652",1,0,0,0,1
"cg05457344",4,1,1,0,6
"cg05457845",1,0,0,0,1
"cg05458412",4,0,0,0,4
"cg05458468",0,0,1,0,1
"cg05458915",0,0,1,0,1
"cg05460050",0,0,1,0,1
"cg05462173",168,9,0,0,177
"cg05463515",0,1,0,0,1
"cg05463727",0,0,1,0,1
"cg05465443",0,1,0,0,1
"cg05466248",3,0,0,0,3
"cg05467212",0,2,0,0,2
"cg05467447",38,46,0,0,84
"cg05467472",4,0,0,0,4
"cg05467716",0,1,0,0,1
"cg05468243",161,417,74,0,652
"cg05468303",1,0,0,0,1
"cg05468559",0,4,16,0,20
"cg05469443",2,0,0,0,2
"cg05469706",2,0,3,0,5
"cg05469734",1,1,0,0,2
"cg05470939",3,0,0,0,3
"cg05471382",4,2,0,0,6
"cg05471877",7,3,0,0,10
"cg05472349",7,3,0,0,10
"cg05472420",1,0,1,1,3
"cg05472727",1,0,0,0,1
"cg05472854",0,4,1,0,5
"cg05473146",71,31,1,0,103
"cg05473963",8,0,0,0,8
"cg05475280",2,0,0,0,2
"cg05475782",1,0,0,0,1
"cg05476452",2,0,0,0,2
"cg05476956",3,3,1,0,7
"cg05477078",12,12,0,0,24
"cg05478407",0,0,1,0,1
"cg05478452",0,1,0,0,1
"cg05479471",1,0,0,0,1
"cg05479618",17,0,1,0,18
"cg05481118",1,0,0,0,1
"cg05481196",2,0,0,0,2
"cg05481217",61,6,0,0,67
"cg05483105",1,0,0,0,1
"cg05483459",1,0,0,0,1
"cg05483945",4,1,0,0,5
"cg05484606",169,120,1,0,290
"cg05484985",0,0,1,0,1
"cg05486191",0,0,1,0,1
"cg05486931",0,2,0,0,2
"cg05487635",0,1,0,0,1
"cg05487698",11,3,0,0,14
"cg05487769",1,7,0,0,8
"cg05488403",1,0,0,0,1
"cg05489989",711,225,5,0,941
"cg05491383",0,0,1,0,1
"cg05491661",1,0,1,0,2
"cg05492075",1,1,0,0,2
"cg05492259",0,0,3,0,3
"cg05493162",0,1,0,0,1
"cg05493770",1,0,0,0,1
"cg05494080",0,3,0,0,3
"cg05494401",0,1,0,0,1
"cg05495422",0,0,1,0,1
"cg05496814",0,1,0,0,1
"cg05496988",3,1,0,0,4
"cg05497346",2,1,0,0,3
"cg05498100",149,242,14,0,405
"cg05498710",0,1,0,0,1
"cg05499272",0,1,4,0,5
"cg05499371",11,0,0,0,11
"cg05499527",0,1,0,0,1
"cg05501127",0,1,0,0,1
"cg05504059",1,0,0,0,1
"cg05505003",1,0,0,0,1
"cg05506103",11,7,10,0,28
"cg05506475",0,0,1,0,1
"cg05506566",0,0,2,0,2
"cg05507257",1,1,1,0,3
"cg05507304",0,1,0,0,1
"cg05508698",0,0,1,0,1
"cg05509061",1,0,0,0,1
"cg05509896",1,0,0,0,1
"cg05509965",193,5,0,0,198
"cg05510560",1,0,0,0,1
"cg05511285",1,0,0,0,1
"cg05512482",0,2,0,0,2
"cg05512912",0,0,2,0,2
"cg05513331",0,0,2,0,2
"cg05513576",1,0,0,0,1
"cg05513661",1,0,0,0,1
"cg05514072",1,0,3,0,4
"cg05514886",0,1,0,0,1
"cg05514914",5,2,2,0,9
"cg05515118",1,0,0,0,1
"cg05515244",1,0,0,0,1
"cg05515414",0,0,2,0,2
"cg05516061",451,85,0,0,536
"cg05516746",14,1,0,0,15
"cg05517993",0,1,0,0,1
"cg05518813",1,0,0,0,1
"cg05519080",42,0,0,0,42
"cg05519181",0,0,1,0,1
"cg05519737",0,1,0,0,1
"cg05520109",0,1,0,0,1
"cg05520155",5,5,0,0,10
"cg05520336",1,0,0,0,1
"cg05521364",1,0,0,0,1
"cg05521586",0,1,0,0,1
"cg05522145",1,0,0,0,1
"cg05523032",0,1,0,0,1
"cg05523500",0,0,4,0,4
"cg05524154",0,0,5,0,5
"cg05524489",0,1,0,0,1
"cg05525305",0,3,3,0,6
"cg05525601",0,0,1,0,1
"cg05525888",0,0,3,0,3
"cg05528975",6,4,0,0,10
"cg05528999",0,1,5,0,6
"cg05530021",1,0,0,0,1
"cg05530055",281,67,0,0,348
"cg05530592",0,0,1,0,1
"cg05530790",0,1,0,0,1
"cg05531502",0,1,0,0,1
"cg05531804",6,2,0,0,8
"cg05533326",0,0,1,0,1
"cg05533705",0,4,5,0,9
"cg05535398",1,0,0,0,1
"cg05535877",0,0,2,0,2
"cg05536014",1,0,0,0,1
"cg05540934",1,0,0,0,1
"cg05541329",0,0,2,0,2
"cg05542541",0,1,0,0,1
"cg05543281",0,1,0,0,1
"cg05543341",0,2,0,0,2
"cg05543443",276,67,6,0,349
"cg05544854",1,0,0,0,1
"cg05545813",2,0,0,0,2
"cg05545910",0,3,0,0,3
"cg05546564",2,1,0,0,3
"cg05546741",15,12,1,0,28
"cg05547146",0,0,1,0,1
"cg05547986",0,0,1,0,1
"cg05548956",539,10,0,0,549
"cg05549246",129,46,0,0,175
"cg05549897",1,1,2,0,4
"cg05550202",0,0,2,0,2
"cg05552796",108,23,0,0,131
"cg05553214",1,0,0,0,1
"cg05553502",1,0,0,0,1
"cg05553515",0,1,1,0,2
"cg05554332",0,0,1,0,1
"cg05554346",3,4,0,0,7
"cg05554735",42,1,0,0,43
"cg05555772",0,0,1,0,1
"cg05555951",0,0,1,0,1
"cg05556833",12,23,12,0,47
"cg05557027",1,0,0,1,2
"cg05557315",1,2,0,1,4
"cg05557449",1,0,0,0,1
"cg05558169",0,1,0,0,1
"cg05558259",3,0,4,0,7
"cg05558712",1,0,0,0,1
"cg05558767",0,1,8,0,9
"cg05559398",0,1,0,0,1
"cg05560062",0,5,0,0,5
"cg05564608",0,0,1,0,1
"cg05564657",0,0,1,0,1
"cg05565715",4,0,1,0,5
"cg05566230",0,0,1,0,1
"cg05566434",4,0,0,0,4
"cg05566736",3,1,0,0,4
"cg05567911",0,1,0,0,1
"cg05568311",5,3,0,0,8
"cg05569814",0,0,1,0,1
"cg05569923",0,0,1,0,1
"cg05570315",0,1,0,0,1
"cg05570356",2,0,0,0,2
"cg05571165",1,0,0,0,1
"cg05571581",0,0,1,0,1
"cg05572164",0,1,0,0,1
"cg05572258",1,0,0,0,1
"cg05572362",1,0,0,0,1
"cg05572584",19,1,0,0,20
"cg05573149",70,26,2,0,98
"cg05575220",3,0,0,0,3
"cg05575601",1,2,0,0,3
"cg05575602",0,0,1,0,1
"cg05575961",5,0,0,0,5
"cg05576262",1,0,0,0,1
"cg05576548",1,0,0,0,1
"cg05576550",0,0,2,0,2
"cg05576903",1,0,0,0,1
"cg05577434",1,0,2,0,3
"cg05577596",0,0,0,1,1
"cg05578236",1,0,0,0,1
"cg05579799",1,0,0,0,1
"cg05579861",0,2,4,0,6
"cg05580667",133,1,0,0,134
"cg05580809",1,0,0,0,1
"cg05581880",1,2,4,0,7
"cg05582035",0,0,1,0,1
"cg05582498",4,0,1,0,5
"cg05583965",0,0,1,0,1
"cg05584235",0,0,2,0,2
"cg05586304",2,4,4,1,11
"cg05586315",4,0,0,0,4
"cg05586541",0,0,1,0,1
"cg05587171",0,0,1,0,1
"cg05587870",150,205,81,0,436
"cg05588334",0,0,1,0,1
"cg05589022",20,0,0,0,20
"cg05589964",0,0,1,0,1
"cg05590025",0,0,1,0,1
"cg05591196",109,164,1,0,274
"cg05591348",0,0,1,0,1
"cg05592278",354,126,0,0,480
"cg05593176",0,0,2,0,2
"cg05593792",0,1,0,0,1
"cg05596272",1,0,0,0,1
"cg05596278",145,44,1,0,190
"cg05596328",0,0,0,1,1
"cg05596824",1,0,0,0,1
"cg05596867",0,1,0,0,1
"cg05597003",25,21,12,0,58
"cg05597504",0,0,1,0,1
"cg05597945",0,1,0,0,1
"cg05598452",0,0,1,0,1
"cg05599109",1,0,0,0,1
"cg05599379",0,0,3,0,3
"cg05600833",0,0,2,0,2
"cg05600935",1480,191,6,0,1677
"cg05601211",0,0,1,0,1
"cg05601954",2,0,0,0,2
"cg05604985",3,0,0,0,3
"cg05605445",0,1,0,0,1
"cg05606074",0,2,0,0,2
"cg05607766",1,0,0,0,1
"cg05609091",1,0,0,0,1
"cg05609173",2,1,0,0,3
"cg05609408",0,0,1,0,1
"cg05609414",0,1,0,0,1
"cg05609837",0,1,0,0,1
"cg05609879",0,0,0,1,1
"cg05610699",8,1,3,0,12
"cg05611875",0,1,0,0,1
"cg05611888",0,0,1,0,1
"cg05611958",2,0,0,0,2
"cg05612744",0,0,1,0,1
"cg05612779",5,1,0,0,6
"cg05613829",1,0,0,0,1
"cg05614010",17,10,0,0,27
"cg05614500",101,12,1,0,114
"cg05615220",4,2,1,0,7
"cg05615443",0,1,0,0,1
"cg05615856",0,1,0,0,1
"cg05616994",2,1,0,0,3
"cg05618647",1,0,0,0,1
"cg05618705",1,0,0,0,1
"cg05619158",0,0,1,0,1
"cg05619858",4,0,1,0,5
"cg05619920",0,0,1,0,1
"cg05620791",333,125,1,0,459
"cg05621035",1,1,0,0,2
"cg05621262",1,1,0,0,2
"cg05621759",2,1,1,0,4
"cg05622300",4,2,0,0,6
"cg05623246",8,0,0,0,8
"cg05623762",0,0,1,0,1
"cg05625046",669,52,0,0,721
"cg05626290",3,0,0,0,3
"cg05626516",1,0,0,0,1
"cg05626738",3,1,1,0,5
"cg05626921",1,0,0,0,1
"cg05627663",0,1,0,0,1
"cg05627946",0,0,1,0,1
"cg05629015",1,1,0,0,2
"cg05629861",1,0,0,0,1
"cg05629982",5,5,1,0,11
"cg05630517",0,1,2,0,3
"cg05631429",0,0,1,0,1
"cg05633670",2,0,0,0,2
"cg05634255",140,3,0,0,143
"cg05634467",0,1,0,0,1
"cg05635504",1,0,0,0,1
"cg05635598",0,0,1,0,1
"cg05636891",62,10,0,0,72
"cg05637065",4,7,9,0,20
"cg05637360",4,2,2,0,8
"cg05638056",1,0,1,0,2
"cg05638821",1,0,0,0,1
"cg05640269",0,0,3,0,3
"cg05640992",1,0,0,0,1
"cg05641180",0,2,2,0,4
"cg05641882",0,1,0,0,1
"cg05642024",0,0,3,0,3
"cg05642048",1,0,0,0,1
"cg05643866",1,0,0,0,1
"cg05644017",2,0,0,0,2
"cg05644151",37,9,1,0,47
"cg05644735",328,60,0,0,388
"cg05645557",1,1,0,0,2
"cg05646402",0,2,0,0,2
"cg05646451",1,0,0,0,1
"cg05647695",1,0,0,0,1
"cg05647929",0,0,1,0,1
"cg05647993",2,1,0,0,3
"cg05650309",1,0,0,0,1
"cg05651080",3,2,0,0,5
"cg05651143",0,0,1,0,1
"cg05651292",0,0,1,0,1
"cg05651393",11,2,0,0,13
"cg05651550",3,1,0,0,4
"cg05653423",0,0,1,0,1
"cg05653481",0,0,1,0,1
"cg05653604",106,6,0,0,112
"cg05654197",0,1,0,0,1
"cg05654913",1,1,0,0,2
"cg05655127",0,0,1,0,1
"cg05655390",0,1,0,0,1
"cg05657251",1,1,0,0,2
"cg05657443",3,5,1,0,9
"cg05658036",1,0,0,0,1
"cg05658414",21,31,0,0,52
"cg05659202",22,4,0,0,26
"cg05659741",0,1,1,0,2
"cg05660005",0,1,0,0,1
"cg05662829",0,0,1,0,1
"cg05665427",0,0,1,0,1
"cg05665768",0,3,0,0,3
"cg05666160",1,0,0,0,1
"cg05666200",0,0,1,0,1
"cg05666458",0,0,1,0,1
"cg05666526",132,272,70,0,474
"cg05667581",0,0,1,0,1
"cg05668158",0,3,0,0,3
"cg05668807",5,1,0,0,6
"cg05669672",0,1,0,0,1
"cg05669709",1,0,0,0,1
"cg05669845",0,1,1,0,2
"cg05669848",1,1,0,0,2
"cg05672487",0,1,0,0,1
"cg05672967",0,0,1,0,1
"cg05673425",2,1,0,0,3
"cg05674444",0,1,1,0,2
"cg05674692",0,1,1,0,2
"cg05675317",0,1,0,0,1
"cg05676046",331,11,14,0,356
"cg05676261",1,1,0,0,2
"cg05676315",1,0,0,0,1
"cg05676915",0,0,1,0,1
"cg05677520",0,0,3,0,3
"cg05677694",0,0,1,0,1
"cg05678976",0,0,6,0,6
"cg05680457",0,1,0,0,1
"cg05680662",0,0,1,0,1
"cg05680926",24,3,0,0,27
"cg05682639",0,1,5,0,6
"cg05682651",0,0,1,0,1
"cg05683999",2,3,0,0,5
"cg05684371",0,0,0,1,1
"cg05684665",104,29,0,0,133
"cg05685579",0,0,1,0,1
"cg05686709",2,0,0,0,2
"cg05687551",636,122,0,0,758
"cg05687710",0,0,1,0,1
"cg05688809",2,0,0,0,2
"cg05690286",0,0,1,0,1
"cg05690360",1,2,0,0,3
"cg05691383",0,0,1,0,1
"cg05691448",9,9,0,0,18
"cg05691530",1,0,0,0,1
"cg05692440",1,0,0,0,1
"cg05693611",0,1,0,0,1
"cg05693721",0,0,1,0,1
"cg05694771",6,2,0,0,8
"cg05695327",0,0,1,1,2
"cg05696368",0,1,0,0,1
"cg05696678",12,2,0,0,14
"cg05697788",2,2,1,0,5
"cg05697832",0,1,0,0,1
"cg05697969",2,0,0,0,2
"cg05698117",1,0,0,0,1
"cg05699123",1,0,0,0,1
"cg05699618",2,1,0,0,3
"cg05699806",0,1,0,0,1
"cg05700141",2,3,3,0,8
"cg05701114",0,1,0,0,1
"cg05701765",0,0,1,0,1
"cg05702459",1,0,0,0,1
"cg05702599",0,0,1,0,1
"cg05702725",13,4,0,0,17
"cg05702779",1,0,0,0,1
"cg05703112",0,0,2,0,2
"cg05704630",71,3,0,0,74
"cg05706649",9,6,0,0,15
"cg05708731",0,1,0,0,1
"cg05710561",0,0,1,0,1
"cg05710730",0,1,2,0,3
"cg05711047",6,3,2,0,11
"cg05711133",95,16,2,0,113
"cg05711688",2,0,0,0,2
"cg05712202",0,0,1,0,1
"cg05712380",12,5,0,0,17
"cg05712403",0,0,1,0,1
"cg05713149",1,0,0,0,1
"cg05713206",2,0,0,0,2
"cg05716269",0,1,0,0,1
"cg05716817",0,2,0,0,2
"cg05717050",8,7,0,0,15
"cg05717250",0,5,0,0,5
"cg05717965",154,399,1,0,554
"cg05719181",0,0,1,0,1
"cg05719686",2,0,0,0,2
"cg05720286",0,0,1,0,1
"cg05720822",0,0,1,0,1
"cg05720980",3,3,1,0,7
"cg05721365",1,0,0,0,1
"cg05721374",28,2,0,0,30
"cg05723200",0,0,1,0,1
"cg05723877",0,0,1,0,1
"cg05727710",1,0,0,0,1
"cg05727934",0,0,1,0,1
"cg05728282",0,3,1,0,4
"cg05729794",291,11,0,0,302
"cg05731278",6,3,0,0,9
"cg05731556",1,0,0,0,1
"cg05732081",20,3,1,0,24
"cg05732579",1,3,0,0,4
"cg05733891",11,0,0,0,11
"cg05734611",0,1,0,0,1
"cg05735384",0,0,1,0,1
"cg05737644",1,1,0,0,2
"cg05738251",38,5,0,0,43
"cg05738580",0,1,2,0,3
"cg05738750",0,0,5,0,5
"cg05739419",2,0,0,0,2
"cg05740024",0,0,2,0,2
"cg05740465",0,0,1,0,1
"cg05740567",0,0,2,0,2
"cg05740793",0,0,1,1,2
"cg05742286",1,0,0,0,1
"cg05742993",0,2,0,0,2
"cg05743982",0,0,1,0,1
"cg05744043",1,0,0,0,1
"cg05744470",0,1,0,0,1
"cg05745461",0,1,0,0,1
"cg05750635",0,0,1,0,1
"cg05751183",7,4,15,0,26
"cg05753470",21,9,2,0,32
"cg05754408",0,0,0,1,1
"cg05754632",3,0,0,0,3
"cg05754968",0,0,1,0,1
"cg05755017",2,0,0,0,2
"cg05755521",0,0,1,0,1
"cg05756457",0,0,4,0,4
"cg05758419",0,0,1,0,1
"cg05758906",0,0,1,0,1
"cg05759316",7,0,1,0,8
"cg05760417",0,0,1,0,1
"cg05760947",1,0,0,0,1
"cg05760951",0,0,6,0,6
"cg05762578",20,4,0,0,24
"cg05763295",7,2,0,0,9
"cg05763799",1,0,0,0,1
"cg05764010",3,1,0,0,4
"cg05764111",1,0,0,0,1
"cg05764431",1,2,4,0,7
"cg05764570",1,1,0,0,2
"cg05764975",1,4,2,0,7
"cg05765449",3,0,0,0,3
"cg05766129",1,0,0,0,1
"cg05766963",0,0,1,0,1
"cg05768328",0,0,1,0,1
"cg05769097",60,3,0,0,63
"cg05769106",1,0,0,0,1
"cg05769108",3,1,0,0,4
"cg05769334",0,0,1,0,1
"cg05771132",0,0,1,0,1
"cg05771578",1,0,0,0,1
"cg05771730",1,0,0,0,1
"cg05773164",211,544,6,0,761
"cg05774037",1,0,0,0,1
"cg05774464",2,0,0,0,2
"cg05775012",2,0,0,0,2
"cg05775372",0,7,13,0,20
"cg05775796",0,3,0,0,3
"cg05777672",39,2,0,0,41
"cg05777877",1,0,1,0,2
"cg05778080",1,1,1,0,3
"cg05778440",0,1,0,0,1
"cg05779088",0,0,1,0,1
"cg05779559",0,1,0,0,1
"cg05779815",1,0,0,0,1
"cg05780883",0,0,2,0,2
"cg05781294",0,0,1,0,1
"cg05781417",4,2,1,0,7
"cg05782078",1,0,0,0,1
"cg05783049",2,0,0,0,2
"cg05783303",0,1,0,0,1
"cg05783455",0,1,0,0,1
"cg05783727",1,0,0,0,1
"cg05783844",191,72,6,0,269
"cg05784226",0,1,0,0,1
"cg05784856",14,0,0,0,14
"cg05787038",3,0,0,0,3
"cg05787294",2,0,0,0,2
"cg05787509",1,0,0,0,1
"cg05789702",0,1,0,0,1
"cg05789736",1,0,0,0,1
"cg05789974",0,3,7,0,10
"cg05790941",2,0,0,0,2
"cg05791411",1,0,0,0,1
"cg05792649",1,0,0,0,1
"cg05793444",13,0,0,0,13
"cg05794086",3,0,0,0,3
"cg05794182",0,0,2,0,2
"cg05795861",16,3,2,0,21
"cg05796223",0,0,2,0,2
"cg05796504",2,0,0,0,2
"cg05796571",1,1,0,0,2
"cg05797594",1,0,0,0,1
"cg05797929",0,0,1,0,1
"cg05798223",0,2,1,0,3
"cg05800723",0,1,2,0,3
"cg05801329",1,0,0,0,1
"cg05801628",0,1,0,0,1
"cg05803138",0,2,6,0,8
"cg05803989",0,0,4,0,4
"cg05804037",2,9,3,0,14
"cg05804598",0,1,1,0,2
"cg05806180",0,0,1,0,1
"cg05807023",11,1,0,0,12
"cg05808783",5,2,0,0,7
"cg05808815",1,0,0,0,1
"cg05809217",72,1,0,0,73
"cg05809395",3,0,0,0,3
"cg05811739",3,0,0,0,3
"cg05812299",5,9,1,0,15
"cg05812492",7,2,1,0,10
"cg05813152",0,1,0,0,1
"cg05813328",0,1,0,0,1
"cg05813532",0,1,0,0,1
"cg05814351",0,0,1,0,1
"cg05815247",1,0,0,0,1
"cg05816971",119,182,75,0,376
"cg05817295",0,1,3,0,4
"cg05817765",0,0,6,0,6
"cg05818532",0,0,2,0,2
"cg05818613",3,2,0,0,5
"cg05818864",1,0,0,0,1
"cg05819186",402,226,1,0,629
"cg05819221",2,0,0,0,2
"cg05820281",1,0,0,0,1
"cg05823038",0,0,1,0,1
"cg05823124",0,1,0,0,1
"cg05823818",19,0,0,0,19
"cg05824755",0,0,1,0,1
"cg05825085",0,2,0,0,2
"cg05825127",0,1,0,0,1
"cg05825459",6,1,0,0,7
"cg05825822",13,2,0,0,15
"cg05825950",1,0,0,0,1
"cg05827751",1,0,1,0,2
"cg05828640",48,2,0,0,50
"cg05828710",863,191,0,0,1054
"cg05831747",0,1,0,0,1
"cg05831907",304,247,2,0,553
"cg05832496",2,0,0,0,2
"cg05833629",116,8,0,0,124
"cg05834378",14,11,1,0,26
"cg05834728",19,4,0,0,23
"cg05835009",0,3,3,0,6
"cg05835309",0,0,2,0,2
"cg05836286",0,0,2,0,2
"cg05836646",3,0,0,0,3
"cg05837053",0,0,1,0,1
"cg05837142",0,1,0,0,1
"cg05837990",5,0,0,0,5
"cg05838667",1,0,0,0,1
"cg05839553",1,0,0,0,1
"cg05839741",0,0,1,0,1
"cg05840010",1,1,0,0,2
"cg05840127",5,3,0,0,8
"cg05840263",0,0,2,0,2
"cg05840289",1,0,0,0,1
"cg05841722",1,0,0,0,1
"cg05842036",0,0,1,0,1
"cg05842120",3,0,0,0,3
"cg05842260",3,0,0,0,3
"cg05843312",0,0,1,0,1
"cg05843946",1,0,0,0,1
"cg05843966",16,1,0,0,17
"cg05844315",0,2,0,0,2
"cg05844402",654,178,8,0,840
"cg05845204",1,0,0,0,1
"cg05845253",0,0,1,0,1
"cg05845566",0,0,1,0,1
"cg05845689",0,1,0,0,1
"cg05846244",0,2,19,0,21
"cg05846642",0,1,0,0,1
"cg05847664",0,0,1,0,1
"cg05848279",0,0,2,0,2
"cg05848463",1,2,2,0,5
"cg05848545",1,0,0,0,1
"cg05848834",1,0,0,0,1
"cg05849499",4,7,3,0,14
"cg05850729",7,3,0,0,10
"cg05850871",0,0,1,0,1
"cg05850997",2,0,0,0,2
"cg05851493",0,0,1,0,1
"cg05852698",70,6,0,0,76
"cg05853159",1,0,0,0,1
"cg05853266",1,4,0,0,5
"cg05856015",0,3,0,0,3
"cg05858115",99,8,0,0,107
"cg05858354",1,5,0,0,6
"cg05858612",0,1,0,0,1
"cg05860102",0,0,2,0,2
"cg05862979",1,0,0,0,1
"cg05864011",0,0,2,0,2
"cg05864151",2,0,0,0,2
"cg05865243",1,7,3,0,11
"cg05865822",4,8,0,0,12
"cg05866132",0,1,0,0,1
"cg05867412",7,3,1,0,11
"cg05867534",0,1,0,0,1
"cg05868039",1,0,0,0,1
"cg05869126",0,0,1,0,1
"cg05869429",0,1,0,0,1
"cg05870631",8,1,2,0,11
"cg05870876",5,0,0,0,5
"cg05871101",0,0,1,0,1
"cg05871585",6,1,3,0,10
"cg05872026",0,0,1,0,1
"cg05872443",13,1,0,0,14
"cg05873111",1,0,2,0,3
"cg05873268",0,0,2,0,2
"cg05874167",220,178,16,0,414
"cg05874478",0,0,1,0,1
"cg05877767",208,121,6,0,335
"cg05878804",0,1,0,0,1
"cg05879324",12,6,2,0,20
"cg05879335",0,0,1,0,1
"cg05880137",2,1,0,0,3
"cg05880813",2,0,0,0,2
"cg05881391",3,0,0,0,3
"cg05881808",0,0,1,0,1
"cg05882426",0,1,1,0,2
"cg05882646",4,0,0,0,4
"cg05882673",12,0,0,0,12
"cg05882675",4,0,0,0,4
"cg05883299",0,1,0,0,1
"cg05884023",1,2,0,0,3
"cg05884988",12,1,0,0,13
"cg05885161",1,0,0,0,1
"cg05886386",0,0,1,0,1
"cg05886469",209,119,6,0,334
"cg05887128",0,1,0,0,1
"cg05887153",1,0,0,0,1
"cg05887787",1,9,8,0,18
"cg05888947",0,0,1,0,1
"cg05890230",16,6,0,0,22
"cg05891094",0,0,1,0,1
"cg05891869",5,2,3,0,10
"cg05892902",2,2,3,0,7
"cg05894907",0,0,1,0,1
"cg05895077",3,0,0,0,3
"cg05896120",3,1,11,0,15
"cg05897583",1,0,0,0,1
"cg05897615",1202,120,0,0,1322
"cg05898113",0,0,5,0,5
"cg05899183",1,0,0,0,1
"cg05899741",0,1,1,0,2
"cg05900045",14,0,0,0,14
"cg05900177",0,2,0,0,2
"cg05900785",0,2,0,0,2
"cg05901483",0,0,1,0,1
"cg05901522",0,1,0,0,1
"cg05901786",1,0,3,0,4
"cg05901895",0,1,0,0,1
"cg05901917",0,1,1,0,2
"cg05902460",0,1,0,0,1
"cg05902791",2,0,0,0,2
"cg05903046",2,0,0,0,2
"cg05905475",10,14,1,0,25
"cg05905523",1,0,0,0,1
"cg05906717",223,135,18,0,376
"cg05907136",0,0,2,0,2
"cg05907976",1,3,0,0,4
"cg05908242",0,0,1,0,1
"cg05908815",0,1,1,0,2
"cg05910970",1,0,0,0,1
"cg05911100",1,0,4,0,5
"cg05911765",3,2,2,0,7
"cg05913586",7,2,0,0,9
"cg05913712",0,0,1,0,1
"cg05914423",11,5,1,0,17
"cg05914507",1,1,0,0,2
"cg05915116",0,0,2,0,2
"cg05915809",4,0,1,0,5
"cg05916255",60,186,552,0,798
"cg05919122",0,5,0,0,5
"cg05919161",237,141,16,0,394
"cg05919690",0,0,1,0,1
"cg05920042",0,0,1,0,1
"cg05920539",10,3,0,0,13
"cg05922028",0,0,1,0,1
"cg05922089",6,0,0,0,6
"cg05922422",37,2,0,0,39
"cg05923759",1,0,0,0,1
"cg05924485",1,0,0,0,1
"cg05924543",1,1,2,0,4
"cg05925577",0,1,15,0,16
"cg05925839",0,4,0,0,4
"cg05925949",0,1,0,0,1
"cg05926314",4,0,0,0,4
"cg05928218",2,0,0,0,2
"cg05929974",29,15,2,0,46
"cg05930008",0,1,0,0,1
"cg05930173",0,0,1,0,1
"cg05932005",0,0,1,0,1
"cg05932230",0,0,1,0,1
"cg05932258",0,1,0,0,1
"cg05932351",129,411,29,0,569
"cg05932828",1,0,0,0,1
"cg05933074",4,0,0,0,4
"cg05933456",15,0,0,0,15
"cg05933703",0,0,2,0,2
"cg05933846",0,0,1,0,1
"cg05933904",1,0,0,0,1
"cg05934315",13,2,0,0,15
"cg05934783",0,0,1,0,1
"cg05935660",14,1,0,0,15
"cg05935774",216,17,0,0,233
"cg05935833",0,0,1,0,1
"cg05936219",0,0,1,0,1
"cg05936337",6,3,0,0,9
"cg05936432",0,1,0,0,1
"cg05936464",0,0,1,0,1
"cg05936503",8,0,0,0,8
"cg05938012",1,0,0,0,1
"cg05938316",0,1,0,0,1
"cg05938524",0,1,0,0,1
"cg05938958",0,2,0,0,2
"cg05939513",0,1,0,0,1
"cg05939907",0,0,2,0,2
"cg05939965",1,0,0,0,1
"cg05940861",0,1,3,0,4
"cg05941060",1,12,3,0,16
"cg05941299",1,1,0,0,2
"cg05941585",1,0,0,0,1
"cg05942449",32,7,1,0,40
"cg05942558",4,0,1,0,5
"cg05943200",1,0,0,0,1
"cg05944468",0,1,0,0,1
"cg05944551",10,4,0,0,14
"cg05944599",0,0,1,0,1
"cg05945013",0,1,0,0,1
"cg05945314",0,1,2,0,3
"cg05945487",1,0,0,0,1
"cg05945584",0,0,1,0,1
"cg05946020",0,0,1,0,1
"cg05946171",0,6,2,0,8
"cg05946262",0,1,0,0,1
"cg05947649",0,0,1,0,1
"cg05948389",0,0,2,0,2
"cg05949379",0,0,0,2,2
"cg05949483",18,0,0,0,18
"cg05949576",1,1,0,0,2
"cg05949877",2,0,0,0,2
"cg05950018",1,1,2,0,4
"cg05950498",0,1,0,0,1
"cg05951044",0,0,0,1,1
"cg05951425",0,2,9,0,11
"cg05952186",0,0,1,0,1
"cg05952192",24,0,0,0,24
"cg05952909",0,2,0,0,2
"cg05953124",0,1,0,0,1
"cg05953316",0,0,1,0,1
"cg05954339",2,7,0,0,9
"cg05954614",0,6,5,0,11
"cg05956679",0,0,1,0,1
"cg05957436",0,0,2,0,2
"cg05957603",1,0,1,0,2
"cg05957730",1,0,0,0,1
"cg05959241",1,0,0,0,1
"cg05961707",22,1,0,0,23
"cg05961721",0,0,1,0,1
"cg05962452",0,0,1,0,1
"cg05963872",1,0,0,0,1
"cg05963962",0,0,1,0,1
"cg05965029",0,1,0,0,1
"cg05965288",0,2,0,0,2
"cg05966241",6,0,0,0,6
"cg05966375",3,1,0,0,4
"cg05966988",0,1,0,0,1
"cg05970660",2,7,12,0,21
"cg05971373",0,0,2,0,2
"cg05971513",0,0,1,0,1
"cg05971818",0,1,0,0,1
"cg05971876",0,0,1,0,1
"cg05972376",0,0,1,0,1
"cg05973337",0,0,1,0,1
"cg05974455",0,1,0,0,1
"cg05975490",1,0,2,0,3
"cg05976179",700,50,0,0,750
"cg05976623",4,0,0,0,4
"cg05977558",403,19,0,0,422
"cg05978071",0,2,1,0,3
"cg05980194",1,0,0,0,1
"cg05980673",3,2,4,0,9
"cg05980726",4,3,0,0,7
"cg05981425",0,0,2,0,2
"cg05981896",0,1,2,0,3
"cg05982863",0,0,1,0,1
"cg05983906",1,1,1,0,3
"cg05983987",2,4,2,0,8
"cg05985066",1,0,1,0,2
"cg05985401",3,4,3,0,10
"cg05985522",1,0,0,0,1
"cg05986195",1,0,0,0,1
"cg05986831",1,0,0,0,1
"cg05987077",20,50,45,0,115
"cg05987172",185,13,2,0,200
"cg05987389",160,164,0,0,324
"cg05987548",0,0,1,0,1
"cg05987567",0,0,1,0,1
"cg05988129",1,0,0,0,1
"cg05988315",0,0,1,0,1
"cg05988638",1,0,0,0,1
"cg05989089",0,0,1,0,1
"cg05989423",0,0,3,0,3
"cg05989669",0,0,0,1,1
"cg05990106",0,0,1,0,1
"cg05990812",73,32,0,0,105
"cg05991857",0,3,1,0,4
"cg05992412",238,66,1,0,305
"cg05992829",15,6,1,0,22
"cg05993665",31,12,2,0,45
"cg05995572",2,5,1,0,8
"cg05996240",0,0,2,0,2
"cg05996573",0,0,1,0,1
"cg05996727",0,0,2,0,2
"cg05998064",0,1,2,0,3
"cg05998089",1,0,0,0,1
"cg05998507",0,0,1,0,1
"cg05999195",0,1,1,0,2
"cg05999368",0,2,5,0,7
"cg06000784",6,2,0,0,8
"cg06001854",89,171,26,0,286
"cg06001976",0,0,2,0,2
"cg06002196",1,0,0,0,1
"cg06002477",0,1,1,0,2
"cg06003040",2,0,0,0,2
"cg06003083",6,0,0,0,6
"cg06003594",0,0,1,0,1
"cg06006574",0,0,1,0,1
"cg06006633",2,0,0,0,2
"cg06008759",0,0,1,0,1
"cg06008853",0,0,1,0,1
"cg06010111",0,1,0,0,1
"cg06010659",4,1,0,0,5
"cg06011441",0,0,3,0,3
"cg06011544",189,126,21,0,336
"cg06011776",10,1,0,0,11
"cg06011925",3,0,0,0,3
"cg06012730",2,2,0,0,4
"cg06012959",4,0,0,0,4
"cg06012992",0,0,2,0,2
"cg06013840",2,0,0,0,2
"cg06014474",2,0,0,0,2
"cg06014557",0,1,0,0,1
"cg06016857",0,3,3,0,6
"cg06018447",189,455,84,0,728
"cg06019692",0,0,1,0,1
"cg06020448",0,0,4,0,4
"cg06021734",1,0,0,0,1
"cg06021910",58,8,0,0,66
"cg06023066",0,0,1,0,1
"cg06023279",0,0,1,0,1
"cg06023295",0,0,1,0,1
"cg06023341",5,0,0,0,5
"cg06025636",5,3,1,0,9
"cg06025872",0,0,1,0,1
"cg06025906",0,0,1,0,1
"cg06025981",2,1,12,0,15
"cg06026296",0,1,0,0,1
"cg06026334",3,0,0,0,3
"cg06026769",1,3,0,2,6
"cg06026880",1,0,0,0,1
"cg06027613",0,0,5,0,5
"cg06027699",0,1,0,0,1
"cg06028557",1,0,0,0,1
"cg06029268",459,286,16,0,761
"cg06030056",0,1,0,0,1
"cg06030761",0,0,1,0,1
"cg06031493",0,1,2,0,3
"cg06031526",113,9,0,0,122
"cg06031536",1,0,0,0,1
"cg06031695",4,2,0,0,6
"cg06032479",1,0,0,0,1
"cg06032830",5,2,0,0,7
"cg06032910",0,0,1,0,1
"cg06033407",998,164,1,0,1163
"cg06033836",0,0,2,0,2
"cg06034437",103,2,0,0,105
"cg06034708",0,1,0,0,1
"cg06035437",0,2,0,0,2
"cg06035525",0,0,3,0,3
"cg06037511",1,5,1,0,7
"cg06038247",0,0,5,0,5
"cg06038274",1,0,0,0,1
"cg06039131",0,1,0,0,1
"cg06039171",1,0,0,0,1
"cg06040664",2,0,0,0,2
"cg06041805",0,1,0,0,1
"cg06042012",1,1,0,0,2
"cg06044794",456,123,9,0,588
"cg06046479",1,0,0,0,1
"cg06046629",1,0,0,0,1
"cg06047195",0,0,1,0,1
"cg06048556",0,0,1,0,1
"cg06048766",1,0,0,0,1
"cg06049751",0,0,1,0,1
"cg06050058",0,1,0,0,1
"cg06050784",0,1,0,0,1
"cg06051442",0,1,0,0,1
"cg06052037",393,37,0,0,430
"cg06053056",3,4,1,0,8
"cg06053973",0,1,0,0,1
"cg06055190",0,1,1,0,2
"cg06055745",1,0,0,0,1
"cg06056644",0,0,2,0,2
"cg06056951",1,0,0,0,1
"cg06057010",1,0,0,0,1
"cg06057059",0,1,0,0,1
"cg06058079",289,40,18,0,347
"cg06058235",0,0,2,0,2
"cg06058958",120,5,0,0,125
"cg06058998",1,0,0,0,1
"cg06059332",150,4,0,0,154
"cg06060244",75,162,84,0,321
"cg06060551",1,0,0,0,1
"cg06060740",0,0,1,0,1
"cg06061449",0,1,7,0,8
"cg06061492",7,2,0,0,9
"cg06061636",3,1,0,0,4
"cg06061787",9,1,0,0,10
"cg06062147",5,6,0,0,11
"cg06062571",0,1,1,0,2
"cg06063209",0,1,4,0,5
"cg06064618",0,0,1,0,1
"cg06065102",2,5,3,0,10
"cg06065612",1,0,0,0,1
"cg06065800",0,2,4,0,6
"cg06066248",11,2,0,0,13
"cg06066596",0,2,3,0,5
"cg06066614",0,0,3,0,3
"cg06066734",1,0,1,0,2
"cg06067884",7,1,0,0,8
"cg06068557",1,0,0,0,1
"cg06068711",1,0,0,0,1
"cg06069441",0,0,1,0,1
"cg06070269",0,0,1,0,1
"cg06070958",3,0,0,0,3
"cg06071797",1,0,0,0,1
"cg06071868",1,0,0,0,1
"cg06072091",0,1,0,0,1
"cg06072965",1,1,9,0,11
"cg06073147",404,112,4,0,520
"cg06073348",2,22,2,0,26
"cg06073550",207,154,37,0,398
"cg06074073",90,874,10,0,974
"cg06074235",2,0,0,0,2
"cg06074448",3,9,18,0,30
"cg06074873",157,796,34,0,987
"cg06075355",6,0,0,0,6
"cg06078612",7,3,0,0,10
"cg06079620",0,0,1,0,1
"cg06079996",0,0,1,0,1
"cg06080712",3,3,2,0,8
"cg06081402",2,3,4,0,9
"cg06081722",0,1,1,0,2
"cg06082013",0,0,1,0,1
"cg06082228",702,84,2,0,788
"cg06082293",174,268,37,0,479
"cg06083830",0,0,1,0,1
"cg06084244",1,0,8,0,9
"cg06084312",0,1,2,0,3
"cg06084379",81,4,0,0,85
"cg06085647",37,1,0,0,38
"cg06085805",5,3,0,0,8
"cg06086071",1,0,0,0,1
"cg06086598",0,1,0,0,1
"cg06086816",0,1,0,0,1
"cg06087028",2,3,2,0,7
"cg06087473",6,4,0,0,10
"cg06089829",469,48,0,0,517
"cg06090569",0,0,1,0,1
"cg06091642",1,0,1,0,2
"cg06092094",2,2,0,0,4
"cg06092382",16,2,0,0,18
"cg06092573",63,2,0,0,65
"cg06093249",0,0,1,0,1
"cg06093522",2,1,0,0,3
"cg06093801",2,3,0,0,5
"cg06094400",1,0,0,0,1
"cg06094882",0,1,0,0,1
"cg06095190",0,1,0,0,1
"cg06095195",2,0,1,0,3
"cg06095202",6,6,3,0,15
"cg06095510",3,7,0,0,10
"cg06096139",0,0,1,0,1
"cg06096602",0,0,1,0,1
"cg06096746",0,1,0,0,1
"cg06098639",3,1,0,0,4
"cg06099703",0,0,1,0,1
"cg06100231",0,1,1,0,2
"cg06100680",8,1,0,0,9
"cg06101212",1,0,0,0,1
"cg06102397",8,0,0,0,8
"cg06103264",0,3,2,0,5
"cg06104137",0,1,0,0,1
"cg06104251",0,1,0,0,1
"cg06105068",6,4,0,0,10
"cg06105768",0,0,1,0,1
"cg06105867",0,0,1,0,1
"cg06106495",1,0,0,0,1
"cg06109013",0,0,1,0,1
"cg06109348",0,0,1,0,1
"cg06109812",1,0,0,0,1
"cg06109894",0,0,1,0,1
"cg06110622",2,0,0,0,2
"cg06111133",49,71,3,0,123
"cg06112092",1,0,0,0,1
"cg06112395",1,0,0,0,1
"cg06112454",0,1,0,0,1
"cg06112835",0,1,0,0,1
"cg06113303",2,1,1,0,4
"cg06113354",1,0,1,0,2
"cg06114361",1,0,0,0,1
"cg06117241",1,0,0,0,1
"cg06117243",0,3,0,0,3
"cg06117597",1,0,1,0,2
"cg06118213",4,2,1,0,7
"cg06118546",0,1,0,0,1
"cg06119128",0,1,0,0,1
"cg06119370",0,0,1,0,1
"cg06119558",82,4,0,0,86
"cg06120379",0,0,1,0,1
"cg06122509",1,0,1,0,2
"cg06122660",0,0,1,0,1
"cg06123714",33,3,1,0,37
"cg06124081",357,19,0,0,376
"cg06124356",1,0,0,0,1
"cg06125762",136,44,2,0,182
"cg06126405",3,0,0,0,3
"cg06127781",0,0,1,0,1
"cg06127902",0,1,0,0,1
"cg06128043",4,0,0,0,4
"cg06128598",0,0,1,0,1
"cg06130303",0,0,1,0,1
"cg06130614",0,1,0,0,1
"cg06131149",10,1,0,0,11
"cg06131377",0,0,1,0,1
"cg06131753",1,0,0,0,1
"cg06133392",2,1,3,0,6
"cg06134820",2,2,1,0,5
"cg06135887",43,1,0,0,44
"cg06136879",2,0,0,0,2
"cg06137864",0,0,1,0,1
"cg06138195",1,1,0,0,2
"cg06139343",0,1,0,0,1
"cg06139384",2,0,0,0,2
"cg06142509",0,2,0,0,2
"cg06143204",1,1,0,0,2
"cg06143839",5,0,0,0,5
"cg06145929",1,0,0,0,1
"cg06145931",4,0,0,0,4
"cg06146502",0,0,1,0,1
"cg06148342",0,1,0,0,1
"cg06148997",1,2,4,0,7
"cg06150454",1,1,0,0,2
"cg06151381",0,0,1,0,1
"cg06151505",268,155,19,0,442
"cg06151558",0,0,1,0,1
"cg06151725",76,1,0,0,77
"cg06153467",0,1,1,0,2
"cg06153799",278,8,0,0,286
"cg06154111",0,0,2,0,2
"cg06156289",1,1,1,0,3
"cg06156859",0,1,0,0,1
"cg06157170",0,0,1,0,1
"cg06157408",0,0,1,0,1
"cg06157628",1,0,0,0,1
"cg06157749",44,6,0,0,50
"cg06158589",0,0,1,0,1
"cg06158935",1,0,0,0,1
"cg06160295",2,0,0,0,2
"cg06160572",0,2,0,0,2
"cg06160841",3,0,0,0,3
"cg06161698",0,0,1,0,1
"cg06161864",0,0,1,0,1
"cg06162377",7,5,0,0,12
"cg06163002",0,1,0,0,1
"cg06164744",1,0,0,0,1
"cg06164953",0,0,1,0,1
"cg06165161",1,0,0,0,1
"cg06166547",1,0,0,0,1
"cg06167524",2,0,0,0,2
"cg06168585",1,0,0,0,1
"cg06169557",0,1,0,0,1
"cg06169753",0,0,1,0,1
"cg06169864",0,0,0,1,1
"cg06170080",3,0,2,0,5
"cg06170203",0,0,1,0,1
"cg06170318",0,1,0,0,1
"cg06172939",0,0,1,0,1
"cg06173103",476,52,1,0,529
"cg06173978",0,1,2,0,3
"cg06174858",0,0,1,0,1
"cg06175075",0,1,1,0,2
"cg06175773",0,0,1,0,1
"cg06176532",36,0,0,0,36
"cg06177002",0,0,1,0,1
"cg06177665",2,0,0,0,2
"cg06177754",1,0,1,0,2
"cg06178123",5,1,8,0,14
"cg06180137",0,0,0,1,1
"cg06180519",1,0,0,0,1
"cg06181670",3,1,0,0,4
"cg06182064",0,0,1,0,1
"cg06182196",121,69,18,0,208
"cg06182811",1,0,0,0,1
"cg06183354",6,6,3,0,15
"cg06183872",0,0,4,0,4
"cg06184547",0,0,2,0,2
"cg06184870",0,0,1,0,1
"cg06184906",1,0,0,0,1
"cg06185515",5,3,0,0,8
"cg06185681",5,2,0,0,7
"cg06186295",22,40,20,0,82
"cg06186440",0,1,0,0,1
"cg06187584",0,0,1,0,1
"cg06189555",0,1,0,0,1
"cg06189904",1,0,0,0,1
"cg06192058",5,6,2,0,13
"cg06192818",4,2,1,0,7
"cg06192895",0,1,4,0,5
"cg06193286",0,2,0,0,2
"cg06193995",21,2,0,0,23
"cg06194003",0,0,1,0,1
"cg06195525",1,0,0,0,1
"cg06196636",9,4,0,0,13
"cg06198390",1,2,1,0,4
"cg06199566",10,4,0,0,14
"cg06199753",1,0,0,0,1
"cg06200670",0,0,1,0,1
"cg06201512",46,54,9,0,109
"cg06201950",0,0,3,0,3
"cg06202470",24,3,0,0,27
"cg06202582",0,0,1,0,1
"cg06203720",0,0,1,0,1
"cg06203912",10,6,6,0,22
"cg06204482",0,0,1,0,1
"cg06205172",0,0,1,0,1
"cg06205244",5,1,0,0,6
"cg06206793",0,0,11,0,11
"cg06206898",0,0,1,0,1
"cg06208158",1,0,0,0,1
"cg06209217",0,0,1,0,1
"cg06211041",438,37,1,0,476
"cg06212318",6,1,0,0,7
"cg06212945",0,3,1,0,4
"cg06213233",0,1,0,0,1
"cg06213484",1,0,0,0,1
"cg06213807",51,79,193,0,323
"cg06213876",0,2,0,0,2
"cg06214334",2,0,1,0,3
"cg06214670",0,1,0,0,1
"cg06214938",76,76,19,0,171
"cg06215035",1,0,0,0,1
"cg06215255",2,1,0,0,3
"cg06215556",54,209,49,0,312
"cg06215683",2,0,0,0,2
"cg06215859",0,0,2,0,2
"cg06216009",0,1,0,0,1
"cg06216103",3,0,0,0,3
"cg06216408",2,1,0,0,3
"cg06217071",2,0,5,0,7
"cg06217788",0,1,0,0,1
"cg06219027",0,2,0,0,2
"cg06219204",0,1,0,0,1
"cg06220837",0,2,1,0,3
"cg06221172",0,0,1,0,1
"cg06221712",0,0,1,0,1
"cg06222979",0,0,4,0,4
"cg06223984",6,0,0,0,6
"cg06224632",1,0,0,0,1
"cg06224849",0,0,1,0,1
"cg06225390",0,0,1,0,1
"cg06227268",1,0,0,0,1
"cg06227614",1,0,0,0,1
"cg06228591",7,1,0,0,8
"cg06230599",3,6,0,0,9
"cg06231863",0,0,2,0,2
"cg06233043",1,1,0,0,2
"cg06233230",4,2,0,0,6
"cg06235582",0,0,1,0,1
"cg06236206",1,0,2,0,3
"cg06237353",0,1,0,0,1
"cg06237354",0,0,1,0,1
"cg06237684",1,3,0,0,4
"cg06240409",0,1,6,0,7
"cg06243452",179,181,49,0,409
"cg06243722",0,0,2,0,2
"cg06243989",5,0,0,0,5
"cg06245427",0,0,5,0,5
"cg06245619",1,0,0,0,1
"cg06247772",0,0,1,0,1
"cg06250288",19,0,0,0,19
"cg06250693",0,1,0,0,1
"cg06252530",1,0,0,0,1
"cg06253682",0,0,1,0,1
"cg06253862",0,1,0,0,1
"cg06255293",0,1,0,0,1
"cg06255409",1,0,0,0,1
"cg06255477",3,1,0,0,4
"cg06255741",0,4,0,0,4
"cg06256374",0,6,8,0,14
"cg06256807",7,2,1,0,10
"cg06258261",0,2,4,0,6
"cg06258461",0,0,5,0,5
"cg06258971",0,0,0,1,1
"cg06260874",72,27,3,0,102
"cg06263740",9,14,0,0,23
"cg06264216",4,0,0,0,4
"cg06264450",1,0,1,0,2
"cg06264653",4,1,0,0,5
"cg06267552",3,0,0,0,3
"cg06267718",1,0,0,0,1
"cg06268161",5,1,0,0,6
"cg06268320",3,0,0,0,3
"cg06269929",0,1,1,0,2
"cg06270462",15,0,0,0,15
"cg06272049",2,0,0,0,2
"cg06272333",1,2,0,0,3
"cg06272863",0,1,0,0,1
"cg06272895",1,0,0,0,1
"cg06273514",0,0,1,0,1
"cg06273548",1,0,1,1,3
"cg06273950",0,0,1,0,1
"cg06274257",0,0,1,0,1
"cg06275134",1,2,2,0,5
"cg06275996",3,1,0,0,4
"cg06276780",0,1,3,0,4
"cg06276864",4,0,0,0,4
"cg06277271",8,6,2,0,16
"cg06279326",3,1,0,0,4
"cg06279640",0,1,0,0,1
"cg06280271",0,1,5,0,6
"cg06281648",30,39,11,0,80
"cg06282353",38,5,0,0,43
"cg06282956",0,0,0,1,1
"cg06283352",1,0,0,0,1
"cg06283672",317,12,0,0,329
"cg06284364",0,0,2,0,2
"cg06284696",0,0,1,0,1
"cg06284756",0,1,0,0,1
"cg06285079",0,1,0,0,1
"cg06286135",0,1,0,0,1
"cg06287199",0,0,1,0,1
"cg06287288",0,1,0,0,1
"cg06288154",0,0,2,0,2
"cg06289735",0,2,0,0,2
"cg06289868",0,1,1,0,2
"cg06290014",0,0,1,0,1
"cg06290265",0,0,1,0,1
"cg06290424",0,0,1,0,1
"cg06290572",2,8,0,0,10
"cg06290851",0,1,0,0,1
"cg06291494",1,1,0,0,2
"cg06292022",0,1,0,0,1
"cg06292520",0,1,0,0,1
"cg06293205",0,0,1,0,1
"cg06293636",0,1,0,0,1
"cg06293718",1,1,0,0,2
"cg06293902",0,0,1,0,1
"cg06294630",1,0,0,0,1
"cg06294976",0,6,2,0,8
"cg06295137",16,28,0,0,44
"cg06295650",6,0,0,0,6
"cg06296671",0,0,1,0,1
"cg06296724",0,1,0,0,1
"cg06297155",557,86,6,0,649
"cg06297160",0,1,0,0,1
"cg06297749",0,0,1,0,1
"cg06298205",0,1,0,0,1
"cg06299783",185,178,51,0,414
"cg06300223",2,1,2,0,5
"cg06300264",0,1,0,0,1
"cg06300268",28,158,651,0,837
"cg06300866",1,23,1,0,25
"cg06301178",0,1,0,0,1
"cg06301791",1,0,0,0,1
"cg06302402",0,0,1,0,1
"cg06302751",16,3,0,0,19
"cg06303529",0,1,0,0,1
"cg06305758",88,2,0,0,90
"cg06306006",0,0,1,0,1
"cg06306519",0,0,1,0,1
"cg06307567",74,72,7,0,153
"cg06307940",0,1,0,0,1
"cg06308323",1,0,0,0,1
"cg06309053",217,8,0,0,225
"cg06310022",0,0,1,0,1
"cg06311098",21,3,0,0,24
"cg06311795",1,0,0,0,1
"cg06312066",3,0,0,0,3
"cg06312221",40,9,2,0,51
"cg06312797",3,1,0,0,4
"cg06313716",0,0,1,0,1
"cg06314643",0,2,6,0,8
"cg06317351",0,0,2,0,2
"cg06320136",0,0,1,0,1
"cg06321300",0,0,2,0,2
"cg06321954",0,1,0,0,1
"cg06323975",0,0,1,0,1
"cg06324439",1,0,0,0,1
"cg06324564",752,202,3,0,957
"cg06324671",0,0,1,0,1
"cg06324707",0,14,2,0,16
"cg06324785",0,1,0,0,1
"cg06325346",9,7,0,0,16
"cg06325687",0,0,2,0,2
"cg06325889",0,3,5,0,8
"cg06326690",0,6,0,0,6
"cg06326713",0,0,6,0,6
"cg06327017",0,1,1,0,2
"cg06328422",1,1,0,0,2
"cg06329412",4,2,0,0,6
"cg06330034",0,0,1,0,1
"cg06330901",3,9,3,0,15
"cg06332314",0,0,1,0,1
"cg06332335",0,0,1,0,1
"cg06333938",1,0,0,0,1
"cg06336871",199,333,63,0,595
"cg06337343",1,2,0,0,3
"cg06338039",0,0,1,0,1
"cg06338518",0,1,0,0,1
"cg06338672",0,1,1,0,2
"cg06339135",0,1,0,0,1
"cg06339505",0,1,0,0,1
"cg06341189",251,4,0,0,255
"cg06341748",2,1,0,0,3
"cg06342503",1,0,0,0,1
"cg06342957",228,67,4,0,299
"cg06343169",0,2,1,0,3
"cg06344336",1,0,0,0,1
"cg06346138",0,0,2,0,2
"cg06346207",0,0,1,0,1
"cg06346218",0,1,0,0,1
"cg06346452",0,1,0,0,1
"cg06348134",1,0,0,0,1
"cg06348980",0,1,0,0,1
"cg06349165",182,166,78,0,426
"cg06349546",0,0,1,0,1
"cg06350966",0,0,1,0,1
"cg06351029",2,0,0,0,2
"cg06351965",1,0,0,0,1
"cg06352855",0,0,1,0,1
"cg06352932",1,0,0,0,1
"cg06352999",0,9,4,0,13
"cg06353703",0,0,1,0,1
"cg06354326",1,0,0,0,1
"cg06354398",1,2,0,0,3
"cg06354503",0,0,3,0,3
"cg06354953",27,6,1,0,34
"cg06355467",24,27,0,0,51
"cg06356339",0,2,0,0,2
"cg06357031",0,1,0,0,1
"cg06357615",0,0,1,0,1
"cg06358300",0,1,0,0,1
"cg06359086",1,0,0,0,1
"cg06359173",160,44,4,0,208
"cg06359884",1,1,0,0,2
"cg06360776",0,1,0,0,1
"cg06362052",1,0,0,0,1
"cg06362838",0,0,3,0,3
"cg06362954",1,0,0,0,1
"cg06363265",0,3,0,0,3
"cg06363680",0,3,0,0,3
"cg06363918",2,0,0,0,2
"cg06364593",1,3,0,0,4
"cg06364753",0,0,1,0,1
"cg06364920",1,0,0,0,1
"cg06365607",0,1,0,0,1
"cg06366898",1,0,0,0,1
"cg06367887",4,1,0,0,5
"cg06367975",22,0,0,0,22
"cg06368974",0,0,6,0,6
"cg06369248",1,0,0,0,1
"cg06369719",0,3,0,0,3
"cg06370886",100,175,22,0,297
"cg06371452",2,1,0,0,3
"cg06372851",0,4,0,0,4
"cg06373096",340,19,0,0,359
"cg06373526",0,3,0,0,3
"cg06373723",0,2,0,0,2
"cg06373919",4,0,0,0,4
"cg06374204",32,1,0,0,33
"cg06374208",1,0,0,0,1
"cg06374756",39,1,0,0,40
"cg06374814",1,0,0,0,1
"cg06375073",1,0,0,0,1
"cg06375206",0,2,0,0,2
"cg06375313",0,0,1,0,1
"cg06375839",0,0,2,0,2
"cg06375884",2,0,0,0,2
"cg06376220",0,0,0,1,1
"cg06377069",4,2,0,0,6
"cg06377220",0,1,0,0,1
"cg06377825",6,0,0,0,6
"cg06377964",1,1,0,0,2
"cg06379110",9,1,5,0,15
"cg06379478",0,1,1,0,2
"cg06379599",3,0,1,0,4
"cg06379858",5,4,0,0,9
"cg06380338",2,0,0,0,2
"cg06380966",93,22,2,0,117
"cg06381000",1,0,0,0,1
"cg06382685",0,2,7,0,9
"cg06383397",0,1,4,0,5
"cg06383512",37,3,0,0,40
"cg06383579",0,0,3,0,3
"cg06383625",0,0,1,0,1
"cg06384475",691,56,1,0,748
"cg06384523",6,2,1,0,9
"cg06384912",1,1,0,0,2
"cg06384958",0,0,1,0,1
"cg06385378",71,3,0,0,74
"cg06385874",0,2,3,0,5
"cg06387141",0,1,1,0,2
"cg06388544",0,1,0,0,1
"cg06389101",0,1,0,0,1
"cg06390057",8,0,0,0,8
"cg06390295",1,0,0,0,1
"cg06390316",0,0,2,0,2
"cg06390946",1,0,0,0,1
"cg06392088",4,5,7,0,16
"cg06392818",2,0,0,0,2
"cg06393130",274,10,0,0,284
"cg06393328",1,0,0,0,1
"cg06393354",1,0,0,0,1
"cg06394451",0,0,1,0,1
"cg06394980",22,1,0,0,23
"cg06395148",0,0,1,0,1
"cg06396237",0,1,0,0,1
"cg06397510",0,0,1,0,1
"cg06398741",24,3,0,0,27
"cg06398754",1,0,0,0,1
"cg06399109",203,30,0,0,233
"cg06399844",10,2,0,0,12
"cg06400319",0,1,0,0,1
"cg06400348",1,0,0,0,1
"cg06401154",12,3,0,0,15
"cg06401830",1,0,0,0,1
"cg06401857",0,0,1,0,1
"cg06402746",0,0,1,0,1
"cg06402976",0,0,0,1,1
"cg06403293",2,1,0,0,3
"cg06404832",0,1,1,0,2
"cg06405517",0,0,1,0,1
"cg06405640",2,0,0,0,2
"cg06406479",0,0,1,0,1
"cg06407259",21,3,0,0,24
"cg06407709",160,9,0,0,169
"cg06407917",0,0,2,0,2
"cg06408926",0,0,2,0,2
"cg06409824",0,1,1,0,2
"cg06409856",24,2,0,0,26
"cg06412465",4,1,0,0,5
"cg06412823",0,0,1,0,1
"cg06413510",0,1,0,0,1
"cg06413673",11,1,0,0,12
"cg06413976",18,1,0,0,19
"cg06415087",1,0,1,0,2
"cg06416186",6,0,0,0,6
"cg06417592",103,3,0,0,106
"cg06417824",0,2,0,0,2
"cg06418131",0,3,3,0,6
"cg06418832",0,1,0,0,1
"cg06419219",1,0,0,0,1
"cg06420058",284,266,5,0,555
"cg06420072",0,1,0,0,1
"cg06420430",1,0,1,0,2
"cg06420486",0,0,1,0,1
"cg06421197",10,0,0,0,10
"cg06421468",1,0,0,0,1
"cg06422731",7,0,0,0,7
"cg06422782",0,0,1,0,1
"cg06423291",57,3,0,0,60
"cg06423573",1,1,3,0,5
"cg06423617",0,0,1,0,1
"cg06426275",1,0,0,0,1
"cg06427857",0,1,0,0,1
"cg06428403",11,1,0,0,12
"cg06430746",1,1,1,0,3
"cg06431031",0,1,0,0,1
"cg06432986",1,0,0,0,1
"cg06433675",0,15,0,0,15
"cg06433694",1,0,0,0,1
"cg06434301",4,0,0,0,4
"cg06434445",0,1,0,0,1
"cg06435604",0,0,1,0,1
"cg06436132",3,5,2,0,10
"cg06437679",1,7,5,0,13
"cg06437703",0,0,1,0,1
"cg06438106",0,0,2,0,2
"cg06438195",0,0,2,0,2
"cg06438301",459,882,41,0,1382
"cg06438517",1,0,0,0,1
"cg06439175",1,0,0,0,1
"cg06439370",0,1,1,0,2
"cg06440169",3,0,0,0,3
"cg06441763",0,0,1,0,1
"cg06442472",238,44,0,0,282
"cg06442996",0,0,1,0,1
"cg06444207",1,0,0,0,1
"cg06444891",0,0,1,0,1
"cg06446730",1,4,0,0,5
"cg06446845",9,5,0,0,14
"cg06447436",2,1,0,0,3
"cg06449623",1,0,0,0,1
"cg06450446",317,106,5,0,428
"cg06451834",0,2,0,0,2
"cg06452681",1,4,11,0,16
"cg06452915",0,0,1,0,1
"cg06453172",0,0,1,0,1
"cg06454894",1,0,0,0,1
"cg06454951",0,1,0,0,1
"cg06455125",10,7,2,0,19
"cg06455153",1,0,0,0,1
"cg06456052",2,0,0,0,2
"cg06456125",1,0,1,0,2
"cg06456831",0,0,2,0,2
"cg06458094",0,0,2,0,2
"cg06459926",21,0,0,0,21
"cg06462185",0,0,1,0,1
"cg06462727",0,1,0,0,1
"cg06462796",1,0,0,0,1
"cg06465891",0,0,1,0,1
"cg06466049",0,0,1,0,1
"cg06466098",23,0,0,0,23
"cg06466175",0,1,0,0,1
"cg06467769",0,2,0,0,2
"cg06467776",0,3,0,0,3
"cg06468169",0,1,0,0,1
"cg06468521",0,1,1,1,3
"cg06468862",14,1,0,0,15
"cg06469293",2,2,0,0,4
"cg06469345",0,1,0,0,1
"cg06469714",2,0,0,0,2
"cg06470246",8,9,4,0,21
"cg06470877",0,1,0,0,1
"cg06471108",0,0,1,0,1
"cg06472423",0,4,0,0,4
"cg06472793",11,0,0,0,11
"cg06474427",0,1,1,0,2
"cg06474664",1,1,0,0,2
"cg06476240",0,0,1,0,1
"cg06476549",1,0,0,0,1
"cg06477464",0,1,0,0,1
"cg06477632",39,4,0,0,43
"cg06480482",0,0,1,0,1
"cg06480695",1,0,0,0,1
"cg06481462",3,6,1,0,10
"cg06481749",2,2,0,0,4
"cg06481920",0,0,3,0,3
"cg06483661",0,0,1,0,1
"cg06484340",1,0,0,0,1
"cg06485504",0,2,0,0,2
"cg06485864",0,1,0,0,1
"cg06485995",315,155,19,0,489
"cg06486581",1,3,0,0,4
"cg06487102",4,0,0,0,4
"cg06488081",0,1,0,0,1
"cg06489286",3,0,1,0,4
"cg06490260",0,0,3,0,3
"cg06490386",0,1,0,0,1
"cg06491147",45,32,2,0,79
"cg06492079",0,1,0,0,1
"cg06492287",0,0,12,0,12
"cg06492821",0,1,0,0,1
"cg06493555",0,0,2,0,2
"cg06494091",0,0,1,0,1
"cg06494497",1,1,1,0,3
"cg06494971",168,201,6,0,375
"cg06495710",0,1,0,0,1
"cg06496022",0,0,1,0,1
"cg06496546",1,4,0,0,5
"cg06497408",0,0,1,0,1
"cg06497612",1,1,2,0,4
"cg06499030",0,1,0,0,1
"cg06499415",0,1,1,0,2
"cg06501766",4,2,1,0,7
"cg06501857",748,24,1,0,773
"cg06502391",0,0,1,0,1
"cg06502456",1,1,0,0,2
"cg06503008",0,1,1,0,2
"cg06503831",0,1,0,0,1
"cg06504331",107,623,8,0,738
"cg06505541",2,0,0,0,2
"cg06506499",0,5,3,0,8
"cg06506868",2,1,6,0,9
"cg06506908",6,6,0,0,12
"cg06507124",0,3,3,0,6
"cg06507259",1,2,0,0,3
"cg06507271",1,1,1,0,3
"cg06509315",12,1,0,0,13
"cg06510090",1,0,0,0,1
"cg06510097",0,1,1,0,2
"cg06510879",0,2,1,0,3
"cg06512405",4,0,0,0,4
"cg06515418",4,1,0,0,5
"cg06515657",0,1,2,0,3
"cg06516328",2,0,0,0,2
"cg06516658",0,3,1,0,4
"cg06517521",1,0,0,0,1
"cg06517813",22,4,0,0,26
"cg06518388",0,1,0,0,1
"cg06519055",5,1,0,0,6
"cg06519908",3,1,0,0,4
"cg06520529",7,2,0,0,9
"cg06522070",0,0,6,0,6
"cg06522491",0,0,1,0,1
"cg06522833",1,0,0,0,1
"cg06522928",31,3,0,0,34
"cg06523691",2,0,0,0,2
"cg06524570",0,0,1,0,1
"cg06525145",0,1,0,0,1
"cg06525231",2,1,0,0,3
"cg06525491",1,1,0,0,2
"cg06527016",1,0,0,0,1
"cg06527221",14,0,0,0,14
"cg06527784",0,0,2,0,2
"cg06528310",146,25,2,0,173
"cg06530883",2,6,0,0,8
"cg06531702",0,0,2,0,2
"cg06532064",0,1,3,0,4
"cg06532628",1,0,0,0,1
"cg06532659",1,0,0,0,1
"cg06532924",11,0,0,0,11
"cg06533244",1,0,0,0,1
"cg06533860",1,1,0,0,2
"cg06534285",2,1,2,0,5
"cg06534313",0,0,4,0,4
"cg06538278",1,0,0,0,1
"cg06538437",0,0,1,0,1
"cg06538888",5,0,3,0,8
"cg06538977",0,0,2,0,2
"cg06540018",11,0,0,0,11
"cg06540105",0,1,0,0,1
"cg06540278",1,0,0,0,1
"cg06540389",27,11,1,0,39
"cg06541654",1,0,0,0,1
"cg06541956",0,0,3,0,3
"cg06542377",1,0,1,0,2
"cg06542429",21,18,12,0,51
"cg06542686",0,1,0,0,1
"cg06542928",0,1,1,0,2
"cg06543424",0,1,0,0,1
"cg06544198",0,1,0,0,1
"cg06545762",1,0,0,0,1
"cg06545804",0,1,3,0,4
"cg06546286",218,11,1,0,230
"cg06547383",7,2,2,0,11
"cg06548442",2,0,1,0,3
"cg06548447",2,0,0,0,2
"cg06548512",0,1,0,0,1
"cg06549743",0,5,9,0,14
"cg06550232",0,1,0,0,1
"cg06550278",1,0,0,0,1
"cg06550991",447,22,0,0,469
"cg06551022",1,0,0,0,1
"cg06552046",2,0,0,0,2
"cg06552182",2,0,0,0,2
"cg06552195",104,0,0,0,104
"cg06552366",0,0,1,0,1
"cg06553213",0,1,0,0,1
"cg06553462",0,0,1,0,1
"cg06554297",0,0,1,0,1
"cg06554331",0,1,0,0,1
"cg06554781",0,0,1,0,1
"cg06555020",2,3,1,0,6
"cg06556648",2,11,0,0,13
"cg06556651",0,1,0,0,1
"cg06557127",10,0,0,0,10
"cg06558491",0,3,12,0,15
"cg06559389",3,0,0,0,3
"cg06560223",1,0,1,0,2
"cg06560422",857,206,2,0,1065
"cg06560494",1,0,1,0,2
"cg06560588",1,0,0,0,1
"cg06561913",2,0,0,0,2
"cg06562727",0,0,2,0,2
"cg06564069",12,7,0,0,19
"cg06564803",0,0,1,0,1
"cg06564915",0,0,1,0,1
"cg06566674",1,0,0,0,1
"cg06567155",1,0,0,0,1
"cg06569419",3,1,0,0,4
"cg06569931",7,0,0,0,7
"cg06570311",424,13,0,0,437
"cg06570922",0,3,0,0,3
"cg06572160",0,2,0,0,2
"cg06574881",4,9,11,0,24
"cg06575172",0,0,1,0,1
"cg06575753",16,4,0,0,20
"cg06575847",27,0,0,0,27
"cg06576340",0,1,0,0,1
"cg06576920",0,1,0,0,1
"cg06577450",308,116,2,0,426
"cg06578353",110,0,1,0,111
"cg06578468",1,0,0,0,1
"cg06579440",14,0,0,0,14
"cg06579913",1,0,0,0,1
"cg06581021",2,2,2,0,6
"cg06581028",1,3,0,0,4
"cg06581357",0,0,1,0,1
"cg06581397",15,6,0,0,21
"cg06583873",2,0,0,0,2
"cg06584224",1,0,0,0,1
"cg06584800",0,2,1,0,3
"cg06584912",0,1,0,0,1
"cg06585645",0,0,1,0,1
"cg06586759",4,4,0,0,8
"cg06586813",0,0,1,0,1
"cg06587217",226,334,30,0,590
"cg06587418",0,1,0,0,1
"cg06587664",1,0,0,0,1
"cg06587797",1,4,3,0,8
"cg06587955",0,0,8,0,8
"cg06587976",1,0,1,0,2
"cg06588595",1,0,0,0,1
"cg06588832",0,0,2,0,2
"cg06589286",0,1,6,0,7
"cg06590120",3,5,12,0,20
"cg06590245",1,0,2,0,3
"cg06592026",4,5,3,0,12
"cg06593507",3,1,0,0,4
"cg06594186",7,0,0,0,7
"cg06594803",1,0,0,0,1
"cg06595212",1,0,0,0,1
"cg06595850",231,701,25,0,957
"cg06596235",0,0,1,0,1
"cg06596561",3,3,2,0,8
"cg06596613",61,0,0,0,61
"cg06596975",3,3,0,0,6
"cg06597038",281,48,0,0,329
"cg06597610",1,0,0,0,1
"cg06598386",1,0,0,0,1
"cg06598557",60,40,1,0,101
"cg06598753",0,0,1,0,1
"cg06599927",0,1,1,0,2
"cg06600404",4,12,12,0,28
"cg06602009",1,0,0,0,1
"cg06602452",0,1,0,0,1
"cg06602498",1,0,0,0,1
"cg06602926",0,0,1,0,1
"cg06603640",6,0,0,0,6
"cg06603834",22,8,0,0,30
"cg06604283",0,0,1,0,1
"cg06604447",0,3,0,0,3
"cg06605163",1,0,0,0,1
"cg06605399",0,1,0,0,1
"cg06605739",4,2,0,0,6
"cg06606511",5,23,9,0,37
"cg06606548",0,1,2,0,3
"cg06607151",0,0,1,0,1
"cg06607594",0,0,1,0,1
"cg06608112",1,0,0,0,1
"cg06608546",1,0,0,0,1
"cg06609220",2,0,0,0,2
"cg06609415",29,5,0,0,34
"cg06609474",0,0,3,0,3
"cg06610614",115,25,2,0,142
"cg06610783",1,3,4,0,8
"cg06611596",0,0,1,0,1
"cg06611684",1,0,0,0,1
"cg06611810",0,0,1,0,1
"cg06611850",30,2,0,0,32
"cg06612055",13,0,0,0,13
"cg06612259",1,1,0,0,2
"cg06612703",0,0,8,0,8
"cg06613547",266,245,33,0,544
"cg06613840",0,1,1,0,2
"cg06614336",0,0,2,0,2
"cg06614472",133,133,2,0,268
"cg06614633",1,0,2,0,3
"cg06615335",1,0,0,0,1
"cg06615940",0,2,1,0,3
"cg06616202",1,0,0,0,1
"cg06616806",0,0,1,0,1
"cg06617629",0,1,0,0,1
"cg06617888",0,0,1,0,1
"cg06618377",0,0,4,0,4
"cg06619150",0,0,1,0,1
"cg06619155",2,0,0,0,2
"cg06619428",1,0,0,0,1
"cg06619494",14,2,5,0,21
"cg06620923",1,0,0,0,1
"cg06621570",7,1,0,0,8
"cg06622267",1,0,0,0,1
"cg06623259",0,1,6,0,7
"cg06623630",0,0,1,0,1
"cg06624121",0,0,1,0,1
"cg06624613",0,0,1,0,1
"cg06626980",0,1,0,0,1
"cg06627170",11,1,0,0,12
"cg06628622",0,1,1,0,2
"cg06630204",0,0,1,0,1
"cg06631160",0,1,1,0,2
"cg06631941",50,2,1,0,53
"cg06632086",3,3,5,0,11
"cg06632694",0,1,1,0,2
"cg06632762",2,1,0,0,3
"cg06633402",0,0,3,0,3
"cg06633484",158,56,2,0,216
"cg06635625",0,2,2,0,4
"cg06635885",1,0,0,0,1
"cg06636001",5,4,0,0,9
"cg06636020",0,0,1,0,1
"cg06636203",0,0,1,0,1
"cg06636270",0,8,0,0,8
"cg06636449",0,0,1,0,1
"cg06637800",0,0,1,0,1
"cg06638980",3,4,3,0,10
"cg06639073",167,113,6,0,286
"cg06639191",0,7,27,0,34
"cg06639663",1,2,1,0,4
"cg06641279",0,1,0,0,1
"cg06641336",5,16,12,0,33
"cg06641357",0,0,1,0,1
"cg06642228",11,11,0,0,22
"cg06643028",10,0,0,0,10
"cg06643214",0,1,5,0,6
"cg06644195",1,0,0,0,1
"cg06644634",3,0,1,0,4
"cg06645805",144,35,0,0,179
"cg06645820",37,31,7,0,75
"cg06646006",5,2,1,0,8
"cg06646020",40,1,0,0,41
"cg06646234",4,1,0,0,5
"cg06649681",2,0,0,0,2
"cg06650261",1,0,0,0,1
"cg06650776",0,1,1,0,2
"cg06651909",0,1,0,0,1
"cg06652542",1063,312,0,0,1375
"cg06652750",0,0,1,0,1
"cg06653151",1,0,0,0,1
"cg06654498",5,17,26,0,48
"cg06654538",1,0,0,0,1
"cg06655570",169,30,2,0,201
"cg06656086",0,1,2,0,3
"cg06656458",0,1,0,0,1
"cg06656836",318,20,0,0,338
"cg06657096",1,0,0,0,1
"cg06657529",0,0,1,0,1
"cg06657865",4,3,0,0,7
"cg06658129",0,1,0,0,1
"cg06658468",1,0,0,0,1
"cg06658544",39,4,0,0,43
"cg06658864",0,1,0,0,1
"cg06658931",1,0,0,0,1
"cg06659422",1,0,0,0,1
"cg06659867",210,499,8,0,717
"cg06659875",4,1,0,0,5
"cg06660652",0,5,0,0,5
"cg06661057",0,0,1,0,1
"cg06663477",0,1,0,0,1
"cg06664054",1,1,2,0,4
"cg06664085",0,1,0,0,1
"cg06666836",41,2,1,0,44
"cg06666853",156,660,9,0,825
"cg06667281",0,1,0,0,1
"cg06668647",1,0,0,0,1
"cg06669226",0,0,2,0,2
"cg06669446",0,1,0,0,1
"cg06671928",1130,143,2,0,1275
"cg06672958",118,300,132,0,550
"cg06673515",1,0,0,0,1
"cg06673840",0,3,0,0,3
"cg06674286",0,0,1,0,1
"cg06674392",8,0,0,0,8
"cg06674873",0,1,1,0,2
"cg06675195",1,0,0,0,1
"cg06675426",12,0,0,0,12
"cg06676115",1,0,0,0,1
"cg06676522",0,0,1,0,1
"cg06676571",0,1,0,0,1
"cg06677120",125,197,142,0,464
"cg06679305",2,1,0,0,3
"cg06679649",150,195,149,0,494
"cg06680147",0,0,1,0,1
"cg06680243",1,0,0,0,1
"cg06681008",0,0,0,1,1
"cg06682105",1,0,0,0,1
"cg06682763",2,0,0,0,2
"cg06683362",1,1,0,0,2
"cg06683480",0,0,1,0,1
"cg06683723",0,0,1,0,1
"cg06685021",0,1,0,0,1
"cg06685140",70,73,17,0,160
"cg06685448",42,2,0,0,44
"cg06685644",0,1,3,0,4
"cg06686106",3,2,0,0,5
"cg06686174",28,448,60,0,536
"cg06686383",0,0,1,0,1
"cg06687820",0,1,0,0,1
"cg06688875",1,0,0,0,1
"cg06690644",1,0,0,0,1
"cg06691434",1,0,0,0,1
"cg06691888",5,1,0,0,6
"cg06692606",105,318,40,0,463
"cg06692784",1,1,0,0,2
"cg06692927",0,1,0,0,1
"cg06694641",0,0,0,1,1
"cg06694869",1,0,0,0,1
"cg06695264",38,1,0,0,39
"cg06698388",1,0,0,0,1
"cg06698828",63,6,0,0,69
"cg06700353",1,0,0,0,1
"cg06700839",0,0,1,0,1
"cg06701842",1,0,0,0,1
"cg06702050",0,0,1,0,1
"cg06702503",1,0,0,0,1
"cg06703435",17,22,1,0,40
"cg06703900",1,0,0,0,1
"cg06704203",0,0,1,0,1
"cg06704701",0,1,0,0,1
"cg06704846",3,2,0,0,5
"cg06705548",2,7,0,0,9
"cg06706398",39,0,1,0,40
"cg06707139",36,46,11,0,93
"cg06707320",13,3,0,0,16
"cg06707338",0,1,0,0,1
"cg06707403",0,0,1,0,1
"cg06708711",1,0,0,0,1
"cg06709285",3,0,0,0,3
"cg06709294",3,0,0,0,3
"cg06710050",0,1,0,0,1
"cg06710295",0,1,0,0,1
"cg06710605",854,65,1,0,920
"cg06710814",1,2,1,0,4
"cg06711418",1,0,0,0,1
"cg06711801",0,2,0,0,2
"cg06712089",0,4,0,0,4
"cg06712539",1,0,0,0,1
"cg06712763",585,8,1,0,594
"cg06712846",4,5,1,0,10
"cg06712867",1,2,0,0,3
"cg06714897",14,7,0,0,21
"cg06715352",1,0,0,0,1
"cg06716325",3,0,0,0,3
"cg06716378",1,5,1,0,7
"cg06716402",0,3,1,0,4
"cg06716703",3,0,0,0,3
"cg06717137",13,60,1,0,74
"cg06717525",1,0,0,0,1
"cg06717971",19,0,0,0,19
"cg06718920",0,1,0,0,1
"cg06719602",389,27,1,0,417
"cg06720084",0,1,0,0,1
"cg06720775",1,0,0,0,1
"cg06720943",0,0,1,0,1
"cg06721546",0,0,1,0,1
"cg06721772",0,1,0,0,1
"cg06722069",6,5,0,0,11
"cg06723310",0,0,2,0,2
"cg06723626",1,0,0,0,1
"cg06723735",1,0,0,0,1
"cg06724019",7,34,16,0,57
"cg06724266",0,1,0,0,1
"cg06726262",0,0,1,0,1
"cg06726509",0,0,2,0,2
"cg06726606",0,0,1,0,1
"cg06727965",1,0,0,0,1
"cg06727993",0,2,0,0,2
"cg06728551",1,0,0,0,1
"cg06728577",82,52,3,0,137
"cg06729723",2,0,0,0,2
"cg06730624",1,0,1,0,2
"cg06731730",0,1,0,0,1
"cg06733652",0,0,1,0,1
"cg06733872",0,0,1,0,1
"cg06733971",3,1,0,0,4
"cg06734002",1,0,0,0,1
"cg06734519",4,0,0,0,4
"cg06734820",1,5,0,0,6
"cg06735216",1,0,0,0,1
"cg06736139",1,0,0,0,1
"cg06736306",0,1,1,0,2
"cg06736940",5,0,0,0,5
"cg06737411",0,1,0,0,1
"cg06737484",1,0,0,0,1
"cg06738560",296,454,3,0,753
"cg06738743",6,0,0,0,6
"cg06739469",1,1,0,0,2
"cg06739505",13,2,0,0,15
"cg06739680",3,1,0,0,4
"cg06740071",1,0,0,0,1
"cg06741060",1,0,0,0,1
"cg06741246",1,3,3,0,7
"cg06741726",0,0,1,0,1
"cg06743811",0,1,0,0,1
"cg06745229",3,0,0,0,3
"cg06746075",1,1,0,0,2
"cg06746669",1,0,0,0,1
"cg06746865",210,48,0,0,258
"cg06746903",0,0,1,0,1
"cg06747770",6,0,0,0,6
"cg06747831",0,0,1,0,1
"cg06748309",14,0,0,0,14
"cg06748315",1,0,0,0,1
"cg06748831",2,0,0,0,2
"cg06749259",17,0,0,0,17
"cg06749642",0,0,1,0,1
"cg06750294",2,1,1,0,4
"cg06750710",0,2,0,0,2
"cg06751700",10,6,0,0,16
"cg06752398",0,0,4,0,4
"cg06752618",5,1,0,0,6
"cg06754664",0,0,1,0,1
"cg06754916",12,13,2,0,27
"cg06754972",3,0,0,0,3
"cg06755151",28,13,1,0,42
"cg06755297",0,1,0,0,1
"cg06755974",5,0,0,0,5
"cg06756315",0,0,2,0,2
"cg06757405",1,3,0,0,4
"cg06757863",272,68,3,0,343
"cg06758211",0,2,0,0,2
"cg06758240",1,0,1,0,2
"cg06758805",1,0,0,0,1
"cg06759210",1,0,0,0,1
"cg06759812",0,1,0,0,1
"cg06759901",1,0,0,0,1
"cg06759944",0,1,0,0,1
"cg06760309",4,0,0,0,4
"cg06760375",9,1,0,0,10
"cg06761076",0,0,2,0,2
"cg06761741",104,357,3,0,464
"cg06762176",0,1,1,0,2
"cg06764332",0,1,0,0,1
"cg06765324",0,0,2,0,2
"cg06765579",0,3,1,0,4
"cg06765586",71,32,3,0,106
"cg06765686",0,1,0,0,1
"cg06766181",0,0,1,0,1
"cg06767456",5,1,1,0,7
"cg06768741",0,0,1,0,1
"cg06769295",0,1,0,0,1
"cg06769581",2,3,0,0,5
"cg06770743",0,0,1,0,1
"cg06772268",8,0,0,0,8
"cg06772279",0,0,1,0,1
"cg06773216",1,0,0,0,1
"cg06774651",15,55,32,0,102
"cg06778587",12,2,0,0,14
"cg06779093",0,5,0,0,5
"cg06779738",0,0,1,0,1
"cg06779890",1,0,0,0,1
"cg06779984",2,0,0,0,2
"cg06780105",1,0,0,0,1
"cg06780463",1,0,0,0,1
"cg06780657",6,1,0,0,7
"cg06780861",2,0,0,0,2
"cg06781468",1,0,0,0,1
"cg06781853",1,0,0,0,1
"cg06783166",1,0,0,0,1
"cg06783668",8,0,0,0,8
"cg06783879",0,1,8,0,9
"cg06784187",286,37,0,0,323
"cg06784339",1,0,0,0,1
"cg06784390",0,1,1,0,2
"cg06784466",0,1,0,0,1
"cg06784646",0,0,1,0,1
"cg06787662",0,0,2,0,2
"cg06787924",1,0,0,0,1
"cg06788767",11,1,0,0,12
"cg06790674",2,2,1,0,5
"cg06791414",0,1,0,0,1
"cg06791415",0,1,0,0,1
"cg06792154",2,2,0,0,4
"cg06792196",30,1,0,0,31
"cg06792262",1,0,0,0,1
"cg06794038",3,0,0,0,3
"cg06794374",0,0,2,0,2
"cg06795980",7,0,0,0,7
"cg06796096",1,0,0,0,1
"cg06796482",0,0,3,0,3
"cg06796501",0,0,2,0,2
"cg06797115",13,1,0,0,14
"cg06797244",4,0,0,0,4
"cg06797501",62,2,0,0,64
"cg06797902",0,1,0,0,1
"cg06797925",1,2,11,0,14
"cg06798084",7,2,1,0,10
"cg06798350",0,1,0,0,1
"cg06799496",2,1,1,0,4
"cg06799747",0,2,0,0,2
"cg06799790",3,1,0,0,4
"cg06801354",2,0,0,0,2
"cg06803031",8,1,0,0,9
"cg06803290",165,10,0,0,175
"cg06805236",5,1,0,0,6
"cg06806212",0,1,0,0,1
"cg06807516",2,0,4,0,6
"cg06807791",34,3,0,0,37
"cg06807895",7,3,1,0,11
"cg06808021",6,64,2,0,72
"cg06808594",0,0,1,0,1
"cg06809077",0,1,0,0,1
"cg06809332",1,0,0,0,1
"cg06809342",184,129,19,0,332
"cg06809444",16,0,0,0,16
"cg06809601",1,3,0,0,4
"cg06809923",0,0,1,0,1
"cg06811798",0,1,0,0,1
"cg06811975",2,0,2,0,4
"cg06812060",25,0,0,0,25
"cg06812417",0,0,1,0,1
"cg06812760",0,0,1,0,1
"cg06813100",4,8,3,0,15
"cg06813122",0,1,0,0,1
"cg06813250",1,1,1,0,3
"cg06813599",1,0,0,0,1
"cg06813824",2,1,0,0,3
"cg06813886",53,298,58,0,409
"cg06813990",0,1,0,0,1
"cg06814061",1,0,0,0,1
"cg06815017",4,0,0,0,4
"cg06815579",4,0,1,0,5
"cg06815586",22,1,0,0,23
"cg06815704",0,6,22,0,28
"cg06816421",16,0,0,0,16
"cg06818126",0,0,2,0,2
"cg06818555",5,0,0,0,5
"cg06819088",3,1,1,0,5
"cg06819251",0,0,1,0,1
"cg06819813",2,0,0,0,2
"cg06819855",0,0,1,0,1
"cg06819926",11,15,7,0,33
"cg06821147",3,6,0,0,9
"cg06821367",12,1,0,0,13
"cg06821828",4,0,0,0,4
"cg06821959",4,6,0,0,10
"cg06822549",5,0,0,0,5
"cg06822963",0,2,0,0,2
"cg06824467",1,0,2,0,3
"cg06825998",0,0,0,1,1
"cg06827198",1,1,0,0,2
"cg06828282",97,1,0,0,98
"cg06829157",1,0,0,0,1
"cg06829902",0,0,3,0,3
"cg06830127",0,1,0,0,1
"cg06830145",703,135,2,0,840
"cg06830415",805,97,3,0,905
"cg06830875",0,1,0,0,1
"cg06831000",0,1,0,0,1
"cg06831182",1,0,0,0,1
"cg06831291",9,1,0,0,10
"cg06831389",2,1,0,0,3
"cg06831761",0,3,1,0,4
"cg06832168",2,0,0,0,2
"cg06832194",0,0,1,0,1
"cg06832331",1,2,1,0,4
"cg06832435",22,2,0,0,24
"cg06832605",2,0,0,0,2
"cg06832985",0,0,1,0,1
"cg06833320",24,1,0,0,25
"cg06833647",0,0,1,0,1
"cg06833672",2,0,0,0,2
"cg06833798",0,0,1,0,1
"cg06834312",1,0,0,0,1
"cg06834705",6,2,0,0,8
"cg06835018",1,0,22,0,23
"cg06835245",1,3,4,0,8
"cg06835821",0,0,1,0,1
"cg06836020",4,2,4,0,10
"cg06836690",3,1,0,0,4
"cg06837067",0,1,2,0,3
"cg06838146",132,47,4,0,183
"cg06838978",0,1,0,0,1
"cg06839360",0,2,0,0,2
"cg06839383",0,1,0,0,1
"cg06839602",0,2,0,0,2
"cg06841069",0,1,0,0,1
"cg06842116",0,0,0,1,1
"cg06842946",2,2,0,0,4
"cg06843058",9,6,2,0,17
"cg06843320",0,0,1,0,1
"cg06844372",0,2,0,1,3
"cg06844496",0,0,3,0,3
"cg06844932",0,1,0,0,1
"cg06845634",2,0,0,0,2
"cg06846700",0,0,6,0,6
"cg06846819",0,2,0,0,2
"cg06847685",0,1,1,0,2
"cg06848711",0,0,1,0,1
"cg06848735",0,1,2,0,3
"cg06850194",2,0,0,0,2
"cg06850416",0,0,1,0,1
"cg06850459",1,0,0,0,1
"cg06850922",54,4,0,0,58
"cg06851575",1,0,0,0,1
"cg06852137",10,1,0,0,11
"cg06852575",2,0,0,0,2
"cg06853126",6,0,0,0,6
"cg06853577",37,2,0,0,39
"cg06854015",1,0,0,0,1
"cg06855022",0,0,1,0,1
"cg06855101",0,0,1,0,1
"cg06857049",4,2,2,0,8
"cg06857705",3,0,0,0,3
"cg06857865",5,0,1,0,6
"cg06859321",0,0,1,0,1
"cg06859828",6,1,0,0,7
"cg06859833",3,1,0,0,4
"cg06861427",0,1,0,0,1
"cg06862268",6,5,0,0,11
"cg06863619",0,0,3,0,3
"cg06864633",0,0,1,0,1
"cg06865650",1,1,0,0,2
"cg06865839",5,0,0,0,5
"cg06865913",0,0,2,0,2
"cg06866756",0,4,1,0,5
"cg06867543",1,0,0,0,1
"cg06868034",220,381,43,0,644
"cg06868095",0,2,9,0,11
"cg06868284",0,1,0,0,1
"cg06868413",108,2,0,0,110
"cg06868699",24,39,1,0,64
"cg06869198",0,0,3,0,3
"cg06870863",0,0,1,0,1
"cg06871123",0,1,3,0,4
"cg06871461",7,1,0,0,8
"cg06871967",0,1,0,0,1
"cg06872010",17,2,3,0,22
"cg06872381",0,0,2,0,2
"cg06872435",0,1,0,0,1
"cg06872981",1,0,1,0,2
"cg06873295",1,6,1,0,8
"cg06873754",3,0,0,0,3
"cg06874013",0,1,0,0,1
"cg06874847",164,461,5,0,630
"cg06874895",64,71,4,0,139
"cg06874947",2,4,3,0,9
"cg06876037",0,0,1,0,1
"cg06876347",1,0,0,0,1
"cg06876956",0,0,1,0,1
"cg06877200",0,1,0,0,1
"cg06877247",0,0,1,0,1
"cg06877413",1,0,0,0,1
"cg06877532",0,3,0,0,3
"cg06877575",0,0,1,0,1
"cg06877711",0,0,1,0,1
"cg06878303",1,0,2,0,3
"cg06878999",1,1,0,0,2
"cg06879423",4,0,0,0,4
"cg06880974",1,0,0,0,1
"cg06881132",16,2,0,0,18
"cg06881398",1,0,0,0,1
"cg06881432",658,62,1,0,721
"cg06882420",5,6,1,0,12
"cg06882544",0,3,1,0,4
"cg06883064",0,0,1,0,1
"cg06883923",0,0,2,0,2
"cg06883934",0,1,0,0,1
"cg06884423",25,0,0,0,25
"cg06884789",0,1,8,0,9
"cg06885468",12,1,0,0,13
"cg06887260",0,1,0,0,1
"cg06887555",2,0,1,0,3
"cg06887980",1,0,0,0,1
"cg06888084",4,3,0,0,7
"cg06888225",0,0,1,0,1
"cg06889442",1,2,0,0,3
"cg06890365",1,0,0,0,1
"cg06890701",0,1,0,0,1
"cg06891282",0,13,2,0,15
"cg06891939",0,0,1,0,1
"cg06892141",0,1,3,0,4
"cg06892579",6,0,0,0,6
"cg06892788",0,0,1,0,1
"cg06893138",2,3,0,0,5
"cg06893302",1,0,0,0,1
"cg06893775",0,0,1,0,1
"cg06893834",1,0,0,0,1
"cg06893844",1,0,0,0,1
"cg06893853",106,120,3,0,229
"cg06895349",0,1,0,0,1
"cg06895834",0,0,2,0,2
"cg06895849",1,0,0,0,1
"cg06896988",0,1,0,0,1
"cg06897125",5,0,0,0,5
"cg06897564",1,0,0,0,1
"cg06897628",1,0,0,0,1
"cg06899791",1,0,0,0,1
"cg06901711",0,0,2,0,2
"cg06901762",126,8,6,0,140
"cg06902091",0,1,1,0,2
"cg06902219",1,0,0,0,1
"cg06902235",5,0,0,0,5
"cg06903151",509,71,10,0,590
"cg06903230",1332,203,4,0,1539
"cg06904337",0,1,0,0,1
"cg06904408",0,3,3,0,6
"cg06906831",1,0,0,0,1
"cg06907056",845,257,10,0,1112
"cg06907332",0,0,2,0,2
"cg06907347",0,1,0,0,1
"cg06907852",2,1,0,0,3
"cg06907892",0,1,0,0,1
"cg06908985",154,394,24,0,572
"cg06909288",2,0,0,0,2
"cg06909898",1,0,0,0,1
"cg06909921",1,0,1,0,2
"cg06910257",0,1,0,0,1
"cg06910465",2,3,0,0,5
"cg06910580",2,0,0,0,2
"cg06910661",6,13,1,0,20
"cg06910673",1,0,0,0,1
"cg06911277",0,2,0,0,2
"cg06911487",0,0,1,0,1
"cg06911525",1,0,0,0,1
"cg06912301",24,2,0,0,26
"cg06913079",95,38,0,0,133
"cg06913579",0,0,0,1,1
"cg06915574",0,0,1,0,1
"cg06918090",3,1,0,0,4
"cg06919059",3,0,0,0,3
"cg06919519",2,0,0,0,2
"cg06920276",61,19,12,0,92
"cg06921605",45,8,0,0,53
"cg06922092",0,0,1,0,1
"cg06923249",0,0,1,0,1
"cg06924880",2,0,1,0,3
"cg06924930",19,0,0,0,19
"cg06925530",185,146,22,0,353
"cg06926499",0,0,1,0,1
"cg06926815",2,0,0,0,2
"cg06926934",0,1,0,0,1
"cg06927217",3,4,2,0,9
"cg06927878",0,1,0,0,1
"cg06929530",0,0,2,0,2
"cg06929622",3,0,0,0,3
"cg06930309",1,0,2,0,3
"cg06930511",1,0,0,0,1
"cg06930754",0,1,1,0,2
"cg06931615",1,0,0,0,1
"cg06931792",0,2,1,0,3
"cg06932999",0,0,1,0,1
"cg06933074",4,1,0,0,5
"cg06933697",0,0,1,0,1
"cg06933949",2,4,1,0,7
"cg06934003",126,419,22,0,567
"cg06934245",0,0,4,0,4
"cg06935106",0,0,2,0,2
"cg06935336",0,1,0,0,1
"cg06935353",19,0,0,0,19
"cg06936025",2,0,0,0,2
"cg06936108",0,1,0,0,1
"cg06936567",0,1,0,0,1
"cg06936779",0,2,0,0,2
"cg06937348",0,0,1,0,1
"cg06937395",0,0,1,0,1
"cg06937593",3,0,0,0,3
"cg06938191",282,26,0,0,308
"cg06938264",0,1,1,0,2
"cg06938890",1,1,0,0,2
"cg06939972",0,0,1,0,1
"cg06940195",0,1,0,0,1
"cg06941917",1,0,4,0,5
"cg06944211",0,0,1,0,1
"cg06944472",4,10,9,0,23
"cg06944489",182,13,3,0,198
"cg06945563",0,0,1,0,1
"cg06945690",0,0,1,0,1
"cg06946213",1,1,0,0,2
"cg06946785",1,0,0,0,1
"cg06947241",0,1,0,0,1
"cg06948111",136,333,2,0,471
"cg06948588",1,0,0,0,1
"cg06948885",21,0,0,0,21
"cg06948989",0,6,6,0,12
"cg06949230",0,1,0,0,1
"cg06949728",0,1,0,0,1
"cg06950384",2,0,0,0,2
"cg06951248",0,1,4,0,5
"cg06952190",1,0,0,0,1
"cg06952379",1,0,0,0,1
"cg06952763",0,1,0,0,1
"cg06953454",0,2,0,0,2
"cg06953577",2,0,0,0,2
"cg06954638",23,30,9,0,62
"cg06954720",1,1,2,0,4
"cg06955268",3,0,0,0,3
"cg06957414",0,1,0,0,1
"cg06957677",78,1,0,0,79
"cg06958842",1,0,0,0,1
"cg06958882",12,1,0,0,13
"cg06959514",0,4,1,0,5
"cg06959657",6,0,17,0,23
"cg06959724",0,0,3,0,3
"cg06959789",0,0,1,0,1
"cg06960314",2,0,0,0,2
"cg06961458",1,0,0,0,1
"cg06961480",0,1,0,0,1
"cg06961632",2,0,0,0,2
"cg06962146",0,0,1,0,1
"cg06963282",0,0,1,0,1
"cg06963524",6,1,0,0,7
"cg06963804",1,0,0,0,1
"cg06964738",2,1,1,0,4
"cg06965391",1,0,0,0,1
"cg06965744",0,1,1,0,2
"cg06966593",16,0,0,0,16
"cg06966817",119,11,7,0,137
"cg06968102",15,2,0,0,17
"cg06968641",4,1,2,0,7
"cg06968817",0,0,4,0,4
"cg06969395",2,20,1,0,23
"cg06970228",0,0,1,0,1
"cg06970454",333,123,8,0,464
"cg06970744",7,0,0,0,7
"cg06970979",7,11,5,0,23
"cg06971044",43,1,0,0,44
"cg06971224",1,0,0,0,1
"cg06971418",4,1,0,0,5
"cg06971660",0,0,1,0,1
"cg06972978",215,292,18,0,525
"cg06973288",0,0,1,0,1
"cg06974474",0,0,2,0,2
"cg06975193",3,3,0,0,6
"cg06975206",8,14,5,0,27
"cg06975686",1,0,0,0,1
"cg06976222",1,0,0,0,1
"cg06976909",11,0,0,0,11
"cg06977264",219,78,8,0,305
"cg06977430",0,1,0,0,1
"cg06977575",0,0,1,0,1
"cg06977823",10,21,10,0,41
"cg06977877",5,0,0,0,5
"cg06977935",0,0,4,0,4
"cg06978737",0,1,0,0,1
"cg06978998",1,3,0,0,4
"cg06979108",0,0,1,0,1
"cg06979110",0,1,0,0,1
"cg06982169",2,0,0,0,2
"cg06982650",387,41,1,0,429
"cg06984352",0,0,1,0,1
"cg06985072",0,0,1,0,1
"cg06985868",0,3,0,0,3
"cg06986160",0,1,1,0,2
"cg06986330",1,0,0,0,1
"cg06987053",1,0,0,0,1
"cg06987369",1,0,0,0,1
"cg06988027",3,0,0,0,3
"cg06989074",0,1,0,0,1
"cg06989102",23,0,0,0,23
"cg06990460",1,0,0,0,1
"cg06991391",0,0,3,0,3
"cg06991392",4,0,0,0,4
"cg06991569",1,0,0,0,1
"cg06993235",140,105,3,0,248
"cg06994974",1,0,0,0,1
"cg06995113",182,69,11,0,262
"cg06995190",0,0,2,0,2
"cg06995715",0,1,0,0,1
"cg06995920",1,1,0,0,2
"cg06996138",0,0,1,0,1
"cg06996240",6,5,0,0,11
"cg06997228",0,5,1,0,6
"cg06999243",1,0,0,0,1
"cg07000267",2,0,2,0,4
"cg07000290",1,1,0,0,2
"cg07000806",0,1,0,0,1
"cg07000980",2,6,0,0,8
"cg07001612",0,0,1,0,1
"cg07003744",0,2,0,0,2
"cg07004080",1,0,0,0,1
"cg07004091",0,0,2,0,2
"cg07004265",0,0,1,0,1
"cg07004394",1,2,1,0,4
"cg07004514",0,0,1,0,1
"cg07004727",0,2,1,0,3
"cg07005246",325,210,9,0,544
"cg07006551",0,0,1,0,1
"cg07006564",0,0,1,0,1
"cg07007213",1,0,0,0,1
"cg07007508",288,218,13,0,519
"cg07008500",0,5,4,0,9
"cg07008560",1,0,0,0,1
"cg07008693",1,0,0,0,1
"cg07008779",0,2,0,0,2
"cg07008926",3,1,1,0,5
"cg07009584",2,1,0,0,3
"cg07011304",0,1,1,0,2
"cg07011770",2,0,0,0,2
"cg07012189",0,1,0,0,1
"cg07014523",0,1,0,0,1
"cg07014842",0,0,1,0,1
"cg07015480",139,104,5,0,248
"cg07015792",0,0,1,0,1
"cg07015927",32,10,0,0,42
"cg07016276",2,0,0,0,2
"cg07016549",2,2,0,0,4
"cg07016638",0,1,0,0,1
"cg07017114",2,0,1,0,3
"cg07017693",1,0,0,0,1
"cg07018090",0,0,2,0,2
"cg07019316",16,8,7,0,31
"cg07019466",0,0,1,0,1
"cg07020080",0,0,0,1,1
"cg07020407",0,0,3,0,3
"cg07020822",0,0,0,1,1
"cg07020979",1,1,0,0,2
"cg07021678",28,1,0,0,29
"cg07022307",1,0,0,0,1
"cg07022442",2,0,0,0,2
"cg07022640",1,0,0,0,1
"cg07022953",1,0,0,0,1
"cg07023131",0,0,1,0,1
"cg07023501",0,0,2,0,2
"cg07024639",0,1,0,0,1
"cg07024913",5,3,0,0,8
"cg07027881",0,0,1,0,1
"cg07028263",2,14,2,0,18
"cg07028937",10,5,0,0,15
"cg07029460",0,0,1,0,1
"cg07029832",0,0,1,0,1
"cg07030012",1,1,2,0,4
"cg07030261",0,1,0,0,1
"cg07030501",0,0,1,0,1
"cg07031437",0,1,0,0,1
"cg07032256",1,1,0,0,2
"cg07033468",1,0,0,0,1
"cg07033673",8,5,0,0,13
"cg07033710",0,1,0,0,1
"cg07033876",34,7,0,0,41
"cg07033880",6,0,0,0,6
"cg07035097",147,616,36,0,799
"cg07035961",0,3,6,0,9
"cg07036833",2,0,0,0,2
"cg07037045",0,1,0,0,1
"cg07038004",29,11,0,0,40
"cg07038675",0,1,0,0,1
"cg07040661",0,0,1,0,1
"cg07040697",11,0,0,0,11
"cg07041214",0,2,2,0,4
"cg07041723",5,0,0,0,5
"cg07042985",0,1,0,0,1
"cg07043044",1,0,0,0,1
"cg07043305",1,0,0,0,1
"cg07044303",0,0,2,0,2
"cg07047407",0,0,6,0,6
"cg07048223",0,0,1,0,1
"cg07049552",0,0,1,0,1
"cg07050599",6,1,0,0,7
"cg07051075",0,0,1,0,1
"cg07051604",4,0,0,0,4
"cg07051610",144,34,0,0,178
"cg07051786",0,1,0,0,1
"cg07052001",0,0,1,0,1
"cg07052627",0,0,1,0,1
"cg07053216",1,0,0,0,1
"cg07053313",0,0,1,0,1
"cg07053942",0,0,1,0,1
"cg07053948",31,37,7,0,75
"cg07054542",1,0,0,0,1
"cg07054687",0,0,1,0,1
"cg07055143",1,0,0,0,1
"cg07055311",1,0,0,0,1
"cg07056236",2,0,0,0,2
"cg07056812",6,0,7,0,13
"cg07056928",1,0,0,0,1
"cg07057532",0,0,1,0,1
"cg07058312",1,0,0,0,1
"cg07058526",13,0,0,0,13
"cg07059451",0,0,1,0,1
"cg07059629",0,1,1,0,2
"cg07059630",4,4,3,0,11
"cg07059631",0,0,1,0,1
"cg07060158",0,1,0,0,1
"cg07060204",1,0,0,0,1
"cg07061359",0,1,1,0,2
"cg07061783",6,1,5,0,12
"cg07061914",0,0,5,0,5
"cg07061975",1,1,0,0,2
"cg07062456",1,0,0,0,1
"cg07062938",1,0,0,0,1
"cg07063211",0,0,2,0,2
"cg07063348",1,0,0,0,1
"cg07063914",197,45,1,0,243
"cg07065708",0,0,0,1,1
"cg07066569",0,0,2,0,2
"cg07067152",0,1,0,0,1
"cg07067659",0,1,0,0,1
"cg07068604",15,7,0,0,22
"cg07068730",3,1,0,0,4
"cg07068998",1,0,0,0,1
"cg07069151",201,353,106,0,660
"cg07070305",0,1,0,0,1
"cg07070466",0,0,1,0,1
"cg07071144",1,0,0,0,1
"cg07071615",0,0,1,0,1
"cg07071690",4,3,2,0,9
"cg07073072",1,0,0,0,1
"cg07075003",1,2,0,0,3
"cg07075169",0,0,1,0,1
"cg07075900",1,0,0,0,1
"cg07076105",3,2,1,0,6
"cg07076850",0,0,0,1,1
"cg07077221",0,2,0,0,2
"cg07079860",0,13,1,0,14
"cg07079936",3,1,0,0,4
"cg07080099",0,0,1,0,1
"cg07082159",0,1,0,0,1
"cg07082282",1,0,0,0,1
"cg07082891",1,0,0,0,1
"cg07083172",0,1,0,0,1
"cg07083366",0,0,1,0,1
"cg07084163",0,0,1,0,1
"cg07084998",0,1,0,0,1
"cg07085082",0,1,0,0,1
"cg07085396",0,5,0,0,5
"cg07085827",0,1,0,0,1
"cg07086641",0,1,0,0,1
"cg07088130",15,77,3,0,95
"cg07088966",0,0,1,0,1
"cg07089020",20,22,22,0,64
"cg07089186",2,0,0,0,2
"cg07089633",0,1,1,0,2
"cg07090534",0,1,3,0,4
"cg07090653",0,1,0,0,1
"cg07090701",0,2,0,0,2
"cg07091523",2,0,0,0,2
"cg07091641",0,1,0,0,1
"cg07093111",0,0,1,0,1
"cg07093140",1,0,0,0,1
"cg07093617",1,0,0,0,1
"cg07093791",0,1,0,0,1
"cg07094519",0,0,10,0,10
"cg07094783",95,35,0,0,130
"cg07095091",82,263,190,0,535
"cg07096883",0,0,1,0,1
"cg07096991",0,0,2,0,2
"cg07097295",3,0,1,0,4
"cg07097560",1,1,0,0,2
"cg07097949",107,4,0,0,111
"cg07099056",0,1,0,0,1
"cg07099241",190,164,43,0,397
"cg07099303",0,0,1,0,1
"cg07099640",0,0,1,0,1
"cg07100448",0,4,0,0,4
"cg07100466",0,0,1,0,1
"cg07100648",0,0,1,0,1
"cg07100658",63,21,0,0,84
"cg07100820",0,0,1,0,1
"cg07100957",0,1,0,0,1
"cg07101552",0,1,0,0,1
"cg07102913",0,1,0,0,1
"cg07103903",2,0,0,0,2
"cg07104116",0,0,1,0,1
"cg07104380",129,274,5,0,408
"cg07104860",0,1,1,0,2
"cg07105734",220,333,8,0,561
"cg07106501",215,6,0,0,221
"cg07106775",2,1,0,1,4
"cg07107034",0,1,7,0,8
"cg07107580",0,2,0,0,2
"cg07107813",9,4,0,0,13
"cg07107877",1,3,0,0,4
"cg07108173",1,0,0,0,1
"cg07109002",36,3,0,0,39
"cg07109351",1,0,1,0,2
"cg07109726",0,1,0,0,1
"cg07109943",9,0,0,0,9
"cg07111049",5,1,1,0,7
"cg07111566",0,1,0,0,1
"cg07111713",0,1,3,0,4
"cg07111721",2,1,0,0,3
"cg07113307",0,0,1,0,1
"cg07113537",0,7,0,0,7
"cg07114335",2,4,0,0,6
"cg07115559",1,0,0,0,1
"cg07116310",12,0,0,0,12
"cg07117364",0,1,1,0,2
"cg07118054",0,0,1,0,1
"cg07119605",0,0,1,0,1
"cg07120007",3,0,0,0,3
"cg07120346",1,2,2,0,5
"cg07120900",949,125,1,0,1075
"cg07121312",0,1,0,0,1
"cg07121313",5,1,0,0,6
"cg07122493",1,0,4,0,5
"cg07124017",0,3,1,0,4
"cg07124145",1,0,0,0,1
"cg07124762",0,1,0,0,1
"cg07124956",0,0,1,0,1
"cg07125350",0,1,1,0,2
"cg07125905",0,0,1,0,1
"cg07125976",0,1,0,0,1
"cg07126424",0,0,1,0,1
"cg07126839",1,0,0,0,1
"cg07127799",138,17,0,0,155
"cg07128102",1,0,0,0,1
"cg07128973",0,0,1,0,1
"cg07129288",1,0,1,0,2
"cg07130687",2,0,0,0,2
"cg07131166",2,0,0,0,2
"cg07131864",0,0,1,0,1
"cg07132710",0,0,1,0,1
"cg07133979",2,1,0,0,3
"cg07134486",647,24,1,0,672
"cg07134887",0,0,1,0,1
"cg07135647",1,0,0,0,1
"cg07135664",1,1,2,0,4
"cg07135942",1,2,2,0,5
"cg07136348",0,1,0,0,1
"cg07136759",20,42,1,0,63
"cg07137409",3,0,0,0,3
"cg07138192",190,13,0,0,203
"cg07138878",1,0,0,0,1
"cg07140537",0,0,1,0,1
"cg07140707",8,7,0,0,15
"cg07141237",21,27,12,0,60
"cg07141885",0,0,1,0,1
"cg07143360",1,0,2,0,3
"cg07146187",6,1,0,0,7
"cg07146974",124,19,3,0,146
"cg07147409",4,1,0,0,5
"cg07147421",2,0,2,0,4
"cg07148241",1,3,1,0,5
"cg07149295",0,1,0,0,1
"cg07149474",1,1,0,0,2
"cg07150585",1,0,0,0,1
"cg07151047",86,15,0,0,101
"cg07151865",5,1,0,0,6
"cg07152342",1,0,0,0,1
"cg07152597",0,0,1,0,1
"cg07152602",1,0,0,0,1
"cg07153694",1,0,0,0,1
"cg07153826",0,0,1,0,1
"cg07154950",0,2,0,0,2
"cg07156820",1,0,0,0,1
"cg07158881",1,0,0,0,1
"cg07158991",0,0,1,0,1
"cg07159094",0,0,1,0,1
"cg07160001",1,2,0,0,3
"cg07160246",5,0,0,1,6
"cg07162573",6,1,0,0,7
"cg07162801",157,70,2,0,229
"cg07163288",0,4,0,0,4
"cg07163603",1,1,1,0,3
"cg07165115",3,0,2,0,5
"cg07165916",5,4,0,0,9
"cg07166654",0,3,0,0,3
"cg07167428",0,0,2,0,2
"cg07169774",0,1,0,0,1
"cg07169798",3,1,0,0,4
"cg07169932",8,4,0,0,12
"cg07170263",13,2,0,0,15
"cg07170302",1,0,0,0,1
"cg07170752",1,0,0,0,1
"cg07170859",2,1,0,0,3
"cg07171229",0,1,0,0,1
"cg07172707",16,2,0,0,18
"cg07172905",1,1,1,0,3
"cg07173274",10,11,6,0,27
"cg07173354",0,1,0,0,1
"cg07174053",0,0,1,0,1
"cg07175090",6,0,0,0,6
"cg07176342",1,0,0,0,1
"cg07178092",5,0,0,0,5
"cg07178561",1,0,0,0,1
"cg07180069",0,2,0,0,2
"cg07182642",0,1,0,0,1
"cg07183286",1,0,0,0,1
"cg07184523",0,0,2,0,2
"cg07186138",0,2,0,0,2
"cg07186168",0,0,2,0,2
"cg07186417",37,1,0,0,38
"cg07186460",1,0,0,0,1
"cg07186585",17,0,0,0,17
"cg07186946",1,3,0,0,4
"cg07187202",1,0,0,0,1
"cg07188591",2,3,0,0,5
"cg07190602",19,1,0,0,20
"cg07191839",0,2,0,0,2
"cg07193389",4,0,0,0,4
"cg07194798",1,1,0,0,2
"cg07195101",0,5,6,0,11
"cg07195195",1,0,0,0,1
"cg07195914",75,27,0,0,102
"cg07196190",0,1,1,0,2
"cg07196347",1,0,0,0,1
"cg07197800",16,7,0,0,23
"cg07199801",2,0,0,0,2
"cg07199834",0,1,0,0,1
"cg07200089",0,1,0,0,1
"cg07200874",156,21,2,0,179
"cg07201013",17,1,0,0,18
"cg07201046",1,0,0,0,1
"cg07201724",414,289,8,0,711
"cg07202423",0,2,0,0,2
"cg07202581",0,0,1,0,1
"cg07202869",1,0,0,0,1
"cg07204066",2,0,0,0,2
"cg07204165",0,1,7,0,8
"cg07204662",1,1,0,0,2
"cg07204792",7,6,3,0,16
"cg07205901",2,1,0,0,3
"cg07207484",0,1,1,0,2
"cg07207581",0,4,0,0,4
"cg07207660",2,0,1,0,3
"cg07208077",0,0,1,0,1
"cg07209141",1,0,0,0,1
"cg07209240",1,0,0,0,1
"cg07209548",2,0,0,0,2
"cg07209823",258,337,28,0,623
"cg07209841",1,0,0,0,1
"cg07211511",3,3,0,0,6
"cg07212416",0,0,2,0,2
"cg07212492",34,20,2,0,56
"cg07212615",5,0,0,0,5
"cg07213289",0,1,0,0,1
"cg07213548",0,0,1,0,1
"cg07213870",1,0,0,0,1
"cg07214314",0,1,0,0,1
"cg07215055",19,15,2,0,36
"cg07216386",0,1,1,0,2
"cg07217051",0,0,1,0,1
"cg07217403",1,0,0,0,1
"cg07217691",3,0,0,0,3
"cg07217789",18,4,3,0,25
"cg07217958",1,0,0,0,1
"cg07219766",14,2,0,0,16
"cg07221224",1,2,0,0,3
"cg07221511",6,0,0,0,6
"cg07222058",0,0,2,0,2
"cg07222502",0,0,1,0,1
"cg07223266",1,1,0,0,2
"cg07223534",1,2,0,0,3
"cg07223935",0,0,1,0,1
"cg07224169",1,0,0,0,1
"cg07224444",0,0,1,0,1
"cg07225035",0,0,1,0,1
"cg07225829",0,0,1,0,1
"cg07226010",8,7,0,0,15
"cg07226165",0,1,0,0,1
"cg07226171",1,0,0,0,1
"cg07228237",3,0,0,0,3
"cg07229500",0,0,1,1,2
"cg07229502",0,1,0,0,1
"cg07230486",1,0,0,0,1
"cg07231315",2,13,3,0,18
"cg07231468",0,0,1,0,1
"cg07231731",3,0,0,0,3
"cg07233127",1,0,0,0,1
"cg07233341",2,0,0,0,2
"cg07235439",0,0,1,0,1
"cg07235855",0,2,0,0,2
"cg07235915",0,4,2,0,6
"cg07236039",5,6,1,0,12
"cg07236062",5,1,0,0,6
"cg07236150",0,0,2,0,2
"cg07236536",1,0,0,0,1
"cg07236560",1,2,4,0,7
"cg07236666",0,1,0,0,1
"cg07236884",3,0,0,0,3
"cg07238396",0,1,0,0,1
"cg07239629",1,1,0,0,2
"cg07240043",666,46,0,0,712
"cg07240873",2,2,6,0,10
"cg07240877",2,0,0,0,2
"cg07242196",3,0,0,0,3
"cg07242282",1,0,0,0,1
"cg07242427",0,1,1,0,2
"cg07243141",0,0,1,0,1
"cg07243371",1,0,0,0,1
"cg07245677",0,1,1,0,2
"cg07245980",0,0,1,0,1
"cg07246190",0,0,2,0,2
"cg07246517",0,1,0,0,1
"cg07246578",1,0,0,0,1
"cg07246946",0,0,1,0,1
"cg07247405",0,0,1,0,1
"cg07248721",0,0,1,0,1
"cg07249209",0,0,3,0,3
"cg07249265",2,0,0,1,3
"cg07250111",0,1,0,0,1
"cg07250333",0,4,0,0,4
"cg07251568",0,1,0,0,1
"cg07251872",0,1,0,0,1
"cg07252424",0,0,1,0,1
"cg07252846",170,11,0,0,181
"cg07253226",1,0,0,0,1
"cg07255151",0,0,1,0,1
"cg07255889",0,0,1,0,1
"cg07256376",1,0,1,0,2
"cg07256918",5,0,0,0,5
"cg07257190",355,17,0,0,372
"cg07258064",1,0,0,0,1
"cg07258640",0,1,0,0,1
"cg07258750",3,1,0,0,4
"cg07258847",34,1,0,0,35
"cg07259110",13,1,0,0,14
"cg07259195",0,0,1,0,1
"cg07259938",0,1,0,0,1
"cg07260325",9,5,9,0,23
"cg07260443",1,0,0,0,1
"cg07260760",7,2,0,0,9
"cg07260820",0,1,0,0,1
"cg07260961",8,3,2,0,13
"cg07262737",0,6,0,0,6
"cg07262902",1,0,0,0,1
"cg07263070",1,0,0,0,1
"cg07263102",0,0,1,0,1
"cg07263153",0,0,1,0,1
"cg07264103",82,19,0,0,101
"cg07264154",0,1,1,0,2
"cg07264329",1,0,0,0,1
"cg07264491",0,9,17,0,26
"cg07264993",1,0,0,0,1
"cg07265236",1,1,0,0,2
"cg07265497",4,0,0,0,4
"cg07266484",0,1,0,0,1
"cg07267052",1,0,0,0,1
"cg07267166",0,0,1,0,1
"cg07267244",0,1,0,0,1
"cg07267415",1,0,0,0,1
"cg07267493",0,0,1,0,1
"cg07268487",1,0,0,0,1
"cg07269000",78,0,0,0,78
"cg07269433",0,1,0,0,1
"cg07271383",0,0,1,0,1
"cg07272353",0,0,1,0,1
"cg07273346",197,6,0,0,203
"cg07275068",0,1,0,1,2
"cg07275221",2,0,1,0,3
"cg07275480",2,0,0,0,2
"cg07276083",0,3,0,0,3
"cg07276530",1,0,0,0,1
"cg07276726",1,0,0,0,1
"cg07277465",157,297,29,0,483
"cg07278125",8,3,0,0,11
"cg07278153",0,0,1,0,1
"cg07279379",0,1,5,0,6
"cg07279579",0,0,1,0,1
"cg07280101",3,0,0,0,3
"cg07280348",5,4,0,0,9
"cg07280371",4,0,0,0,4
"cg07281325",0,0,1,0,1
"cg07281631",0,0,1,0,1
"cg07282838",0,1,0,0,1
"cg07283096",3,1,0,0,4
"cg07283217",1,0,0,0,1
"cg07283489",5,1,0,0,6
"cg07283616",174,119,5,0,298
"cg07283849",1,0,0,0,1
"cg07284034",0,1,0,0,1
"cg07284519",10,0,0,0,10
"cg07284610",6,1,0,0,7
"cg07285331",4,0,0,0,4
"cg07285953",0,1,0,0,1
"cg07286357",0,1,0,0,1
"cg07286753",2,0,0,0,2
"cg07287606",1,0,0,0,1
"cg07287679",0,2,0,0,2
"cg07288347",0,1,0,0,1
"cg07289070",0,0,2,0,2
"cg07293387",142,398,121,0,661
"cg07293650",0,0,5,0,5
"cg07295034",0,4,0,0,4
"cg07295197",0,0,2,0,2
"cg07296963",0,0,1,0,1
"cg07297326",0,0,1,0,1
"cg07299078",5,1,0,0,6
"cg07299305",1,1,0,0,2
"cg07299746",0,0,1,0,1
"cg07301508",1,2,0,0,3
"cg07302997",1,0,0,0,1
"cg07303247",3,9,13,0,25
"cg07304102",1,0,0,0,1
"cg07305421",175,11,0,0,186
"cg07307164",4,0,2,0,6
"cg07307422",33,5,0,0,38
"cg07307460",0,0,2,0,2
"cg07308221",0,0,1,0,1
"cg07309238",1,1,0,0,2
"cg07309274",0,11,4,0,15
"cg07309941",1,0,0,0,1
"cg07311615",0,0,1,0,1
"cg07313438",1,0,0,0,1
"cg07313504",0,0,1,0,1
"cg07314005",1,0,0,0,1
"cg07315228",1,0,0,0,1
"cg07315642",1,0,0,0,1
"cg07315755",0,1,0,0,1
"cg07316298",0,0,2,0,2
"cg07316644",1,7,1,0,9
"cg07316743",0,1,0,0,1
"cg07317705",0,1,0,0,1
"cg07318568",12,1,0,0,13
"cg07318636",19,15,0,0,34
"cg07318767",0,1,0,0,1
"cg07318867",7,2,0,0,9
"cg07319143",86,1,0,0,87
"cg07319624",0,3,0,0,3
"cg07321237",2,0,0,0,2
"cg07321795",0,1,0,0,1
"cg07324045",0,1,0,0,1
"cg07324633",0,0,3,0,3
"cg07324752",0,0,1,0,1
"cg07325227",0,1,1,0,2
"cg07325529",3,0,0,0,3
"cg07326686",0,1,0,0,1
"cg07326692",4,2,0,0,6
"cg07327084",3,0,0,0,3
"cg07327405",0,0,1,0,1
"cg07327466",1,0,0,0,1
"cg07327927",9,5,0,0,14
"cg07327967",3,2,0,0,5
"cg07327970",0,1,0,0,1
"cg07328194",0,1,0,0,1
"cg07328838",1,0,2,0,3
"cg07329248",4,2,0,0,6
"cg07329303",8,0,0,0,8
"cg07329648",0,1,0,0,1
"cg07329713",0,1,1,0,2
"cg07330212",0,8,3,0,11
"cg07330551",5,2,0,0,7
"cg07331004",1,0,1,0,2
"cg07331306",6,1,0,0,7
"cg07332388",23,2,0,0,25
"cg07332769",0,0,3,0,3
"cg07333083",0,0,1,0,1
"cg07333418",303,259,3,0,565
"cg07333783",3,1,0,0,4
"cg07334429",0,1,0,0,1
"cg07334502",1,0,0,0,1
"cg07335131",1,0,0,0,1
"cg07335843",0,1,1,1,3
"cg07336442",60,5,1,0,66
"cg07337025",1,0,0,0,1
"cg07337720",6,6,4,0,16
"cg07338549",1,0,0,0,1
"cg07339229",15,13,0,0,28
"cg07340308",1,0,0,0,1
"cg07341022",0,2,0,0,2
"cg07341408",5,1,2,0,8
"cg07341514",0,1,0,0,1
"cg07341559",3,0,0,0,3
"cg07343708",3,5,8,0,16
"cg07344025",0,1,1,0,2
"cg07344397",0,0,1,0,1
"cg07345589",0,0,1,0,1
"cg07346744",2,0,1,0,3
"cg07346805",1,0,0,0,1
"cg07347663",79,40,6,0,125
"cg07348300",1,0,0,0,1
"cg07349793",0,1,0,0,1
"cg07350076",0,1,2,0,3
"cg07350163",0,0,1,0,1
"cg07351592",1,0,1,0,2
"cg07352416",0,1,0,0,1
"cg07352496",0,1,0,0,1
"cg07352757",1,0,0,0,1
"cg07352967",0,0,1,0,1
"cg07353803",16,4,0,0,20
"cg07354880",266,13,0,0,279
"cg07355088",1,0,2,0,3
"cg07356338",0,0,1,0,1
"cg07356655",20,16,0,0,36
"cg07356876",0,1,0,0,1
"cg07357075",389,177,8,0,574
"cg07357217",0,1,0,0,1
"cg07358009",6,1,0,0,7
"cg07359488",5,0,0,0,5
"cg07359604",2,0,0,0,2
"cg07359806",16,0,0,0,16
"cg07360644",612,167,1,0,780
"cg07360770",5,0,0,0,5
"cg07361027",28,0,0,0,28
"cg07361168",0,3,6,0,9
"cg07362684",0,2,4,0,6
"cg07362693",1,1,1,0,3
"cg07363880",0,0,1,0,1
"cg07366579",0,1,1,0,2
"cg07367727",3,1,6,0,10
"cg07368550",0,0,1,0,1
"cg07368877",10,14,2,0,26
"cg07368938",3,2,0,0,5
"cg07369507",1,0,0,0,1
"cg07370588",0,0,1,0,1
"cg07370894",1,2,0,0,3
"cg07371505",29,10,2,0,41
"cg07372609",178,2,0,0,180
"cg07373872",0,1,0,0,1
"cg07375549",2,0,0,0,2
"cg07375989",2,0,1,0,3
"cg07377002",0,1,0,0,1
"cg07377151",0,0,1,0,1
"cg07377288",0,0,3,0,3
"cg07378327",2,1,0,0,3
"cg07378577",0,1,1,0,2
"cg07378778",3,0,0,0,3
"cg07379293",0,1,0,0,1
"cg07379344",0,0,1,0,1
"cg07379707",0,0,1,0,1
"cg07379832",0,1,0,0,1
"cg07380056",46,38,0,0,84
"cg07380151",0,0,1,0,1
"cg07380282",0,3,1,0,4
"cg07381141",0,1,0,0,1
"cg07381872",0,1,0,0,1
"cg07382308",0,0,1,0,1
"cg07382826",0,0,1,0,1
"cg07383131",0,1,0,0,1
"cg07384687",1,0,0,0,1
"cg07385616",1,1,1,1,4
"cg07386868",0,0,1,0,1
"cg07386879",0,1,0,0,1
"cg07387273",3,0,0,0,3
"cg07387335",0,1,0,0,1
"cg07387471",3,6,0,0,9
"cg07387722",32,58,11,0,101
"cg07388661",1,0,0,0,1
"cg07388711",1,1,2,0,4
"cg07388897",4,1,0,0,5
"cg07389471",4,4,0,0,8
"cg07389699",0,1,0,0,1
"cg07389750",1,0,0,0,1
"cg07390522",0,1,0,0,1
"cg07390703",1,0,6,0,7
"cg07392520",0,2,0,0,2
"cg07393050",0,0,1,0,1
"cg07393352",0,1,1,0,2
"cg07393419",0,0,2,0,2
"cg07393476",2,0,0,0,2
"cg07393586",82,97,13,0,192
"cg07393618",625,181,8,0,814
"cg07393783",0,0,1,0,1
"cg07393787",4,2,0,0,6
"cg07394098",0,0,1,0,1
"cg07396293",5,0,0,0,5
"cg07396477",2,2,0,0,4
"cg07396903",760,600,8,0,1368
"cg07397078",0,0,1,0,1
"cg07397108",0,1,0,0,1
"cg07399500",3,0,3,0,6
"cg07400741",0,0,1,0,1
"cg07401394",1,0,0,0,1
"cg07401773",0,1,0,0,1
"cg07401887",0,0,2,0,2
"cg07402303",321,9,1,0,331
"cg07403728",0,1,0,0,1
"cg07403899",0,1,0,0,1
"cg07404382",7,10,0,0,17
"cg07404466",1,3,2,0,6
"cg07406780",1,0,0,0,1
"cg07406920",5,6,7,0,18
"cg07406927",0,0,2,0,2
"cg07406990",0,1,1,0,2
"cg07407209",0,0,1,0,1
"cg07408114",0,1,0,0,1
"cg07409264",20,3,0,0,23
"cg07410173",0,0,2,0,2
"cg07411754",27,4,0,0,31
"cg07412675",0,1,0,0,1
"cg07413956",0,1,0,0,1
"cg07414544",1,1,0,0,2
"cg07414643",13,14,1,0,28
"cg07415729",0,4,0,0,4
"cg07415947",4,0,0,0,4
"cg07416455",0,1,2,0,3
"cg07416686",0,0,2,0,2
"cg07417863",0,1,0,0,1
"cg07417990",1,2,0,0,3
"cg07420083",0,0,1,0,1
"cg07420137",1,0,0,0,1
"cg07420680",0,0,2,0,2
"cg07420720",135,32,0,0,167
"cg07421169",4,4,0,0,8
"cg07422438",1,1,11,0,13
"cg07423334",0,0,1,0,1
"cg07423399",0,2,3,0,5
"cg07423602",0,1,0,0,1
"cg07424132",20,3,1,0,24
"cg07424403",0,3,1,0,4
"cg07424785",1,0,0,0,1
"cg07425371",3,12,1,0,16
"cg07425885",0,1,1,0,2
"cg07426101",0,1,0,0,1
"cg07426820",3,0,0,0,3
"cg07426931",0,1,0,0,1
"cg07427559",161,166,3,0,330
"cg07427744",0,0,1,0,1
"cg07427867",1,0,0,0,1
"cg07428915",0,0,1,0,1
"cg07429108",1,0,0,0,1
"cg07430362",0,0,1,0,1
"cg07430555",4,0,0,0,4
"cg07430978",1,0,0,0,1
"cg07431748",0,0,1,0,1
"cg07431834",3,0,0,0,3
"cg07432213",0,0,1,0,1
"cg07432632",2,1,0,0,3
"cg07436158",0,0,1,0,1
"cg07436655",1,0,0,0,1
"cg07437093",2,1,5,0,8
"cg07437265",0,0,1,0,1
"cg07437385",0,1,0,0,1
"cg07437507",0,0,1,0,1
"cg07437988",16,0,0,0,16
"cg07438042",0,2,0,0,2
"cg07438451",5,0,0,0,5
"cg07438999",0,1,0,0,1
"cg07439056",0,0,4,0,4
"cg07439096",15,1,0,0,16
"cg07439154",0,0,1,0,1
"cg07440476",4,3,1,0,8
"cg07441476",9,1,0,0,10
"cg07442204",0,0,1,0,1
"cg07442271",1,0,0,0,1
"cg07445156",1,0,0,0,1
"cg07446767",0,1,0,0,1
"cg07446846",0,1,1,0,2
"cg07448286",0,1,0,0,1
"cg07448812",14,1,0,0,15
"cg07448840",3,1,0,0,4
"cg07449715",0,0,2,0,2
"cg07449881",0,1,0,0,1
"cg07449967",3,2,1,0,6
"cg07450641",0,1,5,0,6
"cg07450887",2,0,0,0,2
"cg07452586",1,0,0,0,1
"cg07452753",224,105,13,0,342
"cg07454108",77,11,1,0,89
"cg07455879",48,0,0,0,48
"cg07455963",0,0,1,0,1
"cg07456418",26,0,0,0,26
"cg07457739",0,0,0,1,1
"cg07457918",277,24,3,0,304
"cg07458992",1,0,0,0,1
"cg07459089",0,1,0,0,1
"cg07459324",65,9,0,0,74
"cg07459334",0,0,1,0,1
"cg07459506",1,0,0,0,1
"cg07460365",2,0,0,0,2
"cg07460494",0,0,1,0,1
"cg07460531",333,45,2,0,380
"cg07460600",87,24,1,0,112
"cg07460842",0,0,1,0,1
"cg07460894",10,0,0,0,10
"cg07461414",0,0,0,2,2
"cg07461501",0,1,0,0,1
"cg07462328",0,1,0,0,1
"cg07462838",1,0,0,0,1
"cg07463541",2,2,7,0,11
"cg07463633",0,0,2,0,2
"cg07464489",0,0,1,0,1
"cg07464974",1,0,0,0,1
"cg07465140",2,0,0,0,2
"cg07466437",1,0,0,0,1
"cg07466604",5,4,3,0,12
"cg07466642",1,0,0,0,1
"cg07466783",0,0,0,1,1
"cg07466923",2,0,0,0,2
"cg07467338",0,2,0,0,2
"cg07468782",0,3,0,0,3
"cg07468801",0,0,1,0,1
"cg07468862",125,32,0,0,157
"cg07469105",1,0,0,0,1
"cg07469742",0,0,1,0,1
"cg07469929",1,0,2,0,3
"cg07470362",0,2,2,0,4
"cg07470598",0,0,1,0,1
"cg07470708",1,0,0,0,1
"cg07472097",0,1,0,0,1
"cg07473478",1,0,0,0,1
"cg07473590",0,0,1,0,1
"cg07473909",4,0,0,0,4
"cg07473964",4,2,0,0,6
"cg07473976",1,1,0,0,2
"cg07474076",0,1,0,0,1
"cg07474271",10,15,0,0,25
"cg07474356",0,0,1,0,1
"cg07474663",0,0,4,0,4
"cg07477922",6,0,0,0,6
"cg07478007",0,0,1,0,1
"cg07478472",1,0,0,0,1
"cg07479450",13,3,0,0,16
"cg07479750",0,0,6,0,6
"cg07480369",0,0,1,0,1
"cg07481273",0,1,0,0,1
"cg07481290",0,0,1,0,1
"cg07482296",5,4,17,0,26
"cg07483007",2,0,0,0,2
"cg07483273",3,0,0,0,3
"cg07483523",0,2,0,0,2
"cg07483595",4,0,0,0,4
"cg07483873",1,0,0,0,1
"cg07483922",0,0,1,0,1
"cg07483989",1,0,0,0,1
"cg07484521",1,0,0,0,1
"cg07485777",1,0,0,0,1
"cg07485959",1,0,0,0,1
"cg07488365",180,5,0,0,185
"cg07488493",0,1,0,0,1
"cg07490279",0,0,1,0,1
"cg07490650",1,0,0,0,1
"cg07490692",1,0,0,0,1
"cg07492910",0,0,1,0,1
"cg07493435",0,0,1,0,1
"cg07493704",1,0,0,0,1
"cg07494987",0,0,1,0,1
"cg07495414",20,14,0,0,34
"cg07496173",1,1,0,0,2
"cg07497296",4,0,0,0,4
"cg07497428",131,612,10,0,753
"cg07497536",0,0,1,0,1
"cg07498013",0,1,0,0,1
"cg07498381",8,9,0,0,17
"cg07499759",0,0,1,0,1
"cg07500242",3,0,0,0,3
"cg07501063",0,1,0,0,1
"cg07501337",0,1,0,0,1
"cg07501864",11,0,1,0,12
"cg07502208",3,0,0,0,3
"cg07502563",0,1,0,0,1
"cg07502837",0,0,2,0,2
"cg07502868",0,1,1,0,2
"cg07504079",0,0,2,0,2
"cg07505391",0,0,1,0,1
"cg07505729",766,38,0,0,804
"cg07506698",0,0,1,0,1
"cg07506916",0,1,1,0,2
"cg07507057",3,0,2,0,5
"cg07507228",0,0,1,0,1
"cg07507776",0,0,1,0,1
"cg07507801",0,2,0,0,2
"cg07509199",5,2,1,0,8
"cg07509872",0,1,0,0,1
"cg07510885",0,1,5,0,6
"cg07511080",0,5,0,0,5
"cg07511098",4,0,0,0,4
"cg07512235",3,0,0,0,3
"cg07512790",40,6,0,0,46
"cg07513034",0,0,1,0,1
"cg07514114",10,5,0,0,15
"cg07514343",2,0,0,0,2
"cg07514801",7,15,0,0,22
"cg07515362",1,0,0,0,1
"cg07516098",0,1,0,0,1
"cg07518196",2,9,7,0,18
"cg07518362",0,0,1,0,1
"cg07520860",19,1,0,0,20
"cg07521902",9,7,0,0,16
"cg07522227",1,1,0,0,2
"cg07522440",0,0,1,0,1
"cg07522807",0,0,2,0,2
"cg07523493",2,4,4,0,10
"cg07523532",2,0,0,0,2
"cg07523833",0,0,1,0,1
"cg07524413",3,0,0,0,3
"cg07525202",0,1,0,0,1
"cg07526408",1,7,0,0,8
"cg07526598",0,4,1,0,5
"cg07527032",1,0,4,0,5
"cg07527607",0,1,0,0,1
"cg07527662",1,0,0,0,1
"cg07528254",0,1,0,0,1
"cg07528613",1,1,0,0,2
"cg07529750",3,7,0,0,10
"cg07530330",2,2,0,0,4
"cg07531507",0,1,0,0,1
"cg07532245",1,0,1,0,2
"cg07532354",1,1,0,0,2
"cg07533323",0,0,1,0,1
"cg07536161",0,1,0,0,1
"cg07537133",0,2,1,0,3
"cg07537503",1,4,0,0,5
"cg07538216",2,0,1,0,3
"cg07538406",0,1,0,0,1
"cg07538465",0,1,0,0,1
"cg07538838",321,621,7,0,949
"cg07539564",0,1,1,0,2
"cg07539997",0,2,1,0,3
"cg07541640",0,1,0,0,1
"cg07542000",0,1,0,0,1
"cg07542078",0,2,0,1,3
"cg07544392",0,1,1,0,2
"cg07545535",0,1,1,0,2
"cg07547426",0,0,1,0,1
"cg07547603",1,0,0,0,1
"cg07547730",0,3,2,0,5
"cg07548014",7,0,0,0,7
"cg07548383",0,4,6,0,10
"cg07548495",0,0,2,0,2
"cg07549526",3,0,0,0,3
"cg07549590",0,0,5,0,5
"cg07550684",0,1,2,0,3
"cg07552792",1,1,0,0,2
"cg07553085",0,0,0,1,1
"cg07553195",1,0,0,0,1
"cg07553213",0,1,0,0,1
"cg07554683",1,0,0,0,1
"cg07554775",0,2,0,0,2
"cg07554966",3,3,0,0,6
"cg07555135",6,0,0,0,6
"cg07555290",1,2,1,0,4
"cg07555343",0,1,0,0,1
"cg07556702",1,0,0,0,1
"cg07557024",34,9,0,0,43
"cg07557215",0,0,1,0,1
"cg07558006",1,0,0,0,1
"cg07559358",0,1,2,0,3
"cg07559615",0,1,1,0,2
"cg07559730",2,2,0,0,4
"cg07560401",0,0,1,0,1
"cg07560601",1,0,0,0,1
"cg07560653",1,0,0,0,1
"cg07560741",0,0,1,0,1
"cg07561148",1,0,0,0,1
"cg07561237",3,0,0,0,3
"cg07561890",1,0,0,0,1
"cg07562274",1,0,0,0,1
"cg07562773",7,1,0,0,8
"cg07563101",0,0,2,0,2
"cg07563342",0,1,0,0,1
"cg07563685",19,12,0,0,31
"cg07564133",1,0,0,0,1
"cg07564837",0,1,0,0,1
"cg07564869",0,0,1,0,1
"cg07564979",0,1,0,0,1
"cg07565404",0,1,4,0,5
"cg07565890",0,0,1,0,1
"cg07565961",0,1,4,0,5
"cg07566389",2,2,0,0,4
"cg07566437",0,1,2,0,3
"cg07566463",1,3,6,0,10
"cg07566707",1,0,0,0,1
"cg07566912",0,1,0,0,1
"cg07567294",0,0,1,0,1
"cg07568784",0,0,1,0,1
"cg07569609",2,0,0,0,2
"cg07570065",0,1,0,0,1
"cg07570663",0,1,0,0,1
"cg07572348",1,0,0,0,1
"cg07572531",2,1,0,0,3
"cg07572949",38,0,0,0,38
"cg07573279",5,2,0,0,7
"cg07573366",3,0,0,0,3
"cg07573786",1,0,0,0,1
"cg07573853",15,7,0,0,22
"cg07575166",283,56,5,0,344
"cg07575344",1,0,0,0,1
"cg07576098",1,0,0,0,1
"cg07576187",0,1,0,0,1
"cg07576894",19,2,0,0,21
"cg07576996",85,3,0,0,88
"cg07577022",0,2,0,0,2
"cg07577298",0,1,0,0,1
"cg07580831",0,0,1,0,1
"cg07582050",0,0,1,0,1
"cg07582541",1,0,1,0,2
"cg07583971",2,0,0,0,2
"cg07584771",0,1,0,0,1
"cg07584860",1,0,0,0,1
"cg07585346",0,1,0,0,1
"cg07585727",1,1,2,0,4
"cg07585732",4,0,1,0,5
"cg07586062",0,0,1,0,1
"cg07586799",5,2,3,0,10
"cg07586906",5,0,0,0,5
"cg07587512",1,3,5,1,10
"cg07587783",2,0,0,0,2
"cg07587893",0,0,1,0,1
"cg07587934",0,2,0,0,2
"cg07588413",0,0,1,0,1
"cg07588614",0,0,2,0,2
"cg07588819",0,0,1,0,1
"cg07588857",0,0,1,0,1
"cg07589078",0,0,1,0,1
"cg07589235",0,3,0,0,3
"cg07589991",1,0,0,0,1
"cg07590584",1,0,0,0,1
"cg07590638",128,30,12,0,170
"cg07591603",1,1,0,0,2
"cg07592136",2,0,0,0,2
"cg07592216",0,0,2,0,2
"cg07592681",0,0,1,0,1
"cg07593251",0,1,0,0,1
"cg07593340",1,0,0,0,1
"cg07593637",1,0,0,0,1
"cg07593662",2,0,0,0,2
"cg07594204",1,1,0,0,2
"cg07594244",1,0,0,0,1
"cg07594658",1,0,0,0,1
"cg07595841",5,8,0,0,13
"cg07596136",1,1,0,0,2
"cg07596401",3,0,0,0,3
"cg07596985",1,0,0,0,1
"cg07597885",1,0,0,0,1
"cg07598464",0,1,0,0,1
"cg07598801",2,0,0,0,2
"cg07599579",54,49,6,0,109
"cg07599659",4,0,0,0,4
"cg07601484",3,0,0,0,3
"cg07602297",1,0,0,0,1
"cg07602567",1,7,11,0,19
"cg07602613",0,0,3,0,3
"cg07602740",0,2,4,0,6
"cg07603267",220,10,0,0,230
"cg07603843",0,1,0,0,1
"cg07607269",0,1,0,0,1
"cg07607354",16,2,0,0,18
"cg07607704",0,0,1,0,1
"cg07608562",0,0,1,0,1
"cg07608671",1,1,1,0,3
"cg07609108",0,0,3,0,3
"cg07609466",0,1,0,0,1
"cg07609715",2,1,0,0,3
"cg07610822",1,1,1,0,3
"cg07611321",0,1,0,0,1
"cg07611721",2,0,0,0,2
"cg07611887",0,0,1,0,1
"cg07612889",79,77,1,0,157
"cg07613361",4,0,0,0,4
"cg07614125",0,0,1,0,1
"cg07614174",0,0,2,0,2
"cg07614344",1,4,20,0,25
"cg07615781",1,1,4,0,6
"cg07617384",1,1,1,0,3
"cg07617768",0,0,1,0,1
"cg07618045",0,0,1,0,1
"cg07618048",0,0,1,0,1
"cg07618258",2,0,0,0,2
"cg07618768",0,0,2,0,2
"cg07620039",1,1,0,0,2
"cg07620830",3,0,0,0,3
"cg07621227",0,0,3,0,3
"cg07621312",1,0,0,0,1
"cg07621660",4,7,3,0,14
"cg07622533",0,1,0,0,1
"cg07624616",0,4,1,0,5
"cg07625092",1,1,0,0,2
"cg07625205",0,0,1,0,1
"cg07627602",0,0,1,0,1
"cg07627664",0,1,0,0,1
"cg07627951",31,1,0,0,32
"cg07628178",0,1,0,0,1
"cg07628839",2,0,1,0,3
"cg07630035",1,0,0,0,1
"cg07630509",2,0,0,0,2
"cg07630716",2,0,0,0,2
"cg07631857",1,1,0,0,2
"cg07632538",24,2,0,0,26
"cg07632663",97,30,1,0,128
"cg07633119",224,91,7,0,322
"cg07633583",0,0,1,0,1
"cg07633664",1,0,0,0,1
"cg07633701",0,0,1,0,1
"cg07634082",0,0,6,0,6
"cg07634444",0,1,0,0,1
"cg07635928",0,2,0,0,2
"cg07636194",2,0,0,0,2
"cg07636467",0,0,2,0,2
"cg07636809",1,0,0,0,1
"cg07637183",1,0,0,0,1
"cg07637599",177,107,8,0,292
"cg07638249",0,1,3,0,4
"cg07638938",0,1,0,0,1
"cg07639259",6,4,0,0,10
"cg07639739",0,1,0,0,1
"cg07640666",0,0,1,0,1
"cg07640752",1,0,0,0,1
"cg07640959",0,1,0,0,1
"cg07641355",3,0,0,0,3
"cg07643314",4,0,0,0,4
"cg07644467",0,0,1,0,1
"cg07645542",10,6,2,0,18
"cg07645656",2,0,0,0,2
"cg07645858",251,324,32,0,607
"cg07646007",16,11,1,0,28
"cg07646069",0,0,1,0,1
"cg07646267",1,1,7,0,9
"cg07646562",0,0,1,0,1
"cg07646631",0,0,1,0,1
"cg07646665",2,1,0,0,3
"cg07649370",1,2,0,0,3
"cg07649992",0,2,2,0,4
"cg07651832",0,0,1,0,1
"cg07653370",2,0,0,0,2
"cg07653418",0,1,0,0,1
"cg07653477",0,0,0,1,1
"cg07655261",0,0,1,0,1
"cg07655602",1,0,0,0,1
"cg07655605",1,0,0,0,1
"cg07655636",0,1,0,0,1
"cg07656304",0,1,0,0,1
"cg07657044",0,0,1,0,1
"cg07657192",1,0,0,0,1
"cg07658428",2,1,1,0,4
"cg07658439",334,57,0,0,391
"cg07660283",0,0,1,0,1
"cg07660811",1,0,0,0,1
"cg07661093",1,0,0,0,1
"cg07661389",0,2,1,0,3
"cg07661754",5,0,0,0,5
"cg07661836",1,0,0,0,1
"cg07663200",0,0,1,0,1
"cg07664323",0,1,0,0,1
"cg07665650",1,0,0,0,1
"cg07665907",0,0,1,0,1
"cg07666246",1,3,0,0,4
"cg07669260",0,8,0,0,8
"cg07670185",0,0,1,0,1
"cg07670259",1,0,0,0,1
"cg07670928",0,2,1,0,3
"cg07672343",1,0,0,0,1
"cg07673083",133,253,131,0,517
"cg07673089",11,0,0,0,11
"cg07673702",11,0,0,0,11
"cg07674056",0,0,1,0,1
"cg07674644",1,5,1,0,7
"cg07675647",1,0,0,0,1
"cg07675668",209,13,1,0,223
"cg07679226",0,0,1,0,1
"cg07679581",1,0,1,0,2
"cg07680047",15,4,1,0,20
"cg07680858",0,0,1,0,1
"cg07682009",0,0,1,0,1
"cg07682194",1,1,1,0,3
"cg07682748",1,3,0,0,4
"cg07684818",34,1,0,0,35
"cg07684898",0,1,0,0,1
"cg07685253",2,2,0,0,4
"cg07685606",0,0,1,0,1
"cg07685627",0,0,1,0,1
"cg07686628",0,2,0,0,2
"cg07686733",13,3,0,0,16
"cg07687119",1,0,0,0,1
"cg07687820",1,1,0,0,2
"cg07688274",1,0,15,0,16
"cg07688855",3,7,0,0,10
"cg07688922",8,6,1,0,15
"cg07689032",720,47,0,0,767
"cg07689148",11,2,0,0,13
"cg07690441",4,14,3,0,21
"cg07690692",0,0,1,0,1
"cg07691366",4,0,0,0,4
"cg07691663",0,1,0,0,1
"cg07692540",3,7,2,0,12
"cg07693523",0,1,0,0,1
"cg07694221",0,0,1,0,1
"cg07694711",97,196,91,0,384
"cg07694754",0,0,1,0,1
"cg07695047",0,0,1,0,1
"cg07695488",18,10,0,0,28
"cg07696173",1,0,0,0,1
"cg07696464",5,2,0,0,7
"cg07696670",7,0,0,0,7
"cg07698321",0,1,0,0,1
"cg07699845",0,0,1,0,1
"cg07700847",2,0,0,0,2
"cg07701166",1,0,0,0,1
"cg07703119",3,1,0,0,4
"cg07703249",0,1,1,0,2
"cg07703679",4,0,0,0,4
"cg07703899",0,0,1,0,1
"cg07704242",0,0,2,0,2
"cg07705327",1,0,0,0,1
"cg07706362",0,0,1,0,1
"cg07707039",0,1,0,0,1
"cg07707641",0,1,0,0,1
"cg07708016",0,0,1,0,1
"cg07708613",0,4,3,0,7
"cg07708777",0,0,1,0,1
"cg07708951",22,3,0,0,25
"cg07709314",0,0,1,0,1
"cg07709414",0,1,0,0,1
"cg07709959",2,1,1,0,4
"cg07711067",0,1,0,0,1
"cg07712267",0,0,2,0,2
"cg07713695",47,2,0,0,49
"cg07713796",0,2,0,0,2
"cg07716280",150,180,4,0,334
"cg07717198",11,11,0,0,22
"cg07717491",501,882,55,0,1438
"cg07718349",20,13,0,0,33
"cg07718716",3,3,8,0,14
"cg07719253",0,0,1,0,1
"cg07719261",0,1,0,0,1
"cg07719772",5,3,1,0,9
"cg07721440",0,1,0,0,1
"cg07721848",0,0,2,0,2
"cg07722505",1,0,1,0,2
"cg07724414",1,0,0,0,1
"cg07724643",0,1,1,0,2
"cg07724654",38,0,0,0,38
"cg07725198",1,0,0,0,1
"cg07725685",7,0,0,0,7
"cg07726456",0,0,2,0,2
"cg07726457",0,0,2,0,2
"cg07726756",1,0,0,0,1
"cg07728215",0,0,2,0,2
"cg07728631",0,1,0,0,1
"cg07733129",0,0,1,0,1
"cg07735710",0,1,0,0,1
"cg07735952",1,0,0,0,1
"cg07736415",3,7,4,0,14
"cg07736578",0,0,1,0,1
"cg07736705",1,0,1,0,2
"cg07737469",2,4,1,0,7
"cg07737810",2,0,0,0,2
"cg07739630",0,1,0,0,1
"cg07740199",0,1,5,0,6
"cg07740245",0,1,0,0,1
"cg07740266",13,89,7,0,109
"cg07740914",167,2,0,0,169
"cg07743199",0,2,0,0,2
"cg07743548",17,9,3,0,29
"cg07743747",2,0,0,0,2
"cg07743908",3,0,0,0,3
"cg07743919",4,2,2,0,8
"cg07744210",0,0,0,1,1
"cg07745102",10,0,0,0,10
"cg07745418",1,0,0,0,1
"cg07745725",1,1,3,0,5
"cg07745899",33,2,1,0,36
"cg07746427",2,7,2,0,11
"cg07747791",0,1,0,0,1
"cg07747871",7,0,0,0,7
"cg07747875",0,0,1,0,1
"cg07748193",259,89,1,0,349
"cg07748875",1,0,0,0,1
"cg07749174",0,0,2,0,2
"cg07750118",0,0,1,0,1
"cg07750508",1,0,0,0,1
"cg07750529",0,0,1,0,1
"cg07750560",1,0,0,0,1
"cg07750638",35,16,3,0,54
"cg07750813",31,10,3,0,44
"cg07751304",0,0,1,0,1
"cg07751463",1,0,0,0,1
"cg07752596",115,321,245,0,681
"cg07753245",11,0,0,0,11
"cg07753967",2,0,0,0,2
"cg07754407",0,1,1,0,2
"cg07754531",122,25,2,0,149
"cg07754829",1,1,0,0,2
"cg07754879",0,3,2,0,5
"cg07756562",118,20,0,0,138
"cg07757454",8,0,0,0,8
"cg07757545",690,579,11,0,1280
"cg07757575",1,0,0,0,1
"cg07757885",0,0,1,0,1
"cg07758528",0,5,0,0,5
"cg07760026",4,0,1,0,5
"cg07760800",74,7,0,0,81
"cg07761367",0,0,0,2,2
"cg07762474",1,0,0,0,1
"cg07762485",11,0,0,0,11
"cg07762785",1,2,0,0,3
"cg07762944",0,0,1,0,1
"cg07763398",1,0,0,0,1
"cg07763662",90,1,0,0,91
"cg07764140",109,14,0,0,123
"cg07765167",0,1,0,0,1
"cg07765595",1,0,0,0,1
"cg07765760",0,1,0,0,1
"cg07765828",1,0,2,0,3
"cg07767255",3,3,0,0,6
"cg07767825",1,0,0,0,1
"cg07768516",1371,270,4,0,1645
"cg07769070",0,0,1,0,1
"cg07769893",1,0,0,0,1
"cg07770560",0,0,7,1,8
"cg07772324",2,1,3,2,8
"cg07772467",0,1,2,0,3
"cg07772660",0,1,0,0,1
"cg07773593",0,1,0,0,1
"cg07774906",1,1,1,0,3
"cg07775117",0,0,1,0,1
"cg07776664",149,2,2,0,153
"cg07777156",10,1,4,0,15
"cg07777725",2,1,0,0,3
"cg07778900",0,0,1,0,1
"cg07778983",1,0,0,0,1
"cg07779179",48,2,0,0,50
"cg07779782",5,1,0,0,6
"cg07780979",0,0,1,0,1
"cg07781865",2,0,0,0,2
"cg07782101",0,1,0,0,1
"cg07782381",2,0,0,0,2
"cg07782415",1,0,0,0,1
"cg07785225",3,0,0,0,3
"cg07787595",3,0,0,0,3
"cg07787870",0,0,1,0,1
"cg07788575",0,1,0,0,1
"cg07788609",0,0,1,0,1
"cg07789750",1,0,0,0,1
"cg07790831",1,1,0,0,2
"cg07792006",4,0,0,0,4
"cg07792320",0,0,1,0,1
"cg07792719",3,1,0,0,4
"cg07793537",6,0,2,0,8
"cg07793789",0,0,1,0,1
"cg07793952",4,0,1,0,5
"cg07794230",1,0,0,0,1
"cg07794944",2,0,0,0,2
"cg07795949",4,0,0,0,4
"cg07797560",20,2,0,0,22
"cg07797833",0,1,2,0,3
"cg07799157",9,1,0,0,10
"cg07800079",4,2,0,0,6
"cg07801283",2,0,0,0,2
"cg07801576",1,0,0,0,1
"cg07802551",2,0,0,0,2
"cg07803710",0,0,1,0,1
"cg07804024",1,0,0,0,1
"cg07806771",0,0,1,0,1
"cg07806921",2,0,0,0,2
"cg07807693",1,0,2,0,3
"cg07808174",2,1,0,0,3
"cg07808302",0,1,0,0,1
"cg07808638",0,0,1,0,1
"cg07808983",7,5,0,0,12
"cg07809474",0,0,1,0,1
"cg07810091",0,1,0,0,1
"cg07810366",0,0,2,0,2
"cg07810522",0,0,1,0,1
"cg07810671",149,11,0,0,160
"cg07810716",0,0,1,0,1
"cg07810958",0,0,1,0,1
"cg07811719",157,8,0,0,165
"cg07811931",0,1,1,0,2
"cg07813747",0,1,1,0,2
"cg07813855",1,0,0,0,1
"cg07814345",1,3,5,0,9
"cg07814731",10,1,0,0,11
"cg07814742",95,73,23,0,191
"cg07816163",0,2,1,0,3
"cg07816637",1,2,0,0,3
"cg07817675",1,0,0,0,1
"cg07818063",84,3,0,0,87
"cg07818949",1,0,0,0,1
"cg07819497",0,0,1,0,1
"cg07819861",1,0,0,0,1
"cg07820702",0,1,0,0,1
"cg07820786",1,0,0,2,3
"cg07821305",1,0,0,0,1
"cg07821599",5,0,0,0,5
"cg07821690",0,0,1,1,2
"cg07822613",0,0,1,0,1
"cg07822928",0,2,0,0,2
"cg07823489",0,0,1,0,1
"cg07824272",684,115,5,0,804
"cg07824710",1,0,0,0,1
"cg07824716",0,1,0,0,1
"cg07825955",0,0,1,0,1
"cg07828739",2,0,0,0,2
"cg07829209",832,362,7,0,1201
"cg07829232",0,0,2,0,2
"cg07829469",0,0,4,0,4
"cg07829690",14,0,0,0,14
"cg07830287",0,0,3,0,3
"cg07830695",7,2,0,0,9
"cg07832761",0,0,1,0,1
"cg07833209",0,0,2,0,2
"cg07833472",0,8,0,0,8
"cg07833955",0,0,7,0,7
"cg07834423",0,0,1,0,1
"cg07834670",1,0,0,0,1
"cg07836478",1,3,0,0,4
"cg07839513",3,0,0,0,3
"cg07840471",8,0,0,0,8
"cg07840995",0,0,1,0,1
"cg07841357",431,58,1,0,490
"cg07841686",1,0,0,0,1
"cg07842726",0,2,0,0,2
"cg07843073",2,0,0,0,2
"cg07843463",13,0,0,0,13
"cg07843905",22,1,0,0,23
"cg07844507",0,1,0,0,1
"cg07844659",0,0,1,0,1
"cg07846565",0,0,1,0,1
"cg07847890",12,1,0,0,13
"cg07848485",1,0,0,0,1
"cg07848655",0,0,1,0,1
"cg07848981",3,3,0,0,6
"cg07850316",0,0,1,0,1
"cg07851244",0,2,0,1,3
"cg07851361",4,2,4,0,10
"cg07851470",3,0,0,0,3
"cg07851521",2,0,1,0,3
"cg07852224",2,8,6,0,16
"cg07852429",0,0,1,0,1
"cg07853501",1,0,0,0,1
"cg07854009",0,0,1,0,1
"cg07854339",0,1,1,0,2
"cg07855045",7,3,3,0,13
"cg07855322",208,200,24,0,432
"cg07855337",1,0,0,0,1
"cg07855754",3,0,0,0,3
"cg07856280",1,0,0,0,1
"cg07856387",142,58,3,0,203
"cg07856721",1,0,0,0,1
"cg07858412",0,1,0,0,1
"cg07858489",0,1,2,0,3
"cg07858613",1,1,0,0,2
"cg07858952",0,1,0,0,1
"cg07858972",0,0,0,1,1
"cg07861321",0,0,1,0,1
"cg07861329",4,2,0,0,6
"cg07863373",1,0,1,0,2
"cg07863638",1,0,0,0,1
"cg07864801",11,0,0,0,11
"cg07866524",2,2,0,0,4
"cg07866612",0,0,1,0,1
"cg07866630",0,0,1,0,1
"cg07870039",1,0,0,0,1
"cg07870213",0,0,2,0,2
"cg07870293",0,1,0,0,1
"cg07870528",0,1,0,0,1
"cg07871083",132,70,1,0,203
"cg07871393",0,0,1,0,1
"cg07872558",6,0,0,0,6
"cg07872608",124,199,141,0,464
"cg07872979",0,0,1,0,1
"cg07873068",0,2,0,0,2
"cg07873243",0,1,0,0,1
"cg07874738",8,19,12,0,39
"cg07876350",0,0,1,0,1
"cg07876576",0,0,1,0,1
"cg07877097",2,0,0,0,2
"cg07877145",1,1,0,0,2
"cg07877179",0,1,0,0,1
"cg07877497",1,0,0,0,1
"cg07878191",2,2,0,0,4
"cg07879640",0,0,2,0,2
"cg07879681",0,1,1,0,2
"cg07882184",0,4,1,0,5
"cg07882546",54,2,0,0,56
"cg07883031",71,9,2,0,82
"cg07883262",1,0,0,0,1
"cg07885834",0,3,5,0,8
"cg07886337",1,0,0,0,1
"cg07887247",1,0,0,0,1
"cg07887387",1,0,0,0,1
"cg07888679",0,0,1,0,1
"cg07890131",3,0,0,0,3
"cg07890882",0,1,1,0,2
"cg07891654",0,1,0,0,1
"cg07891737",1,1,1,0,3
"cg07892140",1,2,0,0,3
"cg07892413",0,0,1,0,1
"cg07892451",0,0,1,0,1
"cg07893128",0,4,0,0,4
"cg07893709",1,1,4,0,6
"cg07895538",0,0,1,0,1
"cg07897372",0,1,0,0,1
"cg07898108",1,0,0,0,1
"cg07898500",0,3,1,0,4
"cg07899240",0,2,0,0,2
"cg07899342",0,0,1,0,1
"cg07899983",0,1,0,0,1
"cg07900281",522,66,0,0,588
"cg07900823",0,0,2,0,2
"cg07901472",77,595,72,0,744
"cg07902120",0,0,3,0,3
"cg07902406",38,66,1,0,105
"cg07903073",0,0,1,0,1
"cg07903153",0,1,0,0,1
"cg07903918",0,1,0,0,1
"cg07904255",1,0,0,0,1
"cg07905191",46,1,0,0,47
"cg07905537",1,0,0,0,1
"cg07905544",2,0,0,0,2
"cg07905749",0,0,1,0,1
"cg07905836",2,0,4,0,6
"cg07905965",0,1,0,0,1
"cg07908229",0,1,2,0,3
"cg07908903",1,0,0,0,1
"cg07908999",0,0,2,0,2
"cg07910050",0,1,0,0,1
"cg07910736",0,4,0,2,6
"cg07911310",22,10,2,0,34
"cg07911444",146,7,0,0,153
"cg07911962",263,15,0,0,278
"cg07912018",0,3,0,0,3
"cg07912453",3,3,0,0,6
"cg07912561",1,0,0,0,1
"cg07912888",0,1,0,0,1
"cg07913503",75,6,0,0,81
"cg07913806",3,1,9,0,13
"cg07915318",1,0,0,0,1
"cg07915323",0,2,1,0,3
"cg07916137",0,1,0,0,1
"cg07917473",0,0,2,0,2
"cg07917750",0,1,0,0,1
"cg07917808",0,1,1,0,2
"cg07917842",1,0,1,0,2
"cg07918723",0,0,1,0,1
"cg07919028",0,0,1,0,1
"cg07919753",0,0,0,1,1
"cg07919805",1,0,0,0,1
"cg07920282",617,107,1,0,725
"cg07920452",1,0,0,0,1
"cg07921164",0,0,2,0,2
"cg07921682",235,4,0,0,239
"cg07922434",0,8,8,0,16
"cg07923588",0,0,1,0,1
"cg07924013",0,1,0,0,1
"cg07924971",1,0,0,0,1
"cg07925105",0,0,1,0,1
"cg07925246",1,0,0,0,1
"cg07926178",0,2,16,0,18
"cg07926770",12,0,0,0,12
"cg07926903",0,1,0,0,1
"cg07926986",1,0,0,0,1
"cg07929078",2,0,0,0,2
"cg07929112",0,1,0,0,1
"cg07929264",0,4,0,0,4
"cg07930329",20,1,0,0,21
"cg07933656",0,0,1,0,1
"cg07933929",0,0,1,0,1
"cg07934026",0,1,1,0,2
"cg07934561",0,0,1,0,1
"cg07934604",2,0,0,0,2
"cg07935255",0,2,0,0,2
"cg07935274",1,2,1,0,4
"cg07935490",0,0,1,0,1
"cg07936541",0,1,0,0,1
"cg07937091",6,1,0,0,7
"cg07937544",314,1095,52,0,1461
"cg07938009",0,1,0,0,1
"cg07938509",654,91,2,0,747
"cg07938676",7,0,0,0,7
"cg07939831",4,0,0,0,4
"cg07940072",0,1,0,0,1
"cg07940280",33,2,0,0,35
"cg07940703",4,0,0,0,4
"cg07941860",1,3,1,0,5
"cg07942194",0,0,1,0,1
"cg07942217",0,0,1,0,1
"cg07942324",0,1,1,0,2
"cg07942727",1,0,0,0,1
"cg07942774",0,0,1,0,1
"cg07943461",0,1,1,0,2
"cg07943737",2,0,0,0,2
"cg07943766",1,0,0,0,1
"cg07943881",0,0,1,0,1
"cg07944494",0,19,3,0,22
"cg07944762",1,0,0,0,1
"cg07944793",0,0,1,0,1
"cg07945460",735,26,1,0,762
"cg07945925",0,1,0,0,1
"cg07946795",66,1,0,0,67
"cg07947385",4,0,1,0,5
"cg07947520",2,2,0,0,4
"cg07947847",0,1,1,0,2
"cg07948534",2,0,0,0,2
"cg07949500",1,0,0,0,1
"cg07951151",2,0,4,0,6
"cg07951749",0,0,1,0,1
"cg07951900",1,5,1,0,7
"cg07953082",0,0,1,0,1
"cg07953310",0,1,0,0,1
"cg07954776",0,0,1,0,1
"cg07955741",0,0,1,0,1
"cg07955933",1,0,0,0,1
"cg07956259",1,0,0,0,1
"cg07956857",2,2,0,0,4
"cg07957551",1,0,0,0,1
"cg07957706",0,1,0,0,1
"cg07957795",3,1,0,0,4
"cg07958169",0,1,0,0,1
"cg07959124",0,1,0,0,1
"cg07959403",1,0,0,0,1
"cg07959490",1,0,0,0,1
"cg07961278",140,14,0,0,154
"cg07961637",1,0,0,0,1
"cg07962218",0,0,1,0,1
"cg07962522",1,0,0,0,1
"cg07962593",0,0,0,1,1
"cg07963358",0,0,1,0,1
"cg07963361",1,0,0,0,1
"cg07963706",0,0,1,0,1
"cg07964060",5,3,1,0,9
"cg07964244",3,0,0,0,3
"cg07964602",0,0,1,0,1
"cg07966051",1,1,5,0,7
"cg07966289",0,0,1,0,1
"cg07966808",0,1,0,0,1
"cg07967114",1,0,0,0,1
"cg07967630",0,4,7,0,11
"cg07969008",0,0,1,0,1
"cg07969055",23,1,0,0,24
"cg07969769",0,0,6,0,6
"cg07969785",0,0,1,0,1
"cg07970541",2,0,2,0,4
"cg07970973",1,0,0,0,1
"cg07971250",0,0,20,0,20
"cg07971743",1,1,0,0,2
"cg07971827",333,110,8,0,451
"cg07972787",14,1,0,0,15
"cg07972887",0,1,0,0,1
"cg07973507",0,1,1,0,2
"cg07974031",1,1,1,0,3
"cg07974772",72,3,0,0,75
"cg07975985",1,1,0,0,2
"cg07976578",7,0,0,0,7
"cg07976669",2,5,3,0,10
"cg07976864",2,1,0,0,3
"cg07976976",2,0,0,0,2
"cg07977171",1,5,0,0,6
"cg07977388",1,0,0,0,1
"cg07977689",4,5,0,0,9
"cg07978371",1,0,0,0,1
"cg07978901",1,0,0,0,1
"cg07980295",18,1,0,0,19
"cg07980324",0,1,0,0,1
"cg07980466",0,12,3,0,15
"cg07981080",1,0,0,0,1
"cg07981991",0,1,0,0,1
"cg07983453",7,1,0,0,8
"cg07986413",18,2,0,0,20
"cg07986685",48,30,1,0,79
"cg07986887",1,0,0,0,1
"cg07987449",0,1,0,0,1
"cg07988713",568,36,1,0,605
"cg07989373",337,22,0,0,359
"cg07989450",2,0,0,0,2
"cg07989733",3,0,4,0,7
"cg07989829",0,1,1,0,2
"cg07990036",2,1,0,0,3
"cg07990343",7,7,0,0,14
"cg07991167",0,0,2,0,2
"cg07991252",0,1,0,0,1
"cg07992604",0,1,0,0,1
"cg07992633",1018,572,1,0,1591
"cg07992759",1,0,1,0,2
"cg07993731",3,2,0,0,5
"cg07994580",3,1,15,0,19
"cg07995259",0,1,1,0,2
"cg07996558",2,0,2,0,4
"cg07997387",0,1,0,0,1
"cg07998479",2,4,0,0,6
"cg07999037",0,0,1,0,1
"cg07999542",0,1,0,0,1
"cg08000261",1,0,0,0,1
"cg08002447",3,0,0,0,3
"cg08003742",0,0,2,0,2
"cg08004206",0,4,0,0,4
"cg08004698",0,2,15,0,17
"cg08005007",83,213,245,0,541
"cg08007234",18,8,1,0,27
"cg08007304",1,1,1,0,3
"cg08007557",0,0,1,0,1
"cg08008286",0,1,0,0,1
"cg08008696",2,0,0,0,2
"cg08009313",14,5,0,0,19
"cg08009379",0,0,1,0,1
"cg08009568",0,1,1,0,2
"cg08010037",448,51,0,0,499
"cg08010214",1,0,0,0,1
"cg08012156",0,1,0,0,1
"cg08012922",2,0,0,0,2
"cg08013114",0,2,2,0,4
"cg08015257",1,0,1,0,2
"cg08015467",2,6,0,0,8
"cg08017202",1,0,0,0,1
"cg08017389",1,2,1,0,4
"cg08017453",0,0,1,0,1
"cg08018385",1,0,0,0,1
"cg08018968",1,0,0,0,1
"cg08019449",0,1,0,0,1
"cg08020945",0,0,0,1,1
"cg08021120",0,1,0,0,1
"cg08023458",1,0,0,0,1
"cg08023476",14,0,0,0,14
"cg08024053",0,1,3,0,4
"cg08024278",4,1,0,0,5
"cg08026791",1,0,0,0,1
"cg08027440",0,0,1,0,1
"cg08028004",2,1,0,0,3
"cg08028247",5,3,0,0,8
"cg08028341",0,0,1,0,1
"cg08028425",0,12,15,0,27
"cg08028698",53,4,0,0,57
"cg08029105",4,1,0,0,5
"cg08029610",600,126,0,0,726
"cg08029978",1,0,0,0,1
"cg08030851",0,1,1,0,2
"cg08031346",18,1,0,0,19
"cg08031518",0,1,3,0,4
"cg08032338",3,2,0,0,5
"cg08033285",1,0,0,0,1
"cg08035144",0,0,1,0,1
"cg08035449",0,0,1,0,1
"cg08035771",0,0,1,0,1
"cg08035872",6,2,1,0,9
"cg08037664",0,0,2,0,2
"cg08038224",0,0,7,0,7
"cg08038567",0,2,0,0,2
"cg08039008",0,0,1,0,1
"cg08039281",0,0,1,0,1
"cg08039385",0,0,1,0,1
"cg08039587",1,0,0,0,1
"cg08039701",0,1,0,0,1
"cg08040660",1,0,0,0,1
"cg08041536",0,3,0,0,3
"cg08041573",1,0,0,0,1
"cg08042345",114,14,0,0,128
"cg08042477",4,0,0,0,4
"cg08042799",0,1,0,0,1
"cg08043017",13,1,0,0,14
"cg08043447",9,10,0,0,19
"cg08043779",3,0,0,0,3
"cg08044366",2,8,3,0,13
"cg08044620",0,0,1,0,1
"cg08044718",7,11,1,0,19
"cg08045489",0,1,0,0,1
"cg08045712",3,3,8,0,14
"cg08047135",0,1,0,0,1
"cg08047391",0,0,1,0,1
"cg08047889",390,75,3,0,468
"cg08047902",3,12,2,0,17
"cg08048385",0,1,0,0,1
"cg08049592",0,1,0,0,1
"cg08050006",2,0,0,0,2
"cg08051049",1,0,0,0,1
"cg08051237",173,30,1,1,205
"cg08051322",0,0,1,0,1
"cg08051445",1,0,0,0,1
"cg08052302",0,2,0,0,2
"cg08053115",0,0,1,0,1
"cg08056835",2,0,0,0,2
"cg08057876",0,1,0,0,1
"cg08058191",0,3,0,0,3
"cg08058470",0,0,0,1,1
"cg08059058",1,0,0,0,1
"cg08061076",2,9,4,0,15
"cg08063724",0,1,0,0,1
"cg08065238",6,26,13,0,45
"cg08065292",0,1,0,0,1
"cg08065835",1,1,0,0,2
"cg08066384",0,0,1,0,1
"cg08066535",0,2,0,0,2
"cg08068375",0,1,0,0,1
"cg08068547",13,2,1,0,16
"cg08071329",0,0,2,0,2
"cg08071391",568,1016,29,0,1613
"cg08071595",7,2,1,0,10
"cg08071915",1,1,1,0,3
"cg08072458",1,2,0,0,3
"cg08072863",1,0,0,0,1
"cg08073009",0,0,1,0,1
"cg08073113",0,2,0,0,2
"cg08073294",1,0,2,0,3
"cg08073884",1,0,0,0,1
"cg08074555",1,0,1,0,2
"cg08075604",33,0,0,1,34
"cg08075677",2,0,0,0,2
"cg08075740",0,1,4,0,5
"cg08076532",274,137,2,0,413
"cg08076847",0,1,0,0,1
"cg08078541",4,8,15,0,27
"cg08079056",0,0,1,0,1
"cg08079511",8,1,0,0,9
"cg08080024",1,0,0,0,1
"cg08081379",0,1,0,0,1
"cg08082943",3,2,0,0,5
"cg08083435",0,0,3,0,3
"cg08084616",0,0,1,0,1
"cg08085668",4,3,8,0,15
"cg08087657",1,0,0,0,1
"cg08087673",2,5,2,0,9
"cg08089364",2,0,0,0,2
"cg08089702",0,1,1,0,2
"cg08090296",1,0,4,0,5
"cg08090769",1,0,0,0,1
"cg08091163",0,1,0,0,1
"cg08091579",4,0,0,0,4
"cg08092515",0,1,0,0,1
"cg08093398",3,2,0,0,5
"cg08093564",0,0,2,0,2
"cg08094128",4,1,0,0,5
"cg08095339",0,1,1,0,2
"cg08095340",1,1,0,0,2
"cg08095345",0,1,0,0,1
"cg08095359",4,0,0,0,4
"cg08095613",4,0,3,0,7
"cg08095628",0,0,1,0,1
"cg08096143",0,2,0,0,2
"cg08096812",0,0,6,0,6
"cg08097929",0,2,0,0,2
"cg08099416",0,6,0,0,6
"cg08100031",0,1,0,0,1
"cg08100432",0,0,1,0,1
"cg08100944",0,0,1,0,1
"cg08101922",1,0,0,0,1
"cg08102814",12,1,0,0,13
"cg08103220",0,1,0,0,1
"cg08103359",4,1,0,0,5
"cg08103644",0,0,1,0,1
"cg08105183",2,0,0,0,2
"cg08105529",0,0,0,2,2
"cg08106449",0,1,0,0,1
"cg08106565",0,0,1,0,1
"cg08106635",0,1,0,0,1
"cg08107352",1,0,0,0,1
"cg08107689",0,0,1,0,1
"cg08108713",0,1,0,0,1
"cg08108965",1,0,0,0,1
"cg08109568",0,1,0,0,1
"cg08110005",5,2,0,0,7
"cg08110291",11,1,0,0,12
"cg08111035",1,1,2,0,4
"cg08111251",0,0,1,0,1
"cg08112534",1,7,2,0,10
"cg08113624",0,1,0,0,1
"cg08113639",0,0,1,0,1
"cg08113691",0,0,2,0,2
"cg08113913",0,1,0,0,1
"cg08114547",0,0,1,0,1
"cg08116137",0,0,1,0,1
"cg08116260",1,1,0,0,2
"cg08116922",1,0,0,0,1
"cg08119201",1,0,0,0,1
"cg08119506",184,114,18,0,316
"cg08121102",119,98,0,0,217
"cg08121729",6,3,0,0,9
"cg08122018",2,0,0,0,2
"cg08122948",2,0,0,0,2
"cg08123455",1,0,0,0,1
"cg08126299",0,0,1,0,1
"cg08127021",0,1,0,0,1
"cg08127694",1,0,0,0,1
"cg08127858",0,0,5,0,5
"cg08128444",108,7,0,0,115
"cg08129150",1,1,0,0,2
"cg08129266",8,0,0,0,8
"cg08130060",0,0,1,0,1
"cg08131169",34,6,1,0,41
"cg08133850",0,0,1,0,1
"cg08135103",1,0,0,0,1
"cg08135333",2,0,0,0,2
"cg08135460",0,0,4,0,4
"cg08135815",0,1,0,0,1
"cg08136070",195,5,0,0,200
"cg08137564",368,8,0,0,376
"cg08137671",0,0,1,0,1
"cg08138005",1,0,0,0,1
"cg08140237",1,0,0,0,1
"cg08141049",0,1,0,0,1
"cg08142253",3,0,0,0,3
"cg08142344",0,1,0,0,1
"cg08142983",16,1,0,0,17
"cg08143688",1,5,0,0,6
"cg08143715",28,2,0,0,30
"cg08144319",1,0,0,0,1
"cg08145495",21,0,0,0,21
"cg08146026",1,0,0,0,1
"cg08146256",1,0,0,0,1
"cg08146495",1,2,0,0,3
"cg08148379",1,0,1,0,2
"cg08149071",0,1,1,0,2
"cg08152083",9,8,2,0,19
"cg08152331",3,0,0,0,3
"cg08152599",0,0,1,0,1
"cg08153621",0,1,0,0,1
"cg08154187",0,1,4,0,5
"cg08154700",350,24,0,0,374
"cg08154731",0,0,1,0,1
"cg08155050",3,0,0,0,3
"cg08157101",7,0,0,0,7
"cg08157440",0,1,0,0,1
"cg08158115",12,2,0,0,14
"cg08158805",3,0,0,0,3
"cg08159343",1,0,0,0,1
"cg08160057",0,0,2,0,2
"cg08160079",7,0,0,0,7
"cg08160108",2,0,0,0,2
"cg08160317",1,2,0,0,3
"cg08160771",2,0,0,0,2
"cg08160871",1,0,0,0,1
"cg08160891",0,0,3,0,3
"cg08161325",0,1,0,0,1
"cg08161491",0,0,1,0,1
"cg08161628",169,130,7,0,306
"cg08163494",1,0,2,0,3
"cg08163714",1,0,0,0,1
"cg08164977",106,11,1,0,118
"cg08165108",1,2,0,0,3
"cg08165558",0,0,0,1,1
"cg08165875",0,0,1,0,1
"cg08167039",0,0,1,0,1
"cg08167250",0,0,1,0,1
"cg08167748",1,0,0,0,1
"cg08168175",0,0,1,0,1
"cg08169026",2,0,0,0,2
"cg08170119",15,19,9,0,43
"cg08171276",78,7,0,0,85
"cg08173660",28,18,0,0,46
"cg08174003",1,1,0,0,2
"cg08174320",0,0,1,0,1
"cg08175318",0,1,0,0,1
"cg08175546",68,71,11,0,150
"cg08177746",0,1,0,0,1
"cg08179155",0,0,9,0,9
"cg08179525",0,1,0,0,1
"cg08180553",38,40,4,0,82
"cg08180624",2,2,1,0,5
"cg08181324",0,1,0,0,1
"cg08181657",0,0,1,0,1
"cg08185061",0,0,16,0,16
"cg08185438",0,0,0,1,1
"cg08185695",6,0,0,0,6
"cg08186668",12,0,0,0,12
"cg08187458",0,0,1,0,1
"cg08187469",1,0,0,0,1
"cg08188593",0,0,1,0,1
"cg08189100",0,0,1,0,1
"cg08189391",0,1,0,0,1
"cg08189861",56,14,0,0,70
"cg08190125",0,0,1,0,1
"cg08190464",1,0,0,0,1
"cg08190552",1,0,0,0,1
"cg08191566",0,1,0,0,1
"cg08191781",0,1,0,0,1
"cg08192098",10,1,0,0,11
"cg08194339",0,0,3,0,3
"cg08194650",1,0,0,0,1
"cg08194752",4,0,0,0,4
"cg08194799",0,0,4,0,4
"cg08196128",0,0,3,0,3
"cg08197571",1,0,0,0,1
"cg08198040",1,0,0,0,1
"cg08198401",282,52,0,0,334
"cg08198609",0,6,5,0,11
"cg08198713",1,1,0,0,2
"cg08199235",1,0,0,0,1
"cg08199727",67,0,1,0,68
"cg08200252",1,1,3,0,5
"cg08200869",3,1,2,0,6
"cg08200936",0,0,1,0,1
"cg08201536",2,0,0,0,2
"cg08201625",0,0,3,0,3
"cg08202507",0,0,2,1,3
"cg08202682",0,0,1,0,1
"cg08202827",30,4,1,0,35
"cg08202978",1,0,0,0,1
"cg08204044",1,0,0,0,1
"cg08204861",17,0,0,0,17
"cg08207170",1,0,0,0,1
"cg08207536",0,1,0,0,1
"cg08208598",127,184,1,0,312
"cg08209614",2,0,0,0,2
"cg08210865",5,1,0,0,6
"cg08212477",4,0,0,0,4
"cg08212479",2,1,2,0,5
"cg08214898",323,7,0,0,330
"cg08215115",0,1,0,0,1
"cg08215453",47,2,1,0,50
"cg08215532",0,1,1,0,2
"cg08215876",194,53,2,0,249
"cg08216447",1,0,0,0,1
"cg08217411",0,1,2,0,3
"cg08218330",0,0,1,0,1
"cg08219091",358,64,0,0,422
"cg08219863",1,0,0,0,1
"cg08220596",3,10,4,0,17
"cg08222153",0,0,1,0,1
"cg08222555",364,244,24,0,632
"cg08222798",3,4,2,0,9
"cg08223835",891,672,28,0,1591
"cg08224217",0,0,1,0,1
"cg08224478",0,0,1,0,1
"cg08225398",1,0,0,0,1
"cg08226047",0,0,0,1,1
"cg08227541",1,0,0,0,1
"cg08227568",0,0,1,0,1
"cg08228077",8,0,0,0,8
"cg08228366",3,1,0,0,4
"cg08228804",1,0,0,0,1
"cg08229183",0,0,1,0,1
"cg08229502",0,0,1,0,1
"cg08229688",0,0,1,0,1
"cg08229801",1,2,1,0,4
"cg08230553",3,3,1,0,7
"cg08230698",1,0,0,0,1
"cg08230887",0,1,0,0,1
"cg08234415",0,1,0,0,1
"cg08234563",0,0,1,0,1
"cg08236018",10,1,0,0,11
"cg08236687",1,0,0,0,1
"cg08236766",0,2,0,0,2
"cg08236943",4,0,0,0,4
"cg08237400",196,613,5,0,814
"cg08238746",4,0,0,0,4
"cg08239841",1,0,0,0,1
"cg08240571",0,0,1,0,1
"cg08240978",0,0,1,0,1
"cg08241397",0,1,2,0,3
"cg08241916",0,3,0,0,3
"cg08242232",0,0,2,0,2
"cg08242338",0,2,8,0,10
"cg08243048",0,0,0,1,1
"cg08245127",1,1,0,0,2
"cg08245665",0,0,1,0,1
"cg08246496",0,0,1,0,1
"cg08247552",2,0,1,0,3
"cg08247583",0,0,2,0,2
"cg08248014",157,160,7,0,324
"cg08248445",151,16,0,0,167
"cg08248516",0,1,0,0,1
"cg08248611",2,0,0,0,2
"cg08248738",2,1,0,0,3
"cg08249592",0,0,1,0,1
"cg08250105",1,0,0,0,1
"cg08251160",2,0,0,0,2
"cg08251248",22,2,0,0,24
"cg08251427",2,1,1,1,5
"cg08251678",0,1,0,0,1
"cg08251943",2,1,0,0,3
"cg08252384",0,1,0,0,1
"cg08252966",0,1,1,0,2
"cg08253049",1,0,0,0,1
"cg08253402",2,2,0,0,4
"cg08254533",14,0,0,0,14
"cg08256065",3,7,0,0,10
"cg08256175",6,4,0,0,10
"cg08256557",1,0,0,0,1
"cg08257009",0,1,0,0,1
"cg08257212",0,1,0,0,1
"cg08257573",0,0,1,0,1
"cg08258224",0,1,0,0,1
"cg08258654",0,2,7,0,9
"cg08258922",0,0,1,0,1
"cg08262565",2,0,0,0,2
"cg08262582",1,0,0,0,1
"cg08262637",1,0,0,0,1
"cg08263589",1,0,0,0,1
"cg08263940",1,0,0,0,1
"cg08264118",0,0,1,0,1
"cg08267258",0,1,0,0,1
"cg08267300",0,1,4,1,6
"cg08267888",1,0,2,0,3
"cg08267988",0,1,0,0,1
"cg08268186",1,0,0,0,1
"cg08270434",0,1,1,0,2
"cg08270539",0,0,2,0,2
"cg08271622",0,1,0,0,1
"cg08271781",31,12,2,0,45
"cg08272429",3,0,0,0,3
"cg08273502",116,37,3,0,156
"cg08274761",0,0,2,0,2
"cg08274805",1,1,0,0,2
"cg08275025",0,1,0,0,1
"cg08275631",160,191,7,0,358
"cg08276333",0,0,1,0,1
"cg08276455",707,51,0,0,758
"cg08276538",0,0,0,7,7
"cg08276828",1,0,0,0,1
"cg08277233",9,1,0,0,10
"cg08277815",6,15,0,0,21
"cg08278078",2,0,0,0,2
"cg08278843",0,1,0,0,1
"cg08279546",4,1,0,0,5
"cg08280546",1,0,0,0,1
"cg08280861",1,0,0,0,1
"cg08281071",0,3,0,0,3
"cg08281469",0,1,0,0,1
"cg08281936",0,1,0,0,1
"cg08282195",0,1,0,0,1
"cg08282623",0,1,0,0,1
"cg08282812",0,0,2,0,2
"cg08283318",2,0,0,0,2
"cg08283777",252,10,1,0,263
"cg08284001",4,0,0,0,4
"cg08284151",0,1,1,0,2
"cg08284447",4,1,0,0,5
"cg08284489",1,0,0,0,1
"cg08284758",1,0,0,0,1
"cg08285319",0,2,0,0,2
"cg08285415",0,0,4,0,4
"cg08285429",2,8,1,0,11
"cg08285663",0,0,1,0,1
"cg08285730",0,1,1,2,4
"cg08286003",1,0,0,0,1
"cg08287248",3,10,5,0,18
"cg08287737",0,0,2,0,2
"cg08288237",0,1,0,0,1
"cg08288314",0,0,1,0,1
"cg08288694",0,0,9,0,9
"cg08289176",2,0,0,0,2
"cg08290728",1,0,0,0,1
"cg08291425",0,0,1,0,1
"cg08292569",0,1,0,0,1
"cg08292877",0,0,2,0,2
"cg08293303",0,1,0,0,1
"cg08293468",1,0,0,0,1
"cg08294038",0,0,1,0,1
"cg08294536",0,0,2,0,2
"cg08296390",0,1,0,0,1
"cg08296499",0,0,0,1,1
"cg08296730",0,0,1,0,1
"cg08297137",1,1,0,0,2
"cg08300985",0,0,1,0,1
"cg08300990",0,2,1,0,3
"cg08301036",0,0,1,0,1
"cg08302468",22,0,0,0,22
"cg08304101",1,1,0,0,2
"cg08304249",1,0,0,0,1
"cg08306365",7,0,0,0,7
"cg08306589",0,1,0,0,1
"cg08306696",3,0,0,0,3
"cg08307350",1,0,0,0,1
"cg08307753",0,1,0,0,1
"cg08307867",0,1,0,0,1
"cg08308693",0,0,1,0,1
"cg08309609",142,6,2,0,150
"cg08310364",48,0,0,0,48
"cg08310439",1,1,0,0,2
"cg08313242",3,1,3,0,7
"cg08315130",313,52,10,0,375
"cg08315272",27,1,0,0,28
"cg08317105",0,0,1,0,1
"cg08317295",1,0,0,0,1
"cg08317730",0,1,1,0,2
"cg08317801",0,3,0,0,3
"cg08318353",3,0,0,0,3
"cg08318424",43,53,11,0,107
"cg08318714",0,0,2,0,2
"cg08318882",0,0,1,0,1
"cg08319492",7,0,0,0,7
"cg08319936",1,14,5,0,20
"cg08320982",0,0,1,0,1
"cg08321330",0,1,1,0,2
"cg08322013",0,0,1,0,1
"cg08322149",0,0,1,0,1
"cg08323201",0,0,2,0,2
"cg08323227",1,0,0,0,1
"cg08324383",0,1,0,0,1
"cg08324852",1,0,0,0,1
"cg08324962",0,0,1,0,1
"cg08325307",8,2,1,0,11
"cg08326209",2,0,0,0,2
"cg08326765",0,0,1,0,1
"cg08328153",4,0,0,0,4
"cg08328842",0,1,0,0,1
"cg08328906",0,0,1,0,1
"cg08329070",1,0,0,0,1
"cg08329075",3,0,8,0,11
"cg08329295",0,1,0,0,1
"cg08329443",40,6,0,0,46
"cg08330011",0,1,0,0,1
"cg08330080",0,0,1,0,1
"cg08330547",2,0,0,0,2
"cg08332992",5,0,0,0,5
"cg08333243",0,1,2,0,3
"cg08333333",1,0,0,0,1
"cg08333382",0,0,1,0,1
"cg08333627",22,0,0,0,22
"cg08333839",0,0,0,1,1
"cg08334076",1,1,0,0,2
"cg08334154",0,5,3,0,8
"cg08334278",0,1,0,1,2
"cg08334329",0,3,1,0,4
"cg08335662",0,2,0,0,2
"cg08335892",137,19,0,0,156
"cg08336041",0,0,1,0,1
"cg08336139",0,2,1,0,3
"cg08336687",0,0,1,0,1
"cg08336733",0,5,5,0,10
"cg08337923",12,0,0,0,12
"cg08338237",80,271,286,0,637
"cg08338323",0,0,1,0,1
"cg08339105",0,0,0,1,1
"cg08339324",379,34,0,0,413
"cg08339762",3,5,0,0,8
"cg08340798",1,0,0,0,1
"cg08342134",0,0,2,0,2
"cg08342560",0,0,1,0,1
"cg08343142",4,0,0,0,4
"cg08343786",1,0,0,0,1
"cg08344174",0,1,0,0,1
"cg08346443",2,0,0,0,2
"cg08346453",2,1,0,0,3
"cg08346719",1,0,0,0,1
"cg08347442",144,566,20,0,730
"cg08347582",1,0,0,0,1
"cg08348387",17,1,0,0,18
"cg08348949",1,7,7,0,15
"cg08350960",26,86,0,0,112
"cg08351017",0,1,0,0,1
"cg08353090",3,2,1,0,6
"cg08353172",0,2,0,0,2
"cg08354320",4,1,0,0,5
"cg08354445",1,0,0,0,1
"cg08355345",5,4,0,0,9
"cg08355864",15,11,0,0,26
"cg08356097",3,2,1,0,6
"cg08356248",136,299,102,0,537
"cg08356522",0,1,0,0,1
"cg08356705",0,0,1,0,1
"cg08357055",361,13,0,0,374
"cg08357177",1,0,0,0,1
"cg08357313",5,6,1,0,12
"cg08359870",3,0,0,0,3
"cg08360297",1,0,0,0,1
"cg08362589",0,0,1,0,1
"cg08364584",0,0,1,0,1
"cg08365181",28,21,7,0,56
"cg08365331",1,0,0,0,1
"cg08365438",1,0,0,0,1
"cg08365685",3,5,0,0,8
"cg08365989",0,0,1,0,1
"cg08366912",1,0,0,0,1
"cg08368182",0,0,1,0,1
"cg08368330",0,0,2,0,2
"cg08368496",11,3,0,0,14
"cg08369061",0,2,0,0,2
"cg08369576",0,0,2,0,2
"cg08370325",2,2,2,0,6
"cg08370718",0,1,0,0,1
"cg08371064",0,1,3,0,4
"cg08371086",41,39,2,0,82
"cg08372051",0,0,1,0,1
"cg08372869",0,0,1,0,1
"cg08374391",0,0,1,0,1
"cg08374741",1063,304,5,0,1372
"cg08377426",1,0,0,0,1
"cg08377615",381,13,2,0,396
"cg08377758",9,3,0,0,12
"cg08377862",37,9,2,0,48
"cg08379019",0,0,1,0,1
"cg08380227",0,0,1,0,1
"cg08380262",0,0,2,0,2
"cg08381437",0,0,5,0,5
"cg08381868",0,0,1,0,1
"cg08382147",0,1,0,0,1
"cg08382918",3,1,0,0,4
"cg08382946",0,0,3,0,3
"cg08383902",1,0,0,0,1
"cg08384020",1,0,0,0,1
"cg08384658",12,2,0,0,14
"cg08387805",0,1,0,0,1
"cg08388232",0,0,1,0,1
"cg08389347",0,2,7,0,9
"cg08390994",1,0,0,0,1
"cg08391356",1,0,0,0,1
"cg08392051",51,9,0,0,60
"cg08392142",0,1,1,0,2
"cg08393087",0,1,0,0,1
"cg08393183",1,0,0,0,1
"cg08394510",544,22,0,0,566
"cg08394597",97,8,0,0,105
"cg08394602",1,0,0,0,1
"cg08395009",1,3,1,0,5
"cg08395459",0,0,1,0,1
"cg08395966",0,0,1,0,1
"cg08396017",17,0,0,0,17
"cg08396034",0,1,0,0,1
"cg08396387",1,1,0,0,2
"cg08396483",0,1,0,0,1
"cg08397437",27,6,0,0,33
"cg08397879",3,0,0,0,3
"cg08397951",0,0,1,0,1
"cg08398034",6,3,0,0,9
"cg08398498",2,3,5,0,10
"cg08399178",0,0,0,1,1
"cg08400246",4,0,0,0,4
"cg08400316",0,0,1,0,1
"cg08401859",2,0,0,0,2
"cg08403041",0,0,1,0,1
"cg08403691",36,9,3,0,48
"cg08404057",0,1,0,0,1
"cg08404318",1,0,0,0,1
"cg08405073",0,0,1,0,1
"cg08406892",0,0,1,0,1
"cg08407065",5,7,2,0,14
"cg08408212",0,0,1,0,1
"cg08408543",4,4,2,0,10
"cg08408938",8,1,0,0,9
"cg08409165",0,0,1,0,1
"cg08409563",1,0,0,0,1
"cg08409566",1,0,0,0,1
"cg08410052",0,1,0,0,1
"cg08410326",0,0,1,0,1
"cg08411512",1,0,0,0,1
"cg08411833",2,22,48,0,72
"cg08412485",0,2,0,0,2
"cg08413390",0,0,12,0,12
"cg08414231",1,0,0,0,1
"cg08415053",1,0,0,0,1
"cg08416054",1,0,0,0,1
"cg08416191",243,203,12,0,458
"cg08416313",7,1,0,0,8
"cg08416870",1,0,0,0,1
"cg08418747",0,0,2,0,2
"cg08419523",4,4,1,0,9
"cg08419657",1,1,0,0,2
"cg08420056",31,1,0,0,32
"cg08420353",14,1,0,0,15
"cg08420370",2,0,0,0,2
"cg08420672",0,0,1,0,1
"cg08421550",1,0,0,0,1
"cg08421900",0,0,1,0,1
"cg08422471",0,0,0,1,1
"cg08422668",7,1,0,0,8
"cg08424213",3,0,0,0,3
"cg08425402",1,3,3,0,7
"cg08426980",0,0,1,0,1
"cg08428949",8,0,0,0,8
"cg08429943",0,0,3,0,3
"cg08430598",0,0,1,0,1
"cg08431566",1,0,0,0,1
"cg08431860",0,0,6,0,6
"cg08432147",0,0,3,0,3
"cg08432583",0,1,0,0,1
"cg08432712",13,2,0,0,15
"cg08432992",1,1,1,0,3
"cg08434171",1,0,0,0,1
"cg08434295",0,1,0,0,1
"cg08434350",6,0,0,0,6
"cg08434747",1,0,0,0,1
"cg08436684",1,2,2,0,5
"cg08437461",1,0,0,0,1
"cg08437957",0,2,5,0,7
"cg08438164",177,14,0,0,191
"cg08438268",275,227,36,0,538
"cg08438385",26,8,4,0,38
"cg08439448",85,5,0,0,90
"cg08439881",4,0,0,0,4
"cg08439987",0,0,1,0,1
"cg08440544",0,1,1,0,2
"cg08441918",2,1,1,0,4
"cg08442922",1,0,0,0,1
"cg08443124",1,0,0,0,1
"cg08443492",0,0,1,0,1
"cg08444457",1,1,0,0,2
"cg08445093",21,2,0,0,23
"cg08445469",31,1,0,0,32
"cg08446682",5,1,0,0,6
"cg08447733",0,1,0,0,1
"cg08448812",1,5,1,0,7
"cg08449090",2,2,0,0,4
"cg08449361",1,0,0,0,1
"cg08449389",0,0,3,0,3
"cg08449855",3,0,0,0,3
"cg08449975",18,3,0,0,21
"cg08450058",1,1,1,0,3
"cg08450091",1,0,0,0,1
"cg08450572",0,0,1,0,1
"cg08451113",2,0,0,0,2
"cg08451591",4,2,0,0,6
"cg08451993",3,1,0,0,4
"cg08452671",0,0,1,0,1
"cg08452787",0,1,0,0,1
"cg08454110",114,230,159,0,503
"cg08454334",0,1,0,0,1
"cg08454918",215,142,16,0,373
"cg08455021",2,3,5,0,10
"cg08455548",0,0,1,0,1
"cg08456597",0,0,2,0,2
"cg08457790",0,1,1,0,2
"cg08458349",2,0,0,0,2
"cg08458378",1,0,0,0,1
"cg08458655",31,447,30,0,508
"cg08459182",39,1,0,0,40
"cg08459677",0,0,1,0,1
"cg08460022",0,0,1,0,1
"cg08460439",4,0,0,0,4
"cg08460629",1,0,0,0,1
"cg08461457",0,0,1,0,1
"cg08461781",0,0,2,0,2
"cg08461853",0,0,1,0,1
"cg08462017",0,1,0,0,1
"cg08463813",0,1,9,0,10
"cg08464140",1,0,0,0,1
"cg08464541",1,0,0,0,1
"cg08464734",0,1,2,0,3
"cg08464855",110,6,0,0,116
"cg08464900",3,0,0,0,3
"cg08466138",0,1,4,0,5
"cg08466385",0,2,1,0,3
"cg08467286",0,0,1,0,1
"cg08467737",5,1,0,0,6
"cg08469346",0,0,2,0,2
"cg08469632",0,1,0,0,1
"cg08469640",0,0,1,0,1
"cg08469752",1,0,0,0,1
"cg08470827",1,0,0,0,1
"cg08471420",0,0,1,0,1
"cg08471734",1,0,0,0,1
"cg08472049",1,0,0,0,1
"cg08472559",0,2,0,0,2
"cg08472583",0,0,1,0,1
"cg08472753",9,1,0,0,10
"cg08473226",11,15,1,0,27
"cg08474403",1,0,0,0,1
"cg08475244",0,0,1,0,1
"cg08475518",0,0,1,0,1
"cg08475721",45,35,10,0,90
"cg08476390",1,0,2,0,3
"cg08476832",1,0,0,0,1
"cg08477215",0,1,1,0,2
"cg08477687",0,0,1,0,1
"cg08478046",0,1,0,0,1
"cg08478462",0,0,6,0,6
"cg08479459",1,0,0,0,1
"cg08480493",0,2,0,0,2
"cg08480926",136,44,0,0,180
"cg08481162",0,0,2,0,2
"cg08483173",10,1,0,0,11
"cg08483316",78,192,176,0,446
"cg08483687",1,0,0,0,1
"cg08484972",0,0,1,0,1
"cg08488494",6,4,3,0,13
"cg08488615",0,1,0,0,1
"cg08489228",10,0,0,0,10
"cg08489324",0,0,1,0,1
"cg08489682",5,0,0,0,5
"cg08490030",3,0,0,0,3
"cg08490246",1,0,0,0,1
"cg08490356",2,1,1,0,4
"cg08490589",0,2,1,0,3
"cg08491069",0,1,0,0,1
"cg08491188",0,0,1,0,1
"cg08491641",0,1,0,0,1
"cg08491685",8,3,3,0,14
"cg08492178",2,0,2,0,4
"cg08493360",1,0,0,0,1
"cg08494150",3,4,1,0,8
"cg08494377",1,0,0,0,1
"cg08494644",2,2,0,0,4
"cg08497953",1,1,0,0,2
"cg08498719",0,0,3,0,3
"cg08500685",1,0,0,0,1
"cg08501005",1,0,0,0,1
"cg08501265",0,1,0,0,1
"cg08501735",1,0,0,0,1
"cg08501840",0,1,0,0,1
"cg08504279",1,0,0,0,1
"cg08504577",258,15,2,0,275
"cg08505673",2,0,0,0,2
"cg08505791",4,0,1,0,5
"cg08506004",0,0,4,0,4
"cg08506303",76,64,6,0,146
"cg08506369",1,0,1,0,2
"cg08506401",618,52,0,0,670
"cg08507638",1,0,0,0,1
"cg08508576",0,1,0,0,1
"cg08508777",0,2,1,0,3
"cg08508887",39,16,2,0,57
"cg08509032",18,16,2,0,36
"cg08511331",1,1,1,0,3
"cg08512142",0,0,1,0,1
"cg08512456",0,0,1,0,1
"cg08513364",1,0,0,0,1
"cg08515401",1,0,0,0,1
"cg08516030",0,0,1,0,1
"cg08516112",0,0,2,0,2
"cg08518507",0,0,1,0,1
"cg08518892",0,0,1,0,1
"cg08519216",0,0,1,0,1
"cg08519553",0,1,0,0,1
"cg08519616",0,0,1,0,1
"cg08519764",0,1,1,0,2
"cg08519797",1,0,0,0,1
"cg08519949",1,1,0,0,2
"cg08520349",0,1,0,0,1
"cg08522655",0,0,1,0,1
"cg08522831",1,0,0,0,1
"cg08523325",309,70,2,0,381
"cg08523444",0,1,0,0,1
"cg08525345",11,18,0,0,29
"cg08525476",1399,294,3,0,1696
"cg08526140",21,7,1,0,29
"cg08527172",0,0,1,0,1
"cg08527618",5,0,0,0,5
"cg08528204",23,4,0,0,27
"cg08528213",0,1,0,0,1
"cg08529062",2,1,0,0,3
"cg08529748",28,18,2,0,48
"cg08529987",0,1,0,0,1
"cg08530824",62,0,0,0,62
"cg08531263",1,0,0,0,1
"cg08531365",0,1,1,0,2
"cg08531998",0,0,1,0,1
"cg08533036",47,91,45,0,183
"cg08534331",0,1,0,0,1
"cg08534465",0,1,4,0,5
"cg08536402",1,0,0,0,1
"cg08537563",1,0,0,0,1
"cg08538186",0,8,1,0,9
"cg08539065",1,0,0,0,1
"cg08539375",5,0,0,0,5
"cg08539758",1,0,0,0,1
"cg08539962",13,1,0,0,14
"cg08540307",0,3,0,0,3
"cg08541345",1,1,0,0,2
"cg08541920",0,1,0,0,1
"cg08542640",0,0,1,0,1
"cg08543695",5,1,0,0,6
"cg08546158",0,0,2,0,2
"cg08546300",63,84,4,0,151
"cg08546805",0,0,2,0,2
"cg08547211",31,1,0,0,32
"cg08547427",52,67,4,0,123
"cg08547534",26,2,0,0,28
"cg08547873",104,3,0,0,107
"cg08548044",1,0,0,0,1
"cg08548718",2,2,0,0,4
"cg08548783",0,1,0,0,1
"cg08548871",0,1,0,0,1
"cg08549075",0,0,1,0,1
"cg08549661",0,1,1,0,2
"cg08550084",3,3,0,0,6
"cg08550094",0,2,1,0,3
"cg08550314",21,4,1,0,26
"cg08550333",2,1,0,0,3
"cg08550882",678,73,0,0,751
"cg08551078",0,0,5,0,5
"cg08551188",1,0,0,0,1
"cg08551497",2,1,0,0,3
"cg08551633",0,5,4,0,9
"cg08551868",2,0,0,0,2
"cg08552065",0,1,0,0,1
"cg08552121",0,1,0,0,1
"cg08552635",2,1,0,0,3
"cg08553429",77,16,0,0,93
"cg08555389",0,1,0,0,1
"cg08555657",0,2,0,0,2
"cg08556213",20,7,0,0,27
"cg08556525",4,0,0,0,4
"cg08558058",0,0,1,0,1
"cg08558878",1,0,0,0,1
"cg08558974",6,3,18,0,27
"cg08560150",217,167,9,0,393
"cg08560164",9,0,0,0,9
"cg08561071",0,1,0,0,1
"cg08561667",0,1,1,0,2
"cg08563062",472,12,1,0,485
"cg08563677",0,1,0,0,1
"cg08563847",0,0,1,0,1
"cg08566488",0,0,1,0,1
"cg08566640",0,0,1,0,1
"cg08567947",1,0,2,0,3
"cg08568561",0,0,1,0,1
"cg08571287",0,0,3,0,3
"cg08573318",0,1,0,0,1
"cg08573535",0,0,3,1,4
"cg08573907",3,3,0,0,6
"cg08574140",1,0,0,0,1
"cg08574479",0,0,2,1,3
"cg08574564",0,0,1,0,1
"cg08574632",0,3,0,0,3
"cg08575682",14,1,0,0,15
"cg08576095",8,0,0,0,8
"cg08576845",39,9,2,0,50
"cg08577213",1,0,0,0,1
"cg08577509",12,6,1,0,19
"cg08577517",434,36,1,0,471
"cg08577693",1131,226,0,0,1357
"cg08577904",1,0,1,0,2
"cg08578395",0,0,2,0,2
"cg08580224",1,0,0,0,1
"cg08581275",0,0,1,0,1
"cg08581359",1,1,12,0,14
"cg08581953",2,1,0,0,3
"cg08582546",1,0,0,0,1
"cg08582729",144,6,0,0,150
"cg08582773",2,0,2,0,4
"cg08583411",1,0,0,0,1
"cg08583895",1,8,1,0,10
"cg08584230",2,6,1,0,9
"cg08585897",1,0,0,0,1
"cg08585975",0,2,0,0,2
"cg08588744",1,0,0,0,1
"cg08589864",0,0,1,0,1
"cg08591048",0,0,1,0,1
"cg08591299",73,5,0,0,78
"cg08591671",1,2,3,0,6
"cg08591859",0,1,0,0,1
"cg08593037",2,1,0,0,3
"cg08593252",1,0,0,0,1
"cg08594032",0,0,1,0,1
"cg08594632",32,2,0,0,34
"cg08597025",0,5,0,2,7
"cg08597142",1,0,0,0,1
"cg08597393",0,1,1,0,2
"cg08597797",0,1,0,0,1
"cg08598108",23,18,6,0,47
"cg08598406",1,0,0,0,1
"cg08598483",1,0,0,0,1
"cg08598602",0,0,1,0,1
"cg08598966",0,1,0,0,1
"cg08599229",2,0,3,0,5
"cg08599330",1,0,0,0,1
"cg08600213",4,0,0,0,4
"cg08600458",1,2,2,0,5
"cg08600509",0,0,1,0,1
"cg08600765",0,1,0,0,1
"cg08604085",2,1,0,0,3
"cg08604957",0,1,0,0,1
"cg08605442",27,8,2,0,37
"cg08606818",3,0,0,0,3
"cg08607209",1,0,0,0,1
"cg08607875",0,1,1,0,2
"cg08608016",0,0,1,0,1
"cg08608094",0,0,1,0,1
"cg08608144",0,1,0,0,1
"cg08609896",1,0,0,0,1
"cg08610164",0,0,1,0,1
"cg08610228",1,0,0,0,1
"cg08610886",0,0,2,0,2
"cg08611431",1,2,0,0,3
"cg08612177",1,0,0,0,1
"cg08613507",4,0,0,0,4
"cg08613577",1,0,0,0,1
"cg08614917",0,0,1,0,1
"cg08615458",209,11,0,0,220
"cg08615552",0,1,0,0,1
"cg08615635",0,0,1,0,1
"cg08615887",59,5,1,0,65
"cg08616431",0,0,1,0,1
"cg08616516",0,1,0,0,1
"cg08616853",0,1,0,0,1
"cg08617020",0,1,0,0,1
"cg08617415",0,1,2,0,3
"cg08617645",0,0,1,0,1
"cg08619954",0,1,0,0,1
"cg08620112",131,23,0,0,154
"cg08620245",0,2,0,0,2
"cg08620479",0,0,2,0,2
"cg08620558",1,0,0,0,1
"cg08621454",0,0,17,0,17
"cg08622563",0,0,0,1,1
"cg08623941",212,212,31,0,455
"cg08624705",5,0,0,0,5
"cg08626125",3,0,5,0,8
"cg08626543",0,1,4,0,5
"cg08626637",1098,558,7,0,1663
"cg08627051",2,0,0,0,2
"cg08627594",4,0,0,0,4
"cg08627608",0,0,0,1,1
"cg08627942",0,1,0,0,1
"cg08628006",3,0,0,0,3
"cg08630971",1,2,1,0,4
"cg08633056",0,0,1,0,1
"cg08633200",0,1,0,0,1
"cg08633453",2,0,0,0,2
"cg08634157",0,0,1,0,1
"cg08634826",1,0,0,0,1
"cg08634937",4,0,0,0,4
"cg08636083",0,0,2,0,2
"cg08637257",3,0,2,0,5
"cg08637714",0,0,1,0,1
"cg08637965",0,1,0,0,1
"cg08638287",5,4,2,0,11
"cg08638481",4,0,1,0,5
"cg08638999",68,5,0,0,73
"cg08639839",40,19,1,0,60
"cg08641618",0,0,1,0,1
"cg08643531",0,0,0,1,1
"cg08643930",1,3,1,1,6
"cg08643950",4,0,0,0,4
"cg08643997",0,5,14,0,19
"cg08644058",0,1,0,0,1
"cg08644267",1,0,0,0,1
"cg08644341",1,1,0,0,2
"cg08645579",0,3,1,0,4
"cg08645878",6,0,0,0,6
"cg08646442",0,0,1,0,1
"cg08646667",0,0,5,0,5
"cg08647652",0,1,1,0,2
"cg08648136",0,1,0,0,1
"cg08648727",1,0,0,0,1
"cg08648997",0,0,1,0,1
"cg08650676",1,0,0,0,1
"cg08651039",0,0,2,0,2
"cg08652957",1,0,0,0,1
"cg08653580",3,1,0,0,4
"cg08653918",1,3,0,0,4
"cg08654002",1,0,0,0,1
"cg08654153",1,0,0,0,1
"cg08655480",591,50,4,0,645
"cg08655904",0,1,0,0,1
"cg08656053",0,0,1,0,1
"cg08656064",135,10,0,0,145
"cg08656326",0,1,0,0,1
"cg08656852",0,1,0,0,1
"cg08658981",1,0,1,0,2
"cg08659203",8,1,0,0,9
"cg08659785",62,5,0,0,67
"cg08660064",1,0,0,0,1
"cg08660955",0,1,0,0,1
"cg08661270",0,0,1,0,1
"cg08661591",2,0,0,0,2
"cg08662532",0,1,0,0,1
"cg08663007",0,3,0,1,4
"cg08663008",1,2,0,0,3
"cg08663109",0,1,6,0,7
"cg08663552",0,0,2,0,2
"cg08663953",0,0,1,0,1
"cg08664956",0,1,2,0,3
"cg08667379",0,1,0,0,1
"cg08667899",0,0,2,0,2
"cg08669370",4,0,0,0,4
"cg08671425",1,1,8,0,10
"cg08673142",265,34,0,0,299
"cg08674321",0,2,0,0,2
"cg08674669",14,3,0,0,17
"cg08676001",15,1,0,0,16
"cg08676755",0,1,2,0,3
"cg08677558",0,1,0,0,1
"cg08677715",0,0,3,0,3
"cg08678397",0,0,1,0,1
"cg08678755",1,0,0,0,1
"cg08679502",1,2,0,0,3
"cg08680260",0,0,2,0,2
"cg08680728",0,0,1,0,1
"cg08680991",0,1,7,0,8
"cg08681307",0,0,1,0,1
"cg08681966",0,1,0,0,1
"cg08683088",1,0,0,0,1
"cg08683297",2,2,0,0,4
"cg08684477",0,0,1,0,1
"cg08684904",0,0,1,0,1
"cg08685444",1,1,2,0,4
"cg08686293",2,1,1,0,4
"cg08687251",23,0,0,0,23
"cg08687283",1,0,0,0,1
"cg08687643",1,0,0,0,1
"cg08687731",6,0,0,0,6
"cg08687901",2,2,2,0,6
"cg08688798",0,1,0,0,1
"cg08689158",0,0,1,0,1
"cg08689882",0,0,2,0,2
"cg08693067",1,0,0,0,1
"cg08694149",1,4,3,0,8
"cg08694556",3,0,0,0,3
"cg08694585",4,2,0,0,6
"cg08694858",171,273,12,0,456
"cg08695411",0,0,2,0,2
"cg08695887",1,2,0,0,3
"cg08696836",0,0,1,0,1
"cg08698105",0,1,0,0,1
"cg08699568",0,2,0,0,2
"cg08699977",13,3,0,0,16
"cg08702612",4,0,0,0,4
"cg08702825",1,0,0,0,1
"cg08703289",13,1,0,0,14
"cg08704250",1,0,0,0,1
"cg08705895",6,1,3,0,10
"cg08707025",0,0,1,0,1
"cg08707456",0,0,1,0,1
"cg08707555",0,1,0,0,1
"cg08708193",1,2,0,0,3
"cg08708735",0,1,0,0,1
"cg08709013",1,0,0,0,1
"cg08709039",3,0,0,0,3
"cg08709385",0,6,1,0,7
"cg08709680",25,1,1,0,27
"cg08710629",1,1,0,0,2
"cg08710987",0,0,1,0,1
"cg08711604",1,1,0,0,2
"cg08711796",0,0,2,0,2
"cg08712285",21,2,0,0,23
"cg08713126",0,2,0,0,2
"cg08713543",0,1,0,0,1
"cg08714433",16,9,1,0,26
"cg08714440",1,7,5,0,13
"cg08715207",0,1,0,0,1
"cg08715276",0,1,0,0,1
"cg08715549",0,2,13,0,15
"cg08716211",1,4,4,0,9
"cg08716553",29,1,0,0,30
"cg08717396",1,0,0,0,1
"cg08717896",0,1,0,0,1
"cg08718119",0,0,1,0,1
"cg08720786",0,2,4,0,6
"cg08721746",2,0,0,0,2
"cg08721908",4,1,0,0,5
"cg08722065",0,0,1,0,1
"cg08722115",0,1,0,0,1
"cg08722616",2,1,0,0,3
"cg08723103",0,2,1,0,3
"cg08723637",2,0,0,0,2
"cg08724510",0,1,0,0,1
"cg08724753",6,1,0,0,7
"cg08726145",3,2,4,0,9
"cg08727303",0,0,1,0,1
"cg08727433",57,110,39,0,206
"cg08728514",3,0,0,0,3
"cg08728848",0,1,0,0,1
"cg08728856",0,0,2,0,2
"cg08729004",2,0,0,0,2
"cg08729434",2,0,1,0,3
"cg08729730",9,5,0,0,14
"cg08729779",1,4,4,0,9
"cg08730694",414,34,1,0,449
"cg08730871",8,5,0,0,13
"cg08731917",0,1,0,0,1
"cg08732139",1,2,0,0,3
"cg08732375",0,0,0,1,1
"cg08733482",1,0,0,0,1
"cg08734711",2,1,0,0,3
"cg08735208",1,0,0,0,1
"cg08735636",0,0,2,0,2
"cg08736522",0,0,1,0,1
"cg08736544",0,0,1,0,1
"cg08738770",0,0,1,0,1
"cg08738784",1,0,0,0,1
"cg08739110",1,0,0,0,1
"cg08739281",0,0,1,0,1
"cg08739478",1,5,7,0,13
"cg08739628",6,9,4,0,19
"cg08739648",3,0,0,0,3
"cg08740010",0,5,0,0,5
"cg08740894",0,0,1,0,1
"cg08741921",1,1,4,0,6
"cg08742041",408,244,25,0,677
"cg08742106",0,0,8,0,8
"cg08742360",6,0,0,0,6
"cg08742408",24,2,0,0,26
"cg08742585",3,1,0,0,4
"cg08743024",3,1,0,0,4
"cg08744654",13,0,0,0,13
"cg08745199",1,0,0,0,1
"cg08745461",1,1,0,0,2
"cg08747369",0,1,0,0,1
"cg08748210",26,617,24,0,667
"cg08748794",9,24,1,0,34
"cg08749095",3,0,0,0,3
"cg08751734",0,2,0,0,2
"cg08752431",26,16,1,0,43
"cg08754095",0,0,10,0,10
"cg08755139",3,0,0,0,3
"cg08755283",0,1,0,0,1
"cg08755307",1,0,0,0,1
"cg08755509",62,266,187,0,515
"cg08755601",74,26,0,0,100
"cg08756272",2,0,0,0,2
"cg08757270",821,77,0,0,898
"cg08757434",0,0,1,0,1
"cg08758529",0,0,1,0,1
"cg08759186",2,16,2,0,20
"cg08759274",1,0,0,0,1
"cg08760211",1,0,0,0,1
"cg08761155",1,0,0,0,1
"cg08761334",0,0,1,0,1
"cg08761443",1,0,0,0,1
"cg08762306",0,0,1,0,1
"cg08763584",1,0,0,0,1
"cg08764265",0,2,1,0,3
"cg08765193",23,1,0,0,24
"cg08766627",11,0,0,0,11
"cg08766645",2,0,0,0,2
"cg08767715",4,0,0,0,4
"cg08767884",0,1,0,0,1
"cg08767895",2,1,0,0,3
"cg08769816",7,3,0,0,10
"cg08773640",7,12,3,0,22
"cg08773876",113,59,3,0,175
"cg08773882",0,1,0,0,1
"cg08775793",1,0,0,0,1
"cg08778598",0,0,1,0,1
"cg08778881",1,0,0,0,1
"cg08779129",1,0,2,0,3
"cg08779953",0,1,0,0,1
"cg08780220",1,1,3,0,5
"cg08780318",13,2,0,0,15
"cg08780658",0,1,0,0,1
"cg08780974",11,1,0,0,12
"cg08781081",2,0,1,0,3
"cg08782122",2,3,6,0,11
"cg08782158",0,2,0,0,2
"cg08782688",0,0,2,0,2
"cg08783023",3,4,2,0,9
"cg08783143",250,29,4,0,283
"cg08783558",0,0,1,0,1
"cg08783934",25,0,0,0,25
"cg08786213",702,121,2,0,825
"cg08787622",0,1,0,0,1
"cg08787802",617,105,2,0,724
"cg08787964",1,1,0,0,2
"cg08789741",234,25,0,0,259
"cg08790114",0,10,0,0,10
"cg08790485",0,1,0,0,1
"cg08792584",1,0,0,0,1
"cg08792724",0,4,0,0,4
"cg08793549",0,1,0,0,1
"cg08793924",2,0,0,0,2
"cg08794265",0,0,1,0,1
"cg08795320",0,1,0,0,1
"cg08795713",0,1,1,0,2
"cg08795994",32,19,0,0,51
"cg08796174",0,0,1,0,1
"cg08796647",118,446,18,0,582
"cg08797106",4,4,1,0,9
"cg08797305",2,0,0,0,2
"cg08797793",0,0,1,0,1
"cg08798349",8,2,0,0,10
"cg08798705",412,131,5,0,548
"cg08799632",0,0,1,0,1
"cg08800250",138,6,0,0,144
"cg08801436",0,0,1,0,1
"cg08802097",0,0,3,0,3
"cg08802513",1,1,0,0,2
"cg08802930",4,0,0,0,4
"cg08803663",6,0,1,0,7
"cg08803783",216,16,1,0,233
"cg08803790",12,6,1,0,19
"cg08804250",0,0,1,0,1
"cg08804555",359,249,4,0,612
"cg08805586",2,1,1,0,4
"cg08806109",0,1,0,0,1
"cg08806717",0,0,22,0,22
"cg08807341",0,3,2,0,5
"cg08808258",0,4,0,0,4
"cg08808788",0,1,0,0,1
"cg08808791",0,0,1,0,1
"cg08809635",1,0,0,0,1
"cg08810106",0,1,3,0,4
"cg08811681",0,1,1,0,2
"cg08811817",5,2,0,0,7
"cg08811988",0,0,1,0,1
"cg08813180",286,13,0,0,299
"cg08813464",6,4,0,0,10
"cg08813510",220,18,0,0,238
"cg08814736",1,1,2,0,4
"cg08815672",1,1,0,0,2
"cg08816098",2,0,0,0,2
"cg08816455",24,5,0,0,29
"cg08816824",0,1,1,0,2
"cg08817168",0,0,1,1,2
"cg08817424",2,1,0,0,3
"cg08817483",5,0,0,0,5
"cg08817545",5,0,0,0,5
"cg08818009",4,15,8,0,27
"cg08818385",1,1,0,0,2
"cg08819006",0,0,2,0,2
"cg08819601",0,1,0,0,1
"cg08820568",0,0,0,1,1
"cg08821669",0,1,0,0,1
"cg08822578",1,0,0,0,1
"cg08822679",2,0,0,0,2
"cg08822688",6,4,0,0,10
"cg08822798",0,1,0,0,1
"cg08824169",2,1,1,0,4
"cg08824711",9,0,0,0,9
"cg08825291",0,0,2,0,2
"cg08826095",62,12,0,0,74
"cg08826617",0,0,1,0,1
"cg08827024",0,0,1,0,1
"cg08827274",2,0,0,0,2
"cg08827578",6,0,0,0,6
"cg08829137",1,1,0,0,2
"cg08831381",57,87,4,0,148
"cg08831455",0,1,0,0,1
"cg08832266",0,0,1,0,1
"cg08832842",3,0,1,1,5
"cg08833952",2,2,2,0,6
"cg08834050",1,0,0,0,1
"cg08834459",74,6,0,0,80
"cg08834691",3,0,0,0,3
"cg08834712",1,0,1,0,2
"cg08835686",1,0,0,0,1
"cg08837676",66,12,0,0,78
"cg08838942",2,0,0,0,2
"cg08839534",1,0,0,0,1
"cg08839697",0,0,0,1,1
"cg08840847",0,0,2,0,2
"cg08841159",0,0,1,0,1
"cg08841342",0,2,2,0,4
"cg08842495",1,0,0,0,1
"cg08843769",0,0,1,0,1
"cg08844767",0,0,1,0,1
"cg08844929",0,1,0,0,1
"cg08845336",0,1,0,0,1
"cg08846880",0,1,0,0,1
"cg08847636",1,0,0,0,1
"cg08847773",1,0,1,0,2
"cg08848343",1,0,0,0,1
"cg08849354",0,1,0,0,1
"cg08850310",2,0,0,0,2
"cg08851289",0,0,2,2,4
"cg08851784",0,0,1,0,1
"cg08851851",6,4,6,0,16
"cg08853658",0,1,0,0,1
"cg08854987",1,0,1,0,2
"cg08855301",1,0,0,0,1
"cg08855386",2,1,0,0,3
"cg08855953",61,9,0,0,70
"cg08856378",4,3,0,0,7
"cg08856764",28,2,0,0,30
"cg08857406",1,0,0,0,1
"cg08857513",0,0,1,0,1
"cg08857745",1,0,0,0,1
"cg08857994",0,0,1,0,1
"cg08858020",11,5,2,0,18
"cg08858370",0,0,1,0,1
"cg08858441",0,0,0,1,1
"cg08859406",105,61,0,0,166
"cg08859447",0,2,0,0,2
"cg08859916",0,0,1,0,1
"cg08860007",21,15,1,0,37
"cg08860411",0,1,3,0,4
"cg08860596",0,0,0,1,1
"cg08860941",1,0,0,0,1
"cg08862210",1,0,0,0,1
"cg08862373",1,0,0,0,1
"cg08862717",20,0,0,0,20
"cg08863842",15,0,0,0,15
"cg08865588",594,17,0,0,611
"cg08866633",2,4,2,0,8
"cg08867667",2,1,1,0,4
"cg08868447",3,10,10,0,23
"cg08869206",1,3,0,0,4
"cg08869571",2,2,0,0,4
"cg08869875",0,0,3,1,4
"cg08871291",1,0,2,0,3
"cg08871618",0,0,1,0,1
"cg08871722",1,0,0,0,1
"cg08871875",1,4,0,0,5
"cg08872001",61,101,18,0,180
"cg08872924",0,0,0,1,1
"cg08873266",0,1,0,0,1
"cg08874067",0,1,2,0,3
"cg08875433",0,1,3,0,4
"cg08878372",5,2,0,0,7
"cg08879022",1,1,0,0,2
"cg08879200",0,0,0,1,1
"cg08880064",0,2,1,0,3
"cg08880070",0,0,1,0,1
"cg08880796",1,1,1,0,3
"cg08882060",0,1,0,0,1
"cg08882084",2,0,0,0,2
"cg08882985",2,0,0,0,2
"cg08883028",90,11,0,0,101
"cg08883118",3,0,0,0,3
"cg08883140",2,4,6,0,12
"cg08883146",0,1,0,0,1
"cg08883535",1,0,0,0,1
"cg08884494",1,0,0,0,1
"cg08884854",0,0,4,0,4
"cg08884917",1,0,0,0,1
"cg08885198",0,0,2,0,2
"cg08885316",135,322,61,0,518
"cg08885708",640,26,0,0,666
"cg08886201",12,3,0,0,15
"cg08887184",1,0,0,0,1
"cg08887952",1,1,0,0,2
"cg08888022",18,10,0,0,28
"cg08888152",2,0,0,0,2
"cg08889480",0,0,3,0,3
"cg08889636",19,1,2,0,22
"cg08889954",1,0,0,0,1
"cg08890503",0,0,1,0,1
"cg08891115",0,0,1,0,1
"cg08891229",1,0,0,0,1
"cg08891811",1,0,0,0,1
"cg08893811",1,0,0,0,1
"cg08894150",1,0,0,0,1
"cg08894319",16,1,0,0,17
"cg08894362",1,1,0,0,2
"cg08894410",1,2,14,0,17
"cg08894701",1,0,1,0,2
"cg08895311",11,0,0,0,11
"cg08895454",0,1,0,0,1
"cg08896243",0,1,1,0,2
"cg08896852",1,0,0,0,1
"cg08897010",125,209,0,0,334
"cg08897031",1,0,4,0,5
"cg08897493",3,0,0,0,3
"cg08898949",0,0,1,0,1
"cg08899212",0,0,1,0,1
"cg08899308",2,0,1,0,3
"cg08899761",0,1,0,0,1
"cg08900656",240,38,3,0,281
"cg08901098",0,0,1,0,1
"cg08901578",0,7,16,0,23
"cg08903206",41,4,0,0,45
"cg08903970",212,74,1,0,287
"cg08904095",0,13,1,0,14
"cg08904445",1,2,1,0,4
"cg08904532",1,5,1,0,7
"cg08905402",0,1,0,0,1
"cg08905600",36,5,0,0,41
"cg08905624",72,208,61,0,341
"cg08905705",1,0,0,0,1
"cg08906643",0,1,1,0,2
"cg08907282",9,1,0,0,10
"cg08908004",0,1,0,0,1
"cg08909185",1,0,0,0,1
"cg08911864",0,0,1,0,1
"cg08912238",0,0,2,0,2
"cg08912840",0,3,0,0,3
"cg08913117",0,0,1,0,1
"cg08913191",3,2,0,0,5
"cg08913931",32,8,0,0,40
"cg08915683",0,1,0,0,1
"cg08915776",135,3,0,0,138
"cg08916154",0,1,3,1,5
"cg08916302",0,1,0,0,1
"cg08916839",0,0,1,0,1
"cg08917933",0,0,1,0,1
"cg08918031",0,1,1,0,2
"cg08918057",2,2,0,0,4
"cg08918887",0,0,1,0,1
"cg08919224",0,8,2,0,10
"cg08919359",0,0,8,0,8
"cg08919528",66,217,26,0,309
"cg08919674",0,0,1,0,1
"cg08919930",5,17,3,0,25
"cg08920440",0,3,0,0,3
"cg08920724",5,0,0,0,5
"cg08922544",360,154,0,0,514
"cg08922669",2,0,0,0,2
"cg08923066",3,0,0,0,3
"cg08924026",0,1,0,0,1
"cg08924089",2,0,1,0,3
"cg08924911",29,6,0,0,35
"cg08925882",2,0,0,0,2
"cg08926436",0,1,22,0,23
"cg08927294",45,5,0,0,50
"cg08928494",0,0,1,0,1
"cg08928799",0,0,1,0,1
"cg08928897",1,0,0,0,1
"cg08929218",0,1,0,0,1
"cg08929436",0,0,1,0,1
"cg08930214",0,0,1,0,1
"cg08930642",0,0,7,0,7
"cg08930944",0,1,0,0,1
"cg08931262",0,2,0,0,2
"cg08932233",0,0,5,0,5
"cg08932994",188,445,69,0,702
"cg08933160",0,2,1,0,3
"cg08935003",1,0,0,0,1
"cg08936952",0,0,1,0,1
"cg08937153",0,2,0,0,2
"cg08937395",0,0,1,0,1
"cg08937958",1,0,0,0,1
"cg08939496",0,0,1,0,1
"cg08939658",1,0,0,0,1
"cg08940787",1,0,0,0,1
"cg08941122",1,0,0,0,1
"cg08942052",0,1,0,0,1
"cg08943004",0,1,0,0,1
"cg08943258",1,0,0,0,1
"cg08943499",0,1,0,0,1
"cg08943772",1,0,0,0,1
"cg08944385",0,0,1,0,1
"cg08944997",0,1,0,0,1
"cg08945467",4,13,8,0,25
"cg08945711",1,0,0,0,1
"cg08945718",0,1,0,0,1
"cg08946014",0,0,1,0,1
"cg08946563",0,2,0,0,2
"cg08947087",13,0,0,0,13
"cg08947521",1,0,0,0,1
"cg08949192",1,1,1,0,3
"cg08949783",3,1,0,0,4
"cg08950734",0,2,0,0,2
"cg08950859",0,1,0,0,1
"cg08951186",0,0,1,0,1
"cg08951330",0,0,1,0,1
"cg08951566",0,0,1,0,1
"cg08952108",0,0,1,0,1
"cg08952300",34,1,0,0,35
"cg08953243",2,0,1,0,3
"cg08953850",9,0,0,0,9
"cg08954701",7,3,0,0,10
"cg08954761",0,0,1,0,1
"cg08955952",0,1,0,0,1
"cg08956054",0,0,1,0,1
"cg08956604",1,0,0,0,1
"cg08956724",1,0,1,0,2
"cg08956865",1,1,0,0,2
"cg08958598",3,3,0,0,6
"cg08958952",0,0,1,0,1
"cg08959057",0,0,1,0,1
"cg08959094",0,0,1,0,1
"cg08959314",0,0,1,0,1
"cg08959585",77,35,5,0,117
"cg08960156",0,0,4,0,4
"cg08961258",0,1,0,0,1
"cg08961416",0,0,1,0,1
"cg08961793",0,0,1,0,1
"cg08962164",3,2,2,0,7
"cg08962298",33,0,0,0,33
"cg08963495",2,0,1,0,3
"cg08964890",0,0,1,0,1
"cg08965098",1,5,4,0,10
"cg08965262",8,1,0,0,9
"cg08965677",0,0,1,0,1
"cg08966591",360,67,5,0,432
"cg08967800",0,0,2,0,2
"cg08967927",0,3,0,0,3
"cg08968445",0,1,0,0,1
"cg08968603",14,4,0,0,18
"cg08968947",0,0,1,0,1
"cg08969066",2,1,0,0,3
"cg08970715",5,1,0,0,6
"cg08971041",1,0,0,0,1
"cg08971831",1,1,1,0,3
"cg08972582",2,0,0,0,2
"cg08972632",0,0,1,0,1
"cg08972843",5,0,0,0,5
"cg08973243",0,0,1,0,1
"cg08973839",1,0,1,0,2
"cg08973851",0,1,0,0,1
"cg08974463",1,1,0,0,2
"cg08974492",58,4,0,0,62
"cg08975121",0,1,0,0,1
"cg08975239",8,0,0,0,8
"cg08975295",8,7,1,0,16
"cg08975528",0,0,1,0,1
"cg08975724",6,4,0,0,10
"cg08976025",1,0,0,0,1
"cg08977027",0,0,1,0,1
"cg08977054",122,48,14,0,184
"cg08977954",1,0,0,0,1
"cg08979261",4,3,5,0,12
"cg08979720",0,0,6,0,6
"cg08980382",0,1,0,0,1
"cg08980859",1,0,0,0,1
"cg08981067",0,0,1,0,1
"cg08981669",0,0,9,0,9
"cg08982986",1,0,0,0,1
"cg08983253",0,0,1,0,1
"cg08983429",72,9,0,0,81
"cg08983760",14,7,2,0,23
"cg08984900",0,2,0,0,2
"cg08985078",1,0,1,0,2
"cg08985570",3,4,0,0,7
"cg08987560",10,4,2,0,16
"cg08987606",0,0,1,0,1
"cg08988226",1,0,0,0,1
"cg08988609",5,0,0,0,5
"cg08990626",0,0,1,0,1
"cg08990926",0,1,0,0,1
"cg08992552",0,0,4,0,4
"cg08994836",1,0,0,0,1
"cg08995467",0,0,3,0,3
"cg08995473",101,11,1,0,113
"cg08995668",37,66,215,0,318
"cg08997274",0,0,2,0,2
"cg08997352",0,0,2,0,2
"cg08997445",0,1,0,0,1
"cg08997913",11,2,0,0,13
"cg08998582",0,0,1,0,1
"cg08999332",0,1,0,0,1
"cg08999962",0,1,0,0,1
"cg09000800",1,0,0,0,1
"cg09001642",0,0,2,0,2
"cg09003023",1,1,0,0,2
"cg09003326",113,370,64,0,547
"cg09003499",1,0,1,0,2
"cg09003710",5,0,0,0,5
"cg09004936",9,0,0,0,9
"cg09005448",164,75,3,0,242
"cg09006327",0,1,1,0,2
"cg09006582",2,0,0,0,2
"cg09007244",1,0,0,0,1
"cg09007841",0,0,1,0,1
"cg09008103",1,0,0,0,1
"cg09009891",1,0,0,0,1
"cg09010232",0,2,1,0,3
"cg09010827",0,1,0,0,1
"cg09011231",1,0,1,0,2
"cg09011455",2,1,0,0,3
"cg09011576",2,6,2,0,10
"cg09012174",0,2,1,0,3
"cg09013789",11,16,9,0,36
"cg09013953",0,1,0,0,1
"cg09013995",63,6,0,0,69
"cg09015325",1,0,0,0,1
"cg09015722",0,0,1,0,1
"cg09015841",0,0,1,0,1
"cg09016348",0,4,1,0,5
"cg09016926",0,0,2,0,2
"cg09017528",0,0,9,0,9
"cg09018040",0,2,0,0,2
"cg09018134",1,0,0,0,1
"cg09018383",0,0,1,0,1
"cg09018722",1,1,0,0,2
"cg09018944",22,15,11,0,48
"cg09019137",31,3,0,0,34
"cg09019457",0,0,3,0,3
"cg09020001",7,1,0,0,8
"cg09020336",0,1,1,0,2
"cg09021471",0,0,0,1,1
"cg09023743",1,0,0,0,1
"cg09025174",0,1,0,0,1
"cg09026213",0,1,0,0,1
"cg09026580",52,21,0,0,73
"cg09026875",0,0,1,0,1
"cg09026955",0,1,0,0,1
"cg09027357",0,1,0,0,1
"cg09027495",0,3,0,0,3
"cg09027985",0,1,0,0,1
"cg09028008",0,1,0,0,1
"cg09028316",327,673,19,0,1019
"cg09028478",1,1,0,0,2
"cg09028748",4,5,0,0,9
"cg09029468",0,1,0,0,1
"cg09029526",1,0,0,0,1
"cg09029624",0,0,1,0,1
"cg09030162",1,3,2,0,6
"cg09032303",0,1,0,0,1
"cg09032391",1,0,0,0,1
"cg09032630",0,5,10,0,15
"cg09032973",2,3,2,0,7
"cg09034774",0,1,0,0,1
"cg09034836",0,0,6,0,6
"cg09035253",2,0,0,0,2
"cg09035806",37,0,0,0,37
"cg09035838",0,1,3,0,4
"cg09036478",0,1,1,0,2
"cg09037025",0,0,3,0,3
"cg09037798",0,3,5,0,8
"cg09037867",0,1,0,0,1
"cg09037894",0,1,0,0,1
"cg09038078",5,3,0,0,8
"cg09038914",1,0,0,0,1
"cg09039112",0,0,1,0,1
"cg09039949",2,0,0,0,2
"cg09040134",0,0,1,0,1
"cg09040627",10,17,0,0,27
"cg09043633",0,1,0,0,1
"cg09044154",0,0,1,0,1
"cg09044728",0,0,1,0,1
"cg09045317",5,1,0,0,6
"cg09045419",0,2,2,0,4
"cg09045647",0,0,1,0,1
"cg09046797",1,0,0,0,1
"cg09047536",0,0,1,0,1
"cg09048205",0,0,1,0,1
"cg09048404",0,0,1,1,2
"cg09048955",0,0,1,0,1
"cg09050820",0,1,0,0,1
"cg09050860",77,17,2,0,96
"cg09051904",2,0,0,0,2
"cg09052108",1,0,0,0,1
"cg09052327",0,0,2,0,2
"cg09052585",4,9,9,0,22
"cg09052906",1,0,0,0,1
"cg09053271",0,1,0,0,1
"cg09053663",1,0,0,0,1
"cg09053901",0,0,1,0,1
"cg09054549",3,0,0,0,3
"cg09056039",0,0,6,0,6
"cg09058061",1,0,2,0,3
"cg09058576",0,0,1,0,1
"cg09059466",1,0,0,0,1
"cg09062640",1,0,0,0,1
"cg09062822",0,0,1,0,1
"cg09062849",0,0,1,0,1
"cg09063472",0,0,2,0,2
"cg09066476",2,2,0,0,4
"cg09066849",0,0,1,0,1
"cg09067610",28,29,3,0,60
"cg09067990",115,63,1,0,179
"cg09068303",1,0,0,0,1
"cg09069150",12,6,0,0,18
"cg09069294",0,2,6,0,8
"cg09069886",1,0,0,0,1
"cg09070832",0,2,2,0,4
"cg09071482",0,0,1,0,1
"cg09072368",0,0,1,0,1
"cg09073838",1,0,0,0,1
"cg09074625",4,3,1,0,8
"cg09074808",0,1,0,0,1
"cg09078408",4,2,0,0,6
"cg09079168",0,1,1,0,2
"cg09079286",0,0,1,0,1
"cg09080432",1,1,5,0,7
"cg09080503",1,2,0,0,3
"cg09080729",0,0,1,0,1
"cg09080738",20,21,4,0,45
"cg09081711",1,0,0,0,1
"cg09082515",1,0,0,0,1
"cg09082839",3,0,0,0,3
"cg09082840",1,0,0,0,1
"cg09083082",2,1,1,0,4
"cg09084230",1,0,0,0,1
"cg09086151",0,1,0,0,1
"cg09086740",13,11,2,0,26
"cg09087683",343,10,3,0,356
"cg09088430",0,0,1,0,1
"cg09088812",7,1,0,0,8
"cg09090017",0,1,0,0,1
"cg09090460",0,1,0,0,1
"cg09090462",0,0,1,0,1
"cg09090733",1,0,0,0,1
"cg09091404",8,3,1,0,12
"cg09092132",1,1,0,0,2
"cg09093035",0,1,0,0,1
"cg09093538",0,2,3,0,5
"cg09095645",0,1,0,0,1
"cg09097919",0,1,0,0,1
"cg09099312",1,4,0,0,5
"cg09099653",0,1,0,0,1
"cg09099716",0,1,0,0,1
"cg09100792",3,1,0,0,4
"cg09101041",0,2,1,0,3
"cg09102690",0,1,0,0,1
"cg09102762",1,0,0,0,1
"cg09103600",337,141,9,0,487
"cg09103660",1,0,0,0,1
"cg09103724",26,67,7,0,100
"cg09104029",33,3,0,0,36
"cg09104321",2,0,0,0,2
"cg09104747",0,2,2,0,4
"cg09104915",0,0,1,0,1
"cg09105440",5,4,0,0,9
"cg09105562",0,1,1,0,2
"cg09106471",0,1,0,0,1
"cg09106505",0,3,5,0,8
"cg09107240",3,0,0,0,3
"cg09108378",0,0,1,0,1
"cg09109496",0,1,0,0,1
"cg09110945",2,0,0,0,2
"cg09112388",1,0,0,0,1
"cg09114546",0,0,1,0,1
"cg09115837",1,0,0,0,1
"cg09116520",3,0,0,0,3
"cg09118225",0,1,0,0,1
"cg09118400",6,2,0,0,8
"cg09118481",1,0,1,0,2
"cg09118555",2,2,0,0,4
"cg09120035",0,1,0,0,1
"cg09120188",0,1,1,0,2
"cg09120302",0,55,28,0,83
"cg09120877",29,0,0,0,29
"cg09121055",231,323,20,0,574
"cg09121680",0,1,0,0,1
"cg09121693",0,2,0,0,2
"cg09122035",0,2,0,0,2
"cg09122197",1,2,0,0,3
"cg09122412",0,1,0,0,1
"cg09123431",0,0,1,0,1
"cg09124018",247,205,17,0,469
"cg09124136",1,0,0,0,1
"cg09124223",0,0,1,0,1
"cg09124369",105,7,0,0,112
"cg09124494",0,1,0,0,1
"cg09126659",0,0,2,0,2
"cg09126701",277,207,12,0,496
"cg09126835",2,0,0,0,2
"cg09126870",1,0,0,0,1
"cg09127406",0,0,1,0,1
"cg09127540",1,1,1,0,3
"cg09128064",21,0,0,0,21
"cg09128096",0,1,0,0,1
"cg09128377",0,0,1,0,1
"cg09128733",0,0,1,0,1
"cg09131092",14,0,0,0,14
"cg09131398",0,0,1,0,1
"cg09132256",1,1,0,0,2
"cg09133154",5,0,0,0,5
"cg09133791",1,1,0,0,2
"cg09136023",1,0,0,0,1
"cg09136815",0,1,0,0,1
"cg09137162",720,583,20,0,1323
"cg09137199",0,1,2,0,3
"cg09137423",0,0,1,0,1
"cg09137608",0,1,0,0,1
"cg09137672",0,0,1,0,1
"cg09138437",0,0,2,0,2
"cg09138512",2,0,0,0,2
"cg09139287",0,1,0,0,1
"cg09139559",0,1,0,0,1
"cg09139721",0,0,1,0,1
"cg09140665",1,0,0,0,1
"cg09141001",4,1,0,0,5
"cg09141300",19,1,0,0,20
"cg09141557",1,0,1,0,2
"cg09142608",5,10,0,0,15
"cg09144424",1,0,0,0,1
"cg09145534",487,181,0,0,668
"cg09147386",0,1,0,0,1
"cg09147710",0,0,1,0,1
"cg09147920",0,0,2,0,2
"cg09148746",11,2,0,0,13
"cg09149459",0,0,1,0,1
"cg09150152",133,66,32,0,231
"cg09152401",0,0,1,0,1
"cg09152433",0,1,0,0,1
"cg09152479",0,2,0,0,2
"cg09152490",0,0,1,0,1
"cg09153684",0,1,0,0,1
"cg09154317",3,2,0,0,5
"cg09154395",1,2,1,0,4
"cg09155940",2,0,2,0,4
"cg09156699",0,1,0,0,1
"cg09157431",0,1,0,0,1
"cg09159144",1,0,0,0,1
"cg09159638",2,0,0,0,2
"cg09159682",0,1,0,0,1
"cg09160038",6,0,0,0,6
"cg09160332",0,5,0,0,5
"cg09160336",128,5,0,0,133
"cg09160381",17,5,0,0,22
"cg09160912",1,3,13,0,17
"cg09162829",0,1,5,0,6
"cg09162860",0,1,0,0,1
"cg09163365",0,1,0,0,1
"cg09163516",1,1,3,0,5
"cg09163801",1,0,0,0,1
"cg09164203",0,1,0,0,1
"cg09164211",0,0,6,0,6
"cg09164911",1,0,0,0,1
"cg09166233",1,1,2,0,4
"cg09166973",1,0,0,0,1
"cg09167187",0,0,1,0,1
"cg09167825",1,2,0,0,3
"cg09168272",252,320,6,0,578
"cg09169215",0,0,2,0,2
"cg09169454",35,0,0,0,35
"cg09170347",1,0,0,0,1
"cg09170412",0,0,4,0,4
"cg09170553",0,0,1,0,1
"cg09174168",1,3,1,0,5
"cg09174188",0,3,2,0,5
"cg09174741",170,145,6,0,321
"cg09176105",0,5,2,0,7
"cg09176274",0,0,1,0,1
"cg09176539",0,0,1,0,1
"cg09176545",0,2,3,0,5
"cg09177473",2,0,0,0,2
"cg09177734",0,0,1,0,1
"cg09179420",0,0,1,0,1
"cg09179993",69,1,0,0,70
"cg09180253",1,0,0,0,1
"cg09180341",1,0,0,0,1
"cg09180356",9,9,2,0,20
"cg09180380",0,2,0,0,2
"cg09180890",8,23,11,0,42
"cg09181548",4,2,0,0,6
"cg09182939",0,0,1,0,1
"cg09185386",0,0,1,0,1
"cg09186500",2,0,1,0,3
"cg09186748",5,3,0,0,8
"cg09187740",3,0,0,0,3
"cg09187760",0,0,1,0,1
"cg09187904",14,8,1,0,23
"cg09188016",1,0,0,0,1
"cg09188385",0,0,1,0,1
"cg09188484",0,1,0,0,1
"cg09189601",0,0,0,1,1
"cg09190618",1,0,0,0,1
"cg09190885",18,4,0,0,22
"cg09191036",0,2,0,0,2
"cg09192011",0,0,1,0,1
"cg09192086",12,1,0,0,13
"cg09193791",1,0,0,0,1
"cg09196346",1,1,0,0,2
"cg09196942",0,0,3,0,3
"cg09197288",11,1,0,0,12
"cg09197391",1,0,0,0,1
"cg09197508",0,0,2,0,2
"cg09197653",1,0,0,0,1
"cg09197968",0,0,1,0,1
"cg09198877",0,0,1,0,1
"cg09199072",1,0,0,0,1
"cg09199660",2,0,0,0,2
"cg09200086",0,0,1,0,1
"cg09200097",2,0,0,0,2
"cg09200593",60,201,116,0,377
"cg09200738",2,0,3,0,5
"cg09200760",0,1,0,0,1
"cg09202667",0,0,1,0,1
"cg09202971",17,4,0,0,21
"cg09203382",179,339,84,0,602
"cg09203927",0,1,1,0,2
"cg09204187",0,0,1,0,1
"cg09204524",0,0,1,0,1
"cg09205156",1,11,4,0,16
"cg09205202",1,0,1,0,2
"cg09208020",1,0,0,0,1
"cg09208341",6,4,0,0,10
"cg09208628",5,7,2,0,14
"cg09208740",2,1,1,0,4
"cg09210005",0,1,0,0,1
"cg09211265",0,0,3,0,3
"cg09212113",65,107,4,0,176
"cg09215411",0,0,1,0,1
"cg09216620",0,1,0,0,1
"cg09217910",0,1,0,0,1
"cg09218569",31,2,0,0,33
"cg09218635",1,0,0,0,1
"cg09219566",0,0,1,0,1
"cg09219668",411,202,9,0,622
"cg09219970",1,0,0,0,1
"cg09220034",3,0,0,0,3
"cg09221219",2,0,1,0,3
"cg09221872",57,4,0,0,61
"cg09223975",0,1,0,0,1
"cg09225293",0,2,1,0,3
"cg09225933",0,1,0,0,1
"cg09226290",92,212,246,0,550
"cg09226570",0,1,0,0,1
"cg09226792",0,0,1,0,1
"cg09227105",1,1,0,0,2
"cg09227478",1,0,0,0,1
"cg09227806",1,0,0,0,1
"cg09228725",32,3,0,0,35
"cg09229974",3,2,0,0,5
"cg09231950",24,14,2,0,40
"cg09232103",0,1,0,0,1
"cg09232499",0,2,0,0,2
"cg09233161",1,0,0,0,1
"cg09233678",0,0,1,0,1
"cg09233704",0,0,2,0,2
"cg09234393",0,0,1,0,1
"cg09234465",0,0,2,0,2
"cg09235050",0,4,0,0,4
"cg09235203",0,1,2,0,3
"cg09235885",0,2,0,0,2
"cg09238432",1,0,0,0,1
"cg09238761",0,1,5,0,6
"cg09239150",0,0,1,0,1
"cg09239700",217,30,0,0,247
"cg09239705",1,0,0,0,1
"cg09239716",1,0,0,0,1
"cg09240555",279,43,0,0,322
"cg09241097",0,2,0,0,2
"cg09242100",1,1,1,0,3
"cg09242533",0,0,1,0,1
"cg09242751",9,2,0,0,11
"cg09242901",0,2,4,0,6
"cg09243147",1,0,2,0,3
"cg09243567",0,1,0,0,1
"cg09248119",0,0,1,0,1
"cg09248276",1,0,0,0,1
"cg09248356",0,0,1,0,1
"cg09249611",0,0,1,0,1
"cg09249800",0,1,0,0,1
"cg09249837",1,0,0,0,1
"cg09250300",0,0,1,0,1
"cg09251328",24,7,0,0,31
"cg09253412",0,0,1,0,1
"cg09255484",0,1,3,0,4
"cg09255913",1,0,0,0,1
"cg09256940",0,1,0,0,1
"cg09257039",65,4,0,0,69
"cg09257178",0,1,3,0,4
"cg09258283",0,0,0,1,1
"cg09258439",0,0,1,0,1
"cg09258788",2,0,0,0,2
"cg09259115",1,0,0,0,1
"cg09259182",0,0,1,0,1
"cg09259939",2,0,0,0,2
"cg09260195",6,0,0,0,6
"cg09261703",1,0,0,0,1
"cg09262870",3,0,0,0,3
"cg09263089",1,0,0,0,1
"cg09263407",1,0,1,0,2
"cg09264558",2,4,0,0,6
"cg09265955",3,9,0,0,12
"cg09266008",1,0,0,0,1
"cg09266080",0,0,1,0,1
"cg09266229",1,0,1,0,2
"cg09266310",1,0,0,0,1
"cg09267087",61,29,5,0,95
"cg09267402",212,372,92,0,676
"cg09267580",635,147,3,0,785
"cg09268338",2,1,0,0,3
"cg09269118",9,8,1,0,18
"cg09269480",0,0,1,0,1
"cg09270003",329,129,4,0,462
"cg09270060",2,0,0,0,2
"cg09270514",356,1,14,0,371
"cg09273278",4,1,0,0,5
"cg09273289",223,5,0,0,228
"cg09273482",15,23,9,0,47
"cg09273714",0,1,0,0,1
"cg09274253",1,0,0,0,1
"cg09274963",0,0,1,0,1
"cg09276026",5,1,0,0,6
"cg09276621",1,0,0,0,1
"cg09276863",0,0,1,0,1
"cg09279404",0,0,2,0,2
"cg09279458",1,0,0,0,1
"cg09280243",0,0,2,0,2
"cg09280462",0,0,9,0,9
"cg09282654",31,10,4,0,45
"cg09283690",6,4,3,0,13
"cg09283950",7,1,0,0,8
"cg09284336",2,1,0,0,3
"cg09284719",0,0,1,0,1
"cg09285114",0,0,0,1,1
"cg09285683",0,1,0,0,1
"cg09285808",16,0,0,0,16
"cg09286626",1,0,2,0,3
"cg09287179",0,1,0,0,1
"cg09287977",1,1,0,0,2
"cg09288310",0,1,0,0,1
"cg09289278",0,0,1,0,1
"cg09289439",1,0,0,0,1
"cg09290612",1,0,0,0,1
"cg09291386",0,0,2,0,2
"cg09293122",0,0,1,0,1
"cg09293286",0,0,1,0,1
"cg09294492",0,0,1,0,1
"cg09294660",124,41,2,0,167
"cg09295542",2,0,0,0,2
"cg09296089",0,0,1,0,1
"cg09296453",2,4,2,0,8
"cg09297252",0,5,18,0,23
"cg09297409",0,1,0,0,1
"cg09297882",0,1,0,0,1
"cg09298680",4,0,0,0,4
"cg09299316",6,3,0,0,9
"cg09299390",0,0,1,0,1
"cg09300505",0,0,1,0,1
"cg09300563",0,0,1,0,1
"cg09300980",1,1,0,0,2
"cg09301052",1,0,0,0,1
"cg09302776",0,0,1,0,1
"cg09302845",0,0,1,0,1
"cg09303239",8,0,0,0,8
"cg09303375",0,1,0,0,1
"cg09303715",0,0,1,0,1
"cg09304270",1,6,1,0,8
"cg09305478",0,0,1,0,1
"cg09307250",6,1,0,0,7
"cg09307335",0,0,1,0,1
"cg09307358",0,1,3,0,4
"cg09307838",2,0,0,0,2
"cg09308375",0,1,0,0,1
"cg09308502",37,21,0,0,58
"cg09308847",0,1,0,0,1
"cg09310891",1,0,0,0,1
"cg09311149",3,0,0,0,3
"cg09312996",307,8,0,0,315
"cg09313979",0,0,0,1,1
"cg09314833",78,89,4,1,172
"cg09314984",0,1,0,0,1
"cg09315918",0,0,1,0,1
"cg09316204",5,7,0,0,12
"cg09316214",0,2,0,0,2
"cg09317079",0,1,0,0,1
"cg09317790",0,1,0,0,1
"cg09318124",214,26,1,0,241
"cg09319020",6,0,0,0,6
"cg09319733",1,0,0,0,1
"cg09320079",0,1,0,0,1
"cg09321268",8,3,2,0,13
"cg09321430",181,279,14,0,474
"cg09325041",0,0,5,0,5
"cg09325162",14,0,0,0,14
"cg09325506",1,0,0,0,1
"cg09325695",176,327,37,0,540
"cg09326107",84,66,8,0,158
"cg09327250",0,1,1,0,2
"cg09327375",1137,658,218,0,2013
"cg09327561",0,1,0,0,1
"cg09328163",0,1,1,0,2
"cg09328611",0,0,3,0,3
"cg09328644",0,0,1,0,1
"cg09329587",4,0,0,0,4
"cg09329606",0,1,2,0,3
"cg09330242",1,1,0,0,2
"cg09331835",0,0,2,0,2
"cg09332981",0,0,1,0,1
"cg09333367",0,1,1,0,2
"cg09333889",0,0,1,0,1
"cg09334382",0,1,0,0,1
"cg09334555",23,1,0,0,24
"cg09336056",0,0,1,0,1
"cg09336909",1,0,0,0,1
"cg09338045",1,3,0,0,4
"cg09339153",0,0,1,0,1
"cg09341848",2,0,0,0,2
"cg09342111",27,6,0,0,33
"cg09342798",5,0,0,0,5
"cg09342940",0,0,1,0,1
"cg09342994",2,0,0,0,2
"cg09343672",0,0,1,0,1
"cg09343819",12,0,0,0,12
"cg09344098",0,1,0,0,1
"cg09344219",140,608,11,0,759
"cg09345077",0,1,0,0,1
"cg09345153",1,0,0,0,1
"cg09345839",160,207,41,0,408
"cg09346831",1,1,1,0,3
"cg09346871",15,32,26,0,73
"cg09347151",0,1,0,0,1
"cg09347288",0,0,5,0,5
"cg09348012",91,30,6,0,127
"cg09348732",0,0,3,0,3
"cg09350008",1,0,0,0,1
"cg09350435",0,0,1,0,1
"cg09350883",0,0,1,0,1
"cg09351142",6,0,0,0,6
"cg09353726",0,0,1,0,1
"cg09354295",2,0,0,0,2
"cg09356625",3,3,0,0,6
"cg09357538",1,0,0,0,1
"cg09357750",185,60,2,0,247
"cg09359475",0,0,1,0,1
"cg09362337",0,0,2,0,2
"cg09362743",0,1,0,0,1
"cg09363978",0,0,1,0,1
"cg09364127",602,104,1,0,707
"cg09364218",2,0,0,0,2
"cg09366824",0,1,0,0,1
"cg09367184",104,10,0,0,114
"cg09367334",0,1,0,0,1
"cg09367727",0,0,2,0,2
"cg09367807",0,0,5,0,5
"cg09367849",1,0,0,0,1
"cg09367987",0,1,1,0,2
"cg09368046",0,0,1,0,1
"cg09368964",50,62,1,0,113
"cg09369748",32,15,1,0,48
"cg09369841",0,0,1,0,1
"cg09370277",1,0,0,0,1
"cg09370756",0,0,1,0,1
"cg09371572",1,7,2,0,10
"cg09372999",0,1,0,0,1
"cg09373350",0,0,1,0,1
"cg09373786",4,11,0,0,15
"cg09374462",4,7,3,0,14
"cg09374714",0,0,1,0,1
"cg09375174",1,0,0,0,1
"cg09375299",0,1,0,0,1
"cg09375431",0,1,0,0,1
"cg09377915",1,1,1,0,3
"cg09378304",15,2,0,0,17
"cg09379229",1,0,0,0,1
"cg09380415",0,0,2,0,2
"cg09380600",3,5,1,0,9
"cg09380636",2,2,0,0,4
"cg09381582",0,0,2,0,2
"cg09382092",28,4,0,0,32
"cg09385692",1,0,0,0,1
"cg09386204",0,1,1,0,2
"cg09387519",1,0,0,0,1
"cg09387828",1,0,0,0,1
"cg09387992",295,130,3,0,428
"cg09388113",120,262,285,0,667
"cg09388237",444,582,13,0,1039
"cg09388810",0,2,0,0,2
"cg09389493",1,0,0,0,1
"cg09390022",111,23,1,0,135
"cg09390280",0,0,1,0,1
"cg09391371",0,0,3,0,3
"cg09391383",0,1,0,0,1
"cg09391619",1,0,0,0,1
"cg09392046",0,1,0,0,1
"cg09393382",56,4,0,0,60
"cg09393453",2,1,2,0,5
"cg09393551",6,0,0,0,6
"cg09393942",0,0,1,0,1
"cg09394377",0,0,1,0,1
"cg09394453",11,0,0,0,11
"cg09395572",1,3,0,0,4
"cg09396295",0,1,0,0,1
"cg09397044",3,0,0,0,3
"cg09397191",1,0,0,0,1
"cg09397557",0,1,0,0,1
"cg09398264",0,1,0,0,1
"cg09398544",1,0,0,0,1
"cg09399156",0,0,2,0,2
"cg09399158",0,0,1,0,1
"cg09400269",0,0,1,0,1
"cg09400508",0,0,1,0,1
"cg09402225",0,0,1,0,1
"cg09402943",2,0,0,0,2
"cg09402958",0,1,0,0,1
"cg09403190",1,1,0,0,2
"cg09404119",0,0,1,0,1
"cg09404131",0,0,3,0,3
"cg09406548",0,2,0,0,2
"cg09406846",1,0,0,0,1
"cg09407081",0,1,0,0,1
"cg09407550",1,1,0,0,2
"cg09408951",4,0,0,0,4
"cg09409168",21,32,40,0,93
"cg09409412",31,2,1,0,34
"cg09409435",0,0,1,0,1
"cg09409457",2,1,0,0,3
"cg09409500",25,0,0,0,25
"cg09410171",0,3,0,0,3
"cg09410183",2,5,0,0,7
"cg09410837",14,2,0,0,16
"cg09411719",0,0,1,0,1
"cg09412369",40,6,1,0,47
"cg09412931",1,0,0,0,1
"cg09413655",0,2,9,0,11
"cg09413950",0,0,1,0,1
"cg09414330",1,0,0,0,1
"cg09414985",0,0,1,0,1
"cg09415639",1,0,0,0,1
"cg09415969",2,2,0,0,4
"cg09417740",10,2,0,0,12
"cg09418063",0,1,0,0,1
"cg09418267",0,1,0,0,1
"cg09418601",1,0,0,0,1
"cg09419372",40,1,0,0,41
"cg09420119",2,0,0,0,2
"cg09420391",1,0,0,0,1
"cg09421126",0,4,0,0,4
"cg09421142",1,0,0,0,1
"cg09421361",0,2,0,0,2
"cg09423113",1,0,0,0,1
"cg09423766",4,1,1,0,6
"cg09423819",0,0,1,0,1
"cg09424830",1,1,0,0,2
"cg09425168",1,0,0,0,1
"cg09425249",24,6,1,0,31
"cg09425611",0,1,0,0,1
"cg09426085",0,1,0,0,1
"cg09427936",2,5,0,0,7
"cg09428214",4,3,7,0,14
"cg09428912",1,0,0,0,1
"cg09429216",0,4,1,0,5
"cg09429391",0,1,0,0,1
"cg09429847",1,0,0,0,1
"cg09430308",0,0,4,0,4
"cg09430946",1,0,0,0,1
"cg09431370",5,0,0,0,5
"cg09431479",1,0,0,0,1
"cg09432465",0,1,2,0,3
"cg09434064",2,5,1,0,8
"cg09434193",0,0,1,0,1
"cg09434222",0,0,1,0,1
"cg09434431",0,1,0,0,1
"cg09435109",1,0,0,0,1
"cg09435160",0,0,1,0,1
"cg09435550",2,1,0,0,3
"cg09436232",0,0,1,0,1
"cg09436347",1,1,0,0,2
"cg09437847",0,0,1,0,1
"cg09438217",1,0,0,0,1
"cg09438445",0,0,5,0,5
"cg09439054",0,1,0,0,1
"cg09439534",33,3,0,0,36
"cg09439973",0,0,2,0,2
"cg09440268",0,0,1,0,1
"cg09440986",0,0,1,0,1
"cg09441331",0,1,0,0,1
"cg09441394",0,1,1,0,2
"cg09442159",1,0,0,0,1
"cg09443347",1,0,0,0,1
"cg09443457",0,0,1,0,1
"cg09444120",0,0,1,0,1
"cg09444276",48,15,9,0,72
"cg09444405",0,4,5,0,9
"cg09444802",2,2,0,0,4
"cg09444893",11,1,0,0,12
"cg09445363",268,202,18,0,488
"cg09447834",2,2,0,0,4
"cg09448062",0,0,1,0,1
"cg09448175",140,178,5,0,323
"cg09448246",1,0,0,0,1
"cg09448605",0,0,6,0,6
"cg09448701",2,0,0,0,2
"cg09449069",1,0,0,0,1
"cg09449235",0,1,0,0,1
"cg09450046",4,3,1,0,8
"cg09450238",0,0,1,0,1
"cg09451073",0,1,1,0,2
"cg09451549",2,0,0,0,2
"cg09452335",0,0,0,1,1
"cg09453398",3,2,0,0,5
"cg09453737",0,0,0,1,1
"cg09454209",1,0,0,1,2
"cg09454251",2,6,4,0,12
"cg09454740",1,0,0,0,1
"cg09454979",0,0,1,0,1
"cg09455239",11,0,0,0,11
"cg09456058",14,2,0,0,16
"cg09456065",4,0,0,0,4
"cg09456285",1,0,0,0,1
"cg09456389",1,0,0,0,1
"cg09456760",1,0,1,0,2
"cg09456797",0,1,2,0,3
"cg09457206",1,1,1,0,3
"cg09457413",0,1,0,0,1
"cg09457425",0,0,6,0,6
"cg09458820",0,2,0,0,2
"cg09458836",0,2,1,0,3
"cg09458907",1,0,0,0,1
"cg09459868",0,1,0,0,1
"cg09460082",0,0,1,0,1
"cg09460356",24,0,0,0,24
"cg09460489",0,4,6,0,10
"cg09462412",0,0,1,0,1
"cg09463174",2,0,0,0,2
"cg09464192",0,2,3,0,5
"cg09464367",2,0,0,0,2
"cg09465065",17,1,0,0,18
"cg09465698",1,0,0,0,1
"cg09466338",1,0,0,0,1
"cg09467165",0,1,1,0,2
"cg09467637",3,1,0,0,4
"cg09467711",3,2,1,0,6
"cg09468399",1,1,0,0,2
"cg09468832",3,0,0,0,3
"cg09468937",0,1,0,0,1
"cg09469643",0,0,1,0,1
"cg09469670",1,0,0,0,1
"cg09470902",2,0,2,0,4
"cg09470963",18,0,0,0,18
"cg09471122",0,1,1,0,2
"cg09471659",0,1,2,0,3
"cg09472675",1,0,0,0,1
"cg09473942",0,0,2,0,2
"cg09474010",17,5,0,0,22
"cg09474173",1,0,8,0,9
"cg09474589",1,0,0,0,1
"cg09474625",89,21,2,0,112
"cg09475256",1,0,0,0,1
"cg09475635",1,2,0,0,3
"cg09476883",0,0,1,0,1
"cg09476963",1,0,0,0,1
"cg09477426",597,81,2,0,680
"cg09478228",18,7,0,0,25
"cg09478811",0,1,0,0,1
"cg09478859",0,0,1,0,1
"cg09479016",4,0,0,0,4
"cg09480577",0,0,1,0,1
"cg09481347",31,6,0,0,37
"cg09481699",0,1,0,0,1
"cg09482109",457,798,23,0,1278
"cg09485063",0,0,1,0,1
"cg09485757",3,0,1,0,4
"cg09486868",0,1,0,0,1
"cg09488241",0,0,1,0,1
"cg09488502",174,24,1,0,199
"cg09490556",0,1,2,0,3
"cg09490565",0,1,0,0,1
"cg09494582",0,1,0,0,1
"cg09494694",0,1,1,0,2
"cg09495416",0,1,0,0,1
"cg09496161",1,2,0,0,3
"cg09497124",0,1,0,0,1
"cg09498254",10,4,0,0,14
"cg09499109",2,2,7,0,11
"cg09499262",653,470,3,0,1126
"cg09499747",108,5,0,0,113
"cg09501191",2,0,0,0,2
"cg09501282",0,0,1,0,1
"cg09501518",1,0,0,0,1
"cg09503522",0,0,1,0,1
"cg09504104",4,2,0,0,6
"cg09504130",0,0,1,0,1
"cg09505836",0,0,1,0,1
"cg09505990",5,1,0,0,6
"cg09506496",1,0,0,0,1
"cg09506783",0,0,1,0,1
"cg09507185",4,0,1,1,6
"cg09507246",1,0,0,0,1
"cg09507585",7,1,0,0,8
"cg09507761",1,1,0,0,2
"cg09508275",0,0,1,0,1
"cg09511909",0,1,0,0,1
"cg09512111",25,14,17,0,56
"cg09512765",3,1,0,0,4
"cg09512973",1,1,2,0,4
"cg09513169",0,0,1,0,1
"cg09514664",4,0,0,0,4
"cg09515229",49,10,1,0,60
"cg09516180",2,0,1,0,3
"cg09516423",0,0,1,0,1
"cg09516604",0,1,2,0,3
"cg09516651",0,1,0,0,1
"cg09516898",52,17,1,0,70
"cg09517391",0,0,1,1,2
"cg09517503",4,2,0,0,6
"cg09517734",173,12,0,0,185
"cg09517757",1,1,0,0,2
"cg09517809",0,0,2,0,2
"cg09518851",0,1,0,0,1
"cg09519273",0,0,1,0,1
"cg09519612",1,0,0,0,1
"cg09520501",0,1,0,0,1
"cg09520583",0,1,0,0,1
"cg09520654",1,0,0,0,1
"cg09521141",821,62,11,0,894
"cg09521536",8,4,0,0,12
"cg09521691",1,0,0,0,1
"cg09521818",2,0,0,0,2
"cg09521836",1,1,0,0,2
"cg09522945",0,1,0,0,1
"cg09522962",1,0,0,0,1
"cg09523064",35,2,0,0,37
"cg09523380",0,1,0,0,1
"cg09523909",0,0,1,0,1
"cg09526343",102,13,1,0,116
"cg09526697",0,2,0,0,2
"cg09527301",27,1,0,0,28
"cg09527453",2,1,1,0,4
"cg09527515",2,3,0,0,5
"cg09527714",58,19,5,0,82
"cg09528341",4,0,0,0,4
"cg09529065",1,0,0,0,1
"cg09529280",1,5,0,0,6
"cg09529596",1,0,0,0,1
"cg09531729",0,1,0,0,1
"cg09532502",589,15,0,0,604
"cg09533142",0,1,0,0,1
"cg09533473",0,1,0,0,1
"cg09533512",0,0,3,0,3
"cg09533915",0,0,1,0,1
"cg09534880",1,0,0,0,1
"cg09535358",2,3,2,0,7
"cg09535841",0,1,0,0,1
"cg09536426",0,0,1,0,1
"cg09536474",0,0,1,0,1
"cg09536694",2,1,0,0,3
"cg09537216",0,3,0,0,3
"cg09537523",0,0,1,0,1
"cg09537956",1,0,0,0,1
"cg09537958",36,1,0,0,37
"cg09538725",96,69,20,0,185
"cg09540002",141,4,0,0,145
"cg09540565",0,0,1,0,1
"cg09540626",0,0,1,0,1
"cg09541668",6,0,0,0,6
"cg09542838",0,0,2,0,2
"cg09543842",1,0,0,0,1
"cg09545495",290,137,3,0,430
"cg09545764",5,1,0,0,6
"cg09547767",1,0,0,0,1
"cg09547890",70,3,0,0,73
"cg09550021",0,0,1,0,1
"cg09550097",1,1,1,0,3
"cg09551350",4,0,0,0,4
"cg09551452",1,0,0,0,1
"cg09551916",0,0,1,0,1
"cg09552052",0,1,0,0,1
"cg09552183",0,0,0,1,1
"cg09552829",1,0,0,0,1
"cg09552983",307,246,7,0,560
"cg09553466",0,1,0,0,1
"cg09553915",0,1,0,0,1
"cg09553937",1,0,0,0,1
"cg09553981",0,1,0,0,1
"cg09554696",4,0,0,0,4
"cg09554993",0,1,0,0,1
"cg09555192",0,1,5,0,6
"cg09555398",3,2,2,0,7
"cg09555555",1,0,0,0,1
"cg09555617",0,0,1,0,1
"cg09555682",2,0,0,0,2
"cg09556042",1,1,0,0,2
"cg09556148",0,4,1,0,5
"cg09556994",2,1,0,0,3
"cg09557014",0,0,5,0,5
"cg09558619",0,1,0,0,1
"cg09559097",0,1,0,0,1
"cg09559140",1,0,0,0,1
"cg09559278",2,0,0,0,2
"cg09563405",0,0,1,0,1
"cg09563731",0,0,1,0,1
"cg09563786",3,0,0,0,3
"cg09563859",0,0,0,1,1
"cg09564990",6,1,0,0,7
"cg09565079",0,1,0,0,1
"cg09565688",35,11,0,0,46
"cg09565888",5,0,0,0,5
"cg09566241",3,3,0,0,6
"cg09566453",10,5,0,0,15
"cg09566533",1,0,0,0,1
"cg09567915",1,0,0,0,1
"cg09567953",139,107,4,0,250
"cg09568267",0,0,1,0,1
"cg09568555",1,2,0,0,3
"cg09568556",0,0,1,0,1
"cg09569868",0,3,1,0,4
"cg09569990",51,1,0,0,52
"cg09570855",0,1,0,0,1
"cg09571514",1,0,0,0,1
"cg09572067",0,0,1,0,1
"cg09574369",2,0,0,0,2
"cg09575733",0,0,1,0,1
"cg09576231",0,0,1,0,1
"cg09577320",0,0,1,0,1
"cg09577928",1,0,0,0,1
"cg09578065",0,0,1,0,1
"cg09579413",1,1,0,0,2
"cg09580147",0,0,1,0,1
"cg09580474",2,0,0,0,2
"cg09580601",0,0,1,0,1
"cg09580920",0,1,0,0,1
"cg09581201",312,648,28,0,988
"cg09581588",885,410,4,0,1299
"cg09582822",33,24,2,0,59
"cg09582952",0,0,1,0,1
"cg09583654",0,0,1,0,1
"cg09583921",0,0,1,0,1
"cg09583939",1,0,0,0,1
"cg09584006",15,39,2,0,56
"cg09584532",2,0,0,0,2
"cg09584691",0,2,0,0,2
"cg09585608",1,1,0,0,2
"cg09585688",0,0,1,0,1
"cg09586796",1,0,0,0,1
"cg09590303",0,2,1,2,5
"cg09590812",0,1,0,0,1
"cg09591497",32,34,35,0,101
"cg09591533",1,0,1,0,2
"cg09592224",201,106,5,0,312
"cg09592456",7,9,2,0,18
"cg09592846",3,0,0,0,3
"cg09593727",165,366,66,0,597
"cg09594046",0,0,1,0,1
"cg09594751",6,11,8,0,25
"cg09595356",0,0,1,0,1
"cg09595511",0,0,1,0,1
"cg09596962",9,7,0,0,16
"cg09597119",66,195,345,0,606
"cg09597666",22,6,0,0,28
"cg09598512",0,1,0,0,1
"cg09599259",0,0,1,0,1
"cg09599586",3,6,0,0,9
"cg09600406",0,0,1,0,1
"cg09601319",3,0,0,0,3
"cg09602529",1,1,0,0,2
"cg09602795",0,0,6,0,6
"cg09602820",0,2,1,0,3
"cg09604307",3,0,0,0,3
"cg09604762",1,0,1,0,2
"cg09605111",0,0,1,0,1
"cg09605845",2,0,1,0,3
"cg09606491",1,0,0,0,1
"cg09607043",2,0,0,0,2
"cg09607178",1,0,0,0,1
"cg09607489",68,7,0,0,75
"cg09608028",1,0,0,0,1
"cg09608073",1,0,0,0,1
"cg09609314",3,0,0,0,3
"cg09611690",1,1,0,0,2
"cg09612473",1,0,0,0,1
"cg09612573",0,1,0,0,1
"cg09612765",0,1,0,0,1
"cg09612875",0,1,0,0,1
"cg09612912",200,477,63,0,740
"cg09613747",0,0,1,0,1
"cg09614531",1,0,0,0,1
"cg09614727",3,0,0,0,3
"cg09614762",498,906,15,0,1419
"cg09615580",0,1,2,0,3
"cg09615915",0,3,18,0,21
"cg09616333",1,0,0,0,1
"cg09617896",0,0,1,0,1
"cg09618387",54,6,0,0,60
"cg09618640",0,1,1,0,2
"cg09619446",1,0,0,0,1
"cg09621423",1,0,0,0,1
"cg09622007",0,0,1,0,1
"cg09622330",1,0,0,0,1
"cg09622514",2,0,0,0,2
"cg09623024",0,0,2,0,2
"cg09623130",0,0,1,0,1
"cg09624528",1,2,0,0,3
"cg09625499",0,0,2,0,2
"cg09626061",2,1,0,0,3
"cg09626606",1,0,0,0,1
"cg09626926",0,0,2,0,2
"cg09628321",3,5,3,0,11
"cg09628649",0,0,0,1,1
"cg09628773",4,2,7,0,13
"cg09631192",0,1,0,0,1
"cg09632076",0,0,0,1,1
"cg09632152",0,0,1,0,1
"cg09632727",0,0,1,0,1
"cg09632976",4,0,0,0,4
"cg09633101",5,2,0,0,7
"cg09633140",0,1,2,0,3
"cg09633443",2,0,0,0,2
"cg09634135",0,0,1,0,1
"cg09635009",3,0,0,0,3
"cg09635533",1,0,2,0,3
"cg09636024",0,0,7,0,7
"cg09638003",1,0,0,0,1
"cg09638834",1,0,0,0,1
"cg09639264",0,2,0,0,2
"cg09639771",4,0,0,0,4
"cg09640135",194,26,0,0,220
"cg09640356",0,0,1,0,1
"cg09640718",30,0,0,0,30
"cg09641576",0,0,2,0,2
"cg09642233",0,2,0,0,2
"cg09642777",260,79,1,0,340
"cg09642925",0,0,1,0,1
"cg09643241",4,12,4,0,20
"cg09644244",0,0,1,0,1
"cg09644620",0,1,0,0,1
"cg09644944",5,2,0,0,7
"cg09645180",1,0,0,0,1
"cg09645581",0,1,0,0,1
"cg09646492",0,0,1,0,1
"cg09646655",0,0,5,0,5
"cg09646718",1,0,0,0,1
"cg09647037",73,12,0,0,85
"cg09647375",1,0,0,0,1
"cg09647797",1,0,5,0,6
"cg09649382",178,16,0,0,194
"cg09649438",0,1,0,0,1
"cg09652097",0,1,0,0,1
"cg09652614",7,4,0,0,11
"cg09653199",2,7,0,0,9
"cg09653535",62,57,2,0,121
"cg09655234",4,1,0,0,5
"cg09655459",0,1,0,0,1
"cg09656371",0,2,0,0,2
"cg09656723",1,0,0,0,1
"cg09657136",2,0,0,0,2
"cg09657341",135,274,8,0,417
"cg09657744",0,1,0,0,1
"cg09657936",0,0,1,0,1
"cg09658760",1,0,1,0,2
"cg09658772",1,0,0,0,1
"cg09660501",1,0,0,0,1
"cg09661437",1,0,0,0,1
"cg09662457",4,15,8,0,27
"cg09662862",0,0,1,0,1
"cg09663059",24,30,2,0,56
"cg09663323",0,0,1,0,1
"cg09664152",0,0,1,0,1
"cg09664455",2,3,0,0,5
"cg09664554",219,2,0,0,221
"cg09665844",6,5,0,0,11
"cg09666835",0,0,1,0,1
"cg09667001",0,1,0,0,1
"cg09667205",0,0,1,0,1
"cg09667214",1,1,0,0,2
"cg09667987",0,2,0,0,2
"cg09668244",0,0,1,0,1
"cg09669075",0,1,0,0,1
"cg09669104",1,0,0,0,1
"cg09671131",15,20,74,0,109
"cg09671906",0,1,1,0,2
"cg09672161",0,0,1,0,1
"cg09672286",0,1,0,0,1
"cg09672737",5,0,0,0,5
"cg09672912",1,0,0,0,1
"cg09674162",3,2,0,0,5
"cg09675134",2,0,0,0,2
"cg09675538",0,1,0,0,1
"cg09675895",0,0,1,0,1
"cg09676575",5,9,8,0,22
"cg09676860",0,1,1,0,2
"cg09676939",1,3,1,0,5
"cg09677082",0,1,0,0,1
"cg09677823",23,12,1,0,36
"cg09677938",0,0,1,0,1
"cg09677976",4,1,0,0,5
"cg09678093",0,0,1,0,1
"cg09679014",0,1,0,0,1
"cg09680307",0,1,0,0,1
"cg09680643",1,1,0,0,2
"cg09681750",0,1,0,0,1
"cg09683381",1,0,0,0,1
"cg09684106",2,0,0,0,2
"cg09684637",1,0,0,0,1
"cg09685060",0,1,0,0,1
"cg09685420",0,1,0,0,1
"cg09685630",0,1,0,0,1
"cg09685904",19,0,0,0,19
"cg09685961",1,0,0,0,1
"cg09686729",173,100,32,0,305
"cg09686800",36,2,0,0,38
"cg09686907",1,0,0,0,1
"cg09686964",1,3,23,0,27
"cg09687813",0,1,0,0,1
"cg09690048",1,1,0,0,2
"cg09690561",259,369,10,0,638
"cg09691093",0,4,15,0,19
"cg09692122",4,3,0,0,7
"cg09692125",3,1,3,0,7
"cg09693961",0,1,0,0,1
"cg09694328",1,0,0,0,1
"cg09696515",2,0,0,0,2
"cg09699726",2,0,0,0,2
"cg09700327",16,127,0,0,143
"cg09701144",2,1,1,0,4
"cg09701880",0,0,1,0,1
"cg09703571",0,0,1,0,1
"cg09705217",0,0,1,0,1
"cg09705264",0,0,4,0,4
"cg09705531",0,0,0,1,1
"cg09705623",0,0,1,0,1
"cg09705748",0,1,0,0,1
"cg09705759",1,0,0,0,1
"cg09706152",0,0,2,0,2
"cg09708454",4,0,0,0,4
"cg09708560",2,0,0,0,2
"cg09708666",1,0,0,0,1
"cg09708741",0,0,1,0,1
"cg09708901",147,338,2,0,487
"cg09709641",0,0,1,0,1
"cg09711279",1,0,0,0,1
"cg09711946",0,0,1,0,1
"cg09712857",0,0,1,0,1
"cg09713269",14,14,1,0,29
"cg09713549",5,0,0,0,5
"cg09713616",1,1,0,1,3
"cg09717198",1,0,0,0,1
"cg09717526",0,1,0,0,1
"cg09717610",1,0,0,0,1
"cg09719594",0,18,6,0,24
"cg09720033",1,0,0,0,1
"cg09720271",0,1,0,0,1
"cg09720544",5,4,0,0,9
"cg09721008",1,0,0,0,1
"cg09721041",3,2,0,0,5
"cg09721094",2,0,0,0,2
"cg09722404",2,4,0,0,6
"cg09722408",1,0,0,0,1
"cg09723770",41,593,11,0,645
"cg09726123",4,0,0,0,4
"cg09726125",0,0,1,0,1
"cg09726804",1,0,0,0,1
"cg09727084",0,1,3,0,4
"cg09727546",223,668,28,0,919
"cg09727641",1058,115,1,0,1174
"cg09729955",3,1,0,0,4
"cg09730640",0,0,1,0,1
"cg09730926",1,0,0,0,1
"cg09731073",1,0,0,0,1
"cg09731798",0,0,1,0,1
"cg09732637",1,0,0,0,1
"cg09733789",3,0,0,0,3
"cg09734347",0,1,2,0,3
"cg09734912",16,3,0,0,19
"cg09735337",0,1,0,0,1
"cg09735578",0,1,0,0,1
"cg09736019",0,1,0,0,1
"cg09736404",0,0,1,0,1
"cg09736440",1,1,0,0,2
"cg09736526",7,1,0,0,8
"cg09736774",0,0,1,0,1
"cg09737242",1,0,0,0,1
"cg09737911",5,0,0,0,5
"cg09738190",1,0,0,0,1
"cg09738906",0,2,0,0,2
"cg09739745",0,1,0,0,1
"cg09739912",21,0,1,0,22
"cg09739932",0,0,1,0,1
"cg09740255",0,1,0,0,1
"cg09740542",9,1,0,0,10
"cg09741670",1,1,0,0,2
"cg09743847",1,0,0,1,2
"cg09744243",47,1,0,0,48
"cg09744732",39,1,0,0,40
"cg09745083",1,0,0,0,1
"cg09745812",75,70,8,0,153
"cg09746391",0,0,2,0,2
"cg09746604",2,0,0,0,2
"cg09747169",0,0,0,1,1
"cg09747670",0,1,0,1,2
"cg09748881",1,0,0,0,1
"cg09748946",1,0,0,0,1
"cg09748952",0,1,0,0,1
"cg09750183",0,0,2,0,2
"cg09751842",0,3,4,0,7
"cg09752021",0,2,4,0,6
"cg09753647",1,3,0,0,4
"cg09753648",0,0,1,0,1
"cg09753839",1,5,1,0,7
"cg09754031",1,1,1,0,3
"cg09755032",1,0,1,0,2
"cg09755589",2,1,0,0,3
"cg09756509",1,0,0,0,1
"cg09757134",1,1,0,0,2
"cg09758761",1,0,0,0,1
"cg09758767",0,1,1,0,2
"cg09759040",0,0,1,0,1
"cg09759063",1,0,0,0,1
"cg09759619",554,59,2,0,615
"cg09759808",38,4,0,0,42
"cg09760018",0,0,1,0,1
"cg09761134",0,1,1,0,2
"cg09761155",0,1,0,0,1
"cg09761478",10,5,0,0,15
"cg09761793",1,1,0,0,2
"cg09762209",1,2,1,0,4
"cg09763060",172,9,0,0,181
"cg09764506",6,1,0,0,7
"cg09764916",0,0,1,0,1
"cg09765074",4,2,3,0,9
"cg09765906",0,0,2,0,2
"cg09766212",1,0,0,0,1
"cg09766327",70,44,0,0,114
"cg09767616",1,0,0,0,1
"cg09768178",4,0,0,0,4
"cg09770389",18,2,0,0,20
"cg09770583",0,0,1,0,1
"cg09770647",1,2,3,0,6
"cg09771512",0,0,1,0,1
"cg09772384",8,1,0,0,9
"cg09772816",0,0,1,0,1
"cg09773058",1,0,0,0,1
"cg09773573",0,1,0,0,1
"cg09773647",55,39,14,0,108
"cg09774142",0,0,1,0,1
"cg09774287",297,83,12,0,392
"cg09774565",0,0,2,0,2
"cg09775780",0,0,1,0,1
"cg09775918",0,1,4,0,5
"cg09776277",0,0,2,0,2
"cg09777617",0,1,0,0,1
"cg09778629",1,0,0,0,1
"cg09781729",2,2,1,0,5
"cg09781876",1,0,0,0,1
"cg09782691",205,363,56,0,624
"cg09782993",0,0,1,0,1
"cg09783353",1,0,0,0,1
"cg09784372",0,0,1,0,1
"cg09785091",15,8,2,0,25
"cg09785516",371,188,18,0,577
"cg09785872",0,0,1,0,1
"cg09786303",0,1,0,0,1
"cg09786335",4,14,0,0,18
"cg09787044",1,0,0,0,1
"cg09787394",0,1,0,0,1
"cg09787429",0,0,2,0,2
"cg09787820",0,0,1,0,1
"cg09788161",1,1,0,0,2
"cg09788778",0,0,1,0,1
"cg09789991",1,0,0,0,1
"cg09790134",0,0,8,0,8
"cg09790459",10,1,0,0,11
"cg09791009",71,9,1,0,81
"cg09791665",0,0,2,0,2
"cg09791867",0,0,1,0,1
"cg09793796",11,0,0,0,11
"cg09793809",0,0,1,0,1
"cg09795137",9,2,0,0,11
"cg09795550",12,1,0,0,13
"cg09795614",0,1,0,0,1
"cg09795688",0,1,0,0,1
"cg09797376",1,0,0,0,1
"cg09797837",0,2,0,0,2
"cg09798387",1,6,0,0,7
"cg09801859",0,0,2,0,2
"cg09802186",0,0,1,0,1
"cg09802192",2,4,0,0,6
"cg09803951",2,1,0,0,3
"cg09803972",2,0,1,0,3
"cg09804015",0,1,0,0,1
"cg09804964",0,0,1,0,1
"cg09805323",0,1,0,0,1
"cg09805507",1,0,0,0,1
"cg09805871",0,3,0,0,3
"cg09806597",2,0,0,0,2
"cg09806629",1,0,0,0,1
"cg09806656",2,2,1,0,5
"cg09806948",2,0,0,0,2
"cg09807481",0,1,0,0,1
"cg09808028",59,4,0,0,63
"cg09808075",0,0,1,0,1
"cg09808196",494,150,1,0,645
"cg09808319",1,0,0,0,1
"cg09809246",1,0,0,0,1
"cg09810059",1,0,0,0,1
"cg09811166",0,0,1,0,1
"cg09811926",2,0,0,0,2
"cg09812836",0,0,1,0,1
"cg09813075",1,0,0,0,1
"cg09813493",0,0,1,0,1
"cg09814895",3,0,0,0,3
"cg09814912",394,44,2,0,440
"cg09816143",1,0,0,0,1
"cg09816349",0,0,1,0,1
"cg09816366",0,0,2,0,2
"cg09817102",1,0,0,0,1
"cg09817503",2,2,0,0,4
"cg09817526",0,0,1,0,1
"cg09818023",0,0,2,0,2
"cg09818055",0,0,2,0,2
"cg09818081",0,0,1,0,1
"cg09818912",0,1,0,0,1
"cg09821234",0,1,0,0,1
"cg09821651",110,7,0,0,117
"cg09822191",0,1,0,0,1
"cg09822791",1,0,1,0,2
"cg09823452",0,0,1,0,1
"cg09824202",0,0,1,0,1
"cg09824406",0,1,0,0,1
"cg09824849",0,1,0,0,1
"cg09824926",2,0,0,0,2
"cg09825346",2,0,0,0,2
"cg09825839",1,0,0,0,1
"cg09826047",7,10,10,0,27
"cg09826692",0,1,0,0,1
"cg09826784",0,1,0,0,1
"cg09826911",0,0,1,0,1
"cg09827122",31,3,0,0,34
"cg09827673",0,0,1,0,1
"cg09828632",0,0,1,0,1
"cg09828968",2,0,0,0,2
"cg09829303",7,0,0,0,7
"cg09829573",0,0,1,0,1
"cg09829580",1,0,0,0,1
"cg09829842",207,36,1,0,244
"cg09830040",1,0,0,0,1
"cg09830678",0,1,0,0,1
"cg09831869",1,1,0,0,2
"cg09832694",3,0,0,0,3
"cg09833624",1,0,0,0,1
"cg09834467",17,0,0,0,17
"cg09834770",2,0,0,0,2
"cg09835320",0,0,1,0,1
"cg09835601",16,2,0,0,18
"cg09836361",26,12,0,0,38
"cg09837755",0,0,1,0,1
"cg09838962",298,140,2,0,440
"cg09839321",0,4,0,0,4
"cg09840563",0,1,0,0,1
"cg09840850",0,0,1,0,1
"cg09842125",0,0,1,0,1
"cg09842735",1,0,0,0,1
"cg09843155",3,0,0,0,3
"cg09843754",66,33,0,0,99
"cg09844358",1,0,0,0,1
"cg09844471",4,1,0,0,5
"cg09845145",0,0,1,0,1
"cg09845429",1,1,1,0,3
"cg09847626",0,1,0,0,1
"cg09848080",0,1,0,0,1
"cg09848259",6,19,19,0,44
"cg09848409",88,28,0,0,116
"cg09850581",0,0,1,0,1
"cg09850969",1,4,5,0,10
"cg09851120",0,0,1,0,1
"cg09851814",5,0,0,0,5
"cg09852158",0,0,1,0,1
"cg09853350",0,1,0,0,1
"cg09853486",12,2,0,0,14
"cg09853646",0,1,0,0,1
"cg09853793",0,1,0,0,1
"cg09853839",2,0,0,0,2
"cg09854683",0,0,2,0,2
"cg09855248",1,0,0,0,1
"cg09857651",9,4,1,0,14
"cg09858655",1,2,0,0,3
"cg09858929",0,1,0,0,1
"cg09859866",0,0,1,0,1
"cg09859944",0,0,4,0,4
"cg09860530",0,1,2,0,3
"cg09860935",333,76,3,0,412
"cg09861472",0,0,1,0,1
"cg09861824",0,1,1,0,2
"cg09861838",0,0,1,0,1
"cg09862122",0,0,1,0,1
"cg09862948",0,10,0,0,10
"cg09862990",0,0,1,0,1
"cg09863175",0,1,0,0,1
"cg09863706",42,113,26,0,181
"cg09865026",20,15,8,0,43
"cg09865095",2,0,0,0,2
"cg09865963",0,0,1,0,1
"cg09866510",5,2,0,0,7
"cg09866659",15,0,0,0,15
"cg09867531",12,27,9,0,48
"cg09867905",0,1,0,0,1
"cg09867945",3,0,0,0,3
"cg09867948",10,0,0,0,10
"cg09869112",3,2,0,0,5
"cg09869130",0,2,1,0,3
"cg09870004",0,1,0,0,1
"cg09871257",3,0,0,0,3
"cg09871380",1,1,0,0,2
"cg09872009",0,2,0,0,2
"cg09872233",1,0,0,0,1
"cg09873959",1,0,0,0,1
"cg09875053",0,0,1,0,1
"cg09875176",118,6,0,0,124
"cg09875543",289,20,0,0,309
"cg09878200",0,0,15,0,15
"cg09878905",0,1,0,0,1
"cg09882074",1,4,0,0,5
"cg09882461",3,1,0,0,4
"cg09882526",2,1,0,0,3
"cg09882550",425,39,2,0,466
"cg09883676",2,0,0,0,2
"cg09884279",8,1,0,0,9
"cg09885320",0,0,1,0,1
"cg09887804",0,0,1,0,1
"cg09889135",99,4,1,0,104
"cg09890269",0,1,0,0,1
"cg09891288",0,0,1,0,1
"cg09891682",0,0,11,0,11
"cg09892027",4,1,0,0,5
"cg09892357",209,78,1,0,288
"cg09894096",124,56,1,0,181
"cg09896007",0,1,0,0,1
"cg09896345",71,92,1,0,164
"cg09898271",2,1,0,0,3
"cg09898573",2,0,0,0,2
"cg09899541",5,0,0,0,5
"cg09900169",0,1,0,0,1
"cg09901136",0,0,1,0,1
"cg09902786",1,0,0,0,1
"cg09904079",156,57,0,0,213
"cg09905031",0,0,2,0,2
"cg09905047",0,0,1,0,1
"cg09906575",0,0,1,0,1
"cg09907183",1,0,0,0,1
"cg09907521",0,1,4,0,5
"cg09908764",5,2,0,0,7
"cg09909284",1463,350,7,0,1820
"cg09910353",1,0,0,0,1
"cg09910674",1,0,3,0,4
"cg09910909",0,0,1,0,1
"cg09911086",0,0,1,0,1
"cg09911092",119,19,0,0,138
"cg09911188",0,0,1,0,1
"cg09912803",3,0,1,0,4
"cg09913314",1,1,0,0,2
"cg09916286",0,0,1,0,1
"cg09916886",707,319,3,0,1029
"cg09919901",42,3,0,0,45
"cg09920855",48,15,0,0,63
"cg09921143",0,3,19,0,22
"cg09921291",0,1,0,0,1
"cg09921459",0,1,0,0,1
"cg09922188",33,16,6,0,55
"cg09924173",1,1,1,0,3
"cg09925166",0,0,1,0,1
"cg09926260",0,0,1,0,1
"cg09926669",0,1,0,0,1
"cg09927022",0,1,0,0,1
"cg09927198",115,1,0,0,116
"cg09929345",1,0,0,0,1
"cg09929382",44,127,66,0,237
"cg09930155",1,1,1,0,3
"cg09930192",0,0,2,0,2
"cg09930257",0,0,1,0,1
"cg09930325",0,1,1,0,2
"cg09931146",45,1,0,0,46
"cg09932312",1,1,0,0,2
"cg09935195",2,0,0,0,2
"cg09935517",1,1,0,0,2
"cg09936561",0,2,0,0,2
"cg09937382",3,4,0,0,7
"cg09938469",0,1,1,0,2
"cg09939303",1,0,0,0,1
"cg09939823",1,4,13,0,18
"cg09941393",8,2,0,0,10
"cg09941453",26,13,1,0,40
"cg09941542",1,0,0,0,1
"cg09941905",4,0,1,0,5
"cg09942837",944,56,0,0,1000
"cg09943035",0,0,1,0,1
"cg09943179",6,1,0,0,7
"cg09943288",1,0,0,0,1
"cg09944171",0,0,1,0,1
"cg09944821",0,0,1,0,1
"cg09945103",1,0,0,0,1
"cg09948030",0,3,1,0,4
"cg09948955",0,0,1,0,1
"cg09949146",1,0,0,0,1
"cg09951136",0,0,1,0,1
"cg09951588",1,1,0,0,2
"cg09952475",200,125,3,0,328
"cg09952674",864,221,3,0,1088
"cg09953997",0,0,1,0,1
"cg09954161",4,1,0,0,5
"cg09954197",0,0,1,0,1
"cg09954592",70,58,3,0,131
"cg09955298",1,0,4,0,5
"cg09955928",1,1,1,0,3
"cg09956268",335,14,1,0,350
"cg09956782",1,0,1,0,2
"cg09957715",3,1,6,0,10
"cg09958668",1,7,5,0,13
"cg09958830",1,2,0,0,3
"cg09959525",0,0,1,0,1
"cg09960306",1,0,0,0,1
"cg09960435",3,0,0,0,3
"cg09960454",0,0,1,0,1
"cg09962984",0,1,0,0,1
"cg09963134",1,0,0,0,1
"cg09964566",1,0,0,0,1
"cg09965264",16,18,1,0,35
"cg09965267",0,1,2,0,3
"cg09965363",0,5,0,0,5
"cg09966089",29,0,0,0,29
"cg09967219",0,1,0,0,1
"cg09967514",1,3,1,0,5
"cg09968036",0,1,0,0,1
"cg09968542",13,0,0,0,13
"cg09968565",1,0,1,0,2
"cg09968682",3,0,0,0,3
"cg09970578",0,0,1,0,1
"cg09971388",0,1,0,0,1
"cg09971994",0,0,1,0,1
"cg09972454",0,1,0,0,1
"cg09972884",0,1,1,0,2
"cg09973381",1,0,0,0,1
"cg09974579",3,4,6,0,13
"cg09974839",401,31,0,0,432
"cg09974965",0,1,0,0,1
"cg09974995",0,0,2,0,2
"cg09975659",0,1,0,0,1
"cg09975852",1,0,0,0,1
"cg09977062",1,0,0,0,1
"cg09977572",1,0,0,0,1
"cg09979168",17,4,0,0,21
"cg09979356",17,0,0,0,17
"cg09981611",1,0,0,0,1
"cg09981877",1,0,0,0,1
"cg09983532",1,0,0,0,1
"cg09984674",0,3,0,0,3
"cg09984882",1,0,0,0,1
"cg09984898",0,0,1,0,1
"cg09985260",0,0,1,0,1
"cg09985845",4,0,0,0,4
"cg09986680",0,1,0,0,1
"cg09987243",1,22,6,0,29
"cg09988129",0,0,3,0,3
"cg09988752",0,1,0,0,1
"cg09989996",0,0,1,0,1
"cg09990137",4,0,0,0,4
"cg09990563",23,9,1,0,33
"cg09990998",0,0,2,0,2
"cg09991092",0,0,2,0,2
"cg09991095",2,0,1,0,3
"cg09991426",36,20,15,0,71
"cg09991951",1,0,0,0,1
"cg09992494",0,1,2,0,3
"cg09992952",1,0,0,0,1
"cg09993713",0,1,0,0,1
"cg09993799",0,0,2,0,2
"cg09993843",3,0,0,0,3
"cg09994022",1,0,0,0,1
"cg09994928",0,1,0,0,1
"cg09995011",0,0,1,0,1
"cg09995095",0,1,0,0,1
"cg09995631",2,0,0,0,2
"cg09996211",25,2,0,0,27
"cg09997372",2,2,0,0,4
"cg09998451",1,0,0,0,1
"cg09998597",1,1,0,0,2
"cg09998941",0,0,1,0,1
"cg09999130",1,0,0,0,1
"cg09999443",1,0,0,0,1
"cg10000492",0,0,1,0,1
"cg10001363",0,0,2,0,2
"cg10001546",0,0,6,0,6
"cg10002360",0,0,2,0,2
"cg10002567",456,65,2,0,523
"cg10004174",0,0,1,0,1
"cg10006235",0,0,1,0,1
"cg10006252",0,0,1,0,1
"cg10007036",0,0,2,0,2
"cg10007405",3,0,1,0,4
"cg10007938",43,40,0,0,83
"cg10009207",0,0,1,0,1
"cg10010249",0,1,0,0,1
"cg10011015",0,3,3,0,6
"cg10011199",0,0,1,0,1
"cg10011855",0,2,0,0,2
"cg10011963",1,0,0,0,1
"cg10011978",38,10,0,0,48
"cg10012396",0,0,1,0,1
"cg10012448",1,0,0,0,1
"cg10013287",1,0,1,0,2
"cg10014005",0,1,1,0,2
"cg10014293",0,0,1,0,1
"cg10014648",8,0,0,0,8
"cg10014874",1,0,0,0,1
"cg10014881",1,0,0,0,1
"cg10016122",0,1,1,0,2
"cg10016348",0,0,2,0,2
"cg10016575",0,0,2,0,2
"cg10017787",0,0,1,0,1
"cg10018203",0,0,1,0,1
"cg10018615",0,3,0,0,3
"cg10018644",1,0,0,0,1
"cg10019095",0,0,3,0,3
"cg10019176",0,1,0,0,1
"cg10019528",0,1,0,0,1
"cg10019798",0,1,0,0,1
"cg10020029",1,0,0,0,1
"cg10020592",0,3,1,0,4
"cg10021724",0,1,0,0,1
"cg10022139",160,105,16,0,281
"cg10023469",45,2,0,0,47
"cg10025396",0,0,1,0,1
"cg10026583",2,3,0,0,5
"cg10026966",1,0,1,0,2
"cg10027400",4,0,0,0,4
"cg10027879",0,0,1,0,1
"cg10028983",1,0,0,0,1
"cg10029411",5,3,0,0,8
"cg10029427",0,1,2,0,3
"cg10030810",0,0,2,0,2
"cg10030999",0,2,2,0,4
"cg10031648",0,1,0,0,1
"cg10031873",0,0,2,0,2
"cg10032306",5,0,0,1,6
"cg10032945",3,1,0,0,4
"cg10033761",3,3,0,0,6
"cg10034184",1,0,0,0,1
"cg10034578",5,0,0,0,5
"cg10034990",1,6,0,0,7
"cg10036001",4,0,0,0,4
"cg10036421",112,69,7,0,188
"cg10036564",0,1,0,0,1
"cg10037448",1,0,0,0,1
"cg10037654",1,4,1,0,6
"cg10037915",0,0,1,0,1
"cg10039047",0,1,0,0,1
"cg10039093",0,1,0,0,1
"cg10039444",2,0,0,0,2
"cg10040225",97,28,4,0,129
"cg10040266",0,1,8,0,9
"cg10040836",0,0,1,0,1
"cg10041051",2,0,0,0,2
"cg10041376",17,0,0,0,17
"cg10042288",14,3,0,0,17
"cg10042352",4,3,1,0,8
"cg10042755",0,0,2,0,2
"cg10043313",0,0,2,0,2
"cg10043526",1,0,0,0,1
"cg10043709",6,14,0,0,20
"cg10043718",1,0,0,0,1
"cg10043804",1,1,0,0,2
"cg10044071",2,0,0,0,2
"cg10044516",0,2,2,0,4
"cg10044900",4,2,0,0,6
"cg10045669",0,1,0,0,1
"cg10045903",13,8,0,0,21
"cg10046270",8,0,0,0,8
"cg10047572",1,0,0,0,1
"cg10047694",0,1,2,0,3
"cg10050487",1,1,0,1,3
"cg10051312",34,18,3,0,55
"cg10051480",0,1,0,0,1
"cg10052017",1,0,0,0,1
"cg10052190",1,0,0,0,1
"cg10052389",1,0,0,0,1
"cg10052602",0,0,1,0,1
"cg10053473",0,1,4,0,5
"cg10054297",1,0,0,0,1
"cg10054630",1,0,0,0,1
"cg10054948",89,7,0,0,96
"cg10054980",293,201,9,0,503
"cg10054984",1,4,6,0,11
"cg10055252",2,0,0,0,2
"cg10055505",1,2,0,0,3
"cg10057085",0,0,1,0,1
"cg10057098",1,0,0,0,1
"cg10057657",0,0,1,0,1
"cg10057685",0,0,1,0,1
"cg10057801",0,1,1,0,2
"cg10057879",0,1,0,0,1
"cg10058538",0,0,1,0,1
"cg10058597",1,0,0,0,1
"cg10059036",1,0,0,0,1
"cg10059171",0,0,1,0,1
"cg10059542",174,425,9,0,608
"cg10060487",0,2,0,0,2
"cg10060903",0,1,0,0,1
"cg10060918",1,2,0,0,3
"cg10062503",134,16,0,0,150
"cg10064814",0,0,1,0,1
"cg10065081",55,4,0,0,59
"cg10065977",5,0,0,0,5
"cg10066481",52,6,2,0,60
"cg10066871",2,1,3,0,6
"cg10068158",1,0,0,0,1
"cg10068301",0,0,2,0,2
"cg10068877",0,1,0,0,1
"cg10069644",3,0,0,0,3
"cg10070016",2,0,0,0,2
"cg10070728",2,0,2,0,4
"cg10071036",0,1,0,0,1
"cg10071277",84,13,0,0,97
"cg10071848",14,0,0,0,14
"cg10072162",1,2,1,0,4
"cg10072547",5,3,0,0,8
"cg10072611",1,4,0,0,5
"cg10073693",0,1,0,0,1
"cg10074864",0,1,1,1,3
"cg10075390",1,0,0,0,1
"cg10075641",0,1,0,0,1
"cg10075923",11,20,0,0,31
"cg10076968",0,0,1,0,1
"cg10078100",1,0,0,0,1
"cg10078143",0,0,1,0,1
"cg10079132",0,1,1,0,2
"cg10080807",0,1,1,0,2
"cg10080855",0,0,1,0,1
"cg10081074",0,0,1,0,1
"cg10081761",2,1,0,0,3
"cg10081980",1,4,4,0,9
"cg10082973",0,1,0,0,1
"cg10083391",0,3,2,0,5
"cg10084803",1,0,0,0,1
"cg10084960",10,0,0,0,10
"cg10085927",510,17,0,0,527
"cg10086643",0,2,0,0,2
"cg10087060",0,0,1,0,1
"cg10087910",106,4,0,0,110
"cg10087939",0,1,0,0,1
"cg10088331",0,1,0,0,1
"cg10088985",0,0,1,0,1
"cg10090044",44,277,4,0,325
"cg10090058",1,0,0,0,1
"cg10090256",1,0,3,0,4
"cg10090432",3,0,0,0,3
"cg10090521",2,0,1,0,3
"cg10091148",0,1,3,0,4
"cg10091335",0,3,0,0,3
"cg10091891",5,0,0,0,5
"cg10092524",20,32,0,0,52
"cg10092774",1,0,0,0,1
"cg10093308",0,1,2,0,3
"cg10093328",0,0,1,0,1
"cg10093438",3,1,5,0,9
"cg10093475",292,15,1,0,308
"cg10093769",1,0,0,0,1
"cg10094846",4,2,5,0,11
"cg10095114",0,0,3,0,3
"cg10095508",0,1,0,0,1
"cg10095517",0,1,0,0,1
"cg10096008",0,2,0,0,2
"cg10096351",237,15,2,0,254
"cg10096579",0,1,3,0,4
"cg10096796",0,0,1,0,1
"cg10097316",1,0,1,0,2
"cg10097360",1,0,0,0,1
"cg10098729",0,0,2,0,2
"cg10098787",1,0,0,0,1
"cg10099709",38,23,5,0,66
"cg10099778",1,0,0,0,1
"cg10100698",1,5,0,0,6
"cg10101143",3,1,0,0,4
"cg10102037",0,2,3,0,5
"cg10102302",232,286,29,0,547
"cg10102736",0,0,1,0,1
"cg10104027",0,0,1,0,1
"cg10104420",1,0,1,0,2
"cg10105015",0,1,1,2,4
"cg10105110",112,5,0,0,117
"cg10105244",0,0,1,2,3
"cg10105294",0,0,6,0,6
"cg10105797",169,124,1,0,294
"cg10106289",0,0,2,0,2
"cg10106823",0,1,0,0,1
"cg10107140",0,1,0,0,1
"cg10108196",45,60,1,0,106
"cg10108252",3,11,4,0,18
"cg10108539",8,11,0,0,19
"cg10108661",0,0,1,0,1
"cg10108994",1,1,0,0,2
"cg10109590",0,1,0,0,1
"cg10110271",0,1,0,0,1
"cg10110998",2,0,0,0,2
"cg10111524",0,0,1,0,1
"cg10112420",0,1,0,0,1
"cg10112754",0,0,1,1,2
"cg10113197",0,6,8,0,14
"cg10113618",124,63,1,0,188
"cg10115022",0,0,1,0,1
"cg10115148",1,0,0,0,1
"cg10115894",0,0,1,0,1
"cg10115918",1,0,0,0,1
"cg10117171",0,0,1,0,1
"cg10117562",1,0,1,0,2
"cg10120264",0,0,1,0,1
"cg10120818",0,0,3,0,3
"cg10121058",9,1,0,0,10
"cg10121457",0,2,0,0,2
"cg10122800",16,2,0,0,18
"cg10123193",0,1,0,0,1
"cg10124011",0,0,1,0,1
"cg10124704",0,0,1,0,1
"cg10124807",0,2,0,0,2
"cg10125193",0,0,1,0,1
"cg10125522",0,3,4,0,7
"cg10127479",0,0,2,0,2
"cg10127610",0,0,2,0,2
"cg10128037",0,0,1,0,1
"cg10129404",0,0,2,0,2
"cg10130155",1,0,0,0,1
"cg10130537",0,0,1,0,1
"cg10131227",308,73,3,0,384
"cg10131604",11,4,0,0,15
"cg10132867",0,2,0,0,2
"cg10134307",0,0,1,0,1
"cg10135213",1,0,0,0,1
"cg10135427",0,1,0,0,1
"cg10138057",42,93,2,0,137
"cg10138249",0,2,0,0,2
"cg10138919",0,7,0,0,7
"cg10138977",0,9,2,0,11
"cg10139648",1,0,0,0,1
"cg10139889",0,0,1,0,1
"cg10140277",13,1,0,0,14
"cg10140383",0,1,1,0,2
"cg10141332",0,1,0,0,1
"cg10142128",1,0,0,0,1
"cg10142141",0,1,10,0,11
"cg10142179",0,1,0,0,1
"cg10142210",1,0,0,0,1
"cg10143809",0,0,1,0,1
"cg10144275",0,0,1,0,1
"cg10145297",0,1,0,0,1
"cg10146692",0,1,0,0,1
"cg10147207",0,0,2,0,2
"cg10147329",0,1,2,0,3
"cg10147634",0,0,3,0,3
"cg10148441",0,1,0,0,1
"cg10150205",4,7,3,0,14
"cg10150902",3,0,0,0,3
"cg10151314",0,1,0,0,1
"cg10151829",5,1,0,0,6
"cg10153214",2,0,0,0,2
"cg10153373",8,0,0,0,8
"cg10153892",3,0,0,0,3
"cg10154311",0,0,1,0,1
"cg10155261",0,1,0,0,1
"cg10155838",1,0,0,0,1
"cg10155929",1,1,0,0,2
"cg10157862",0,0,1,0,1
"cg10157972",0,1,3,0,4
"cg10158133",2,3,2,0,7
"cg10159922",0,2,4,0,6
"cg10160125",0,0,1,0,1
"cg10160890",4,2,0,0,6
"cg10161423",0,0,2,0,2
"cg10161675",3,0,3,0,6
"cg10161913",0,0,1,0,1
"cg10162227",0,1,0,0,1
"cg10162696",1,8,0,0,9
"cg10162747",0,0,5,0,5
"cg10163022",1,3,0,0,4
"cg10164790",2,0,0,0,2
"cg10165276",1,0,0,0,1
"cg10165474",2,1,0,0,3
"cg10166077",0,1,4,0,5
"cg10167065",3,0,0,0,3
"cg10167508",1,0,0,0,1
"cg10169323",0,1,0,0,1
"cg10169449",0,0,1,0,1
"cg10170763",2,0,0,0,2
"cg10171307",2,2,0,0,4
"cg10171720",0,0,0,1,1
"cg10172695",1,0,2,0,3
"cg10172967",1,0,0,0,1
"cg10173001",5,4,0,0,9
"cg10173724",0,2,4,0,6
"cg10173883",0,1,5,0,6
"cg10175278",0,1,10,0,11
"cg10176389",0,0,0,1,1
"cg10176587",7,1,0,0,8
"cg10176672",1,0,0,0,1
"cg10177080",0,1,0,0,1
"cg10177295",1,0,0,0,1
"cg10178062",50,4,0,0,54
"cg10178127",5,0,0,0,5
"cg10179045",0,1,3,0,4
"cg10179227",3,3,1,0,7
"cg10179518",0,6,0,0,6
"cg10180409",0,0,4,0,4
"cg10180411",1,0,2,0,3
"cg10180583",0,0,1,0,1
"cg10181555",11,0,0,0,11
"cg10182060",1,0,0,0,1
"cg10187727",2,0,0,0,2
"cg10187764",0,0,1,0,1
"cg10188253",0,1,1,0,2
"cg10188284",142,469,12,0,623
"cg10188698",91,197,258,0,546
"cg10191100",0,1,0,0,1
"cg10192038",1,0,0,0,1
"cg10192170",0,1,4,0,5
"cg10192572",0,0,1,0,1
"cg10192949",1,0,0,0,1
"cg10193420",1,3,2,0,6
"cg10193727",0,0,1,0,1
"cg10193743",14,4,0,0,18
"cg10194854",3,6,2,0,11
"cg10195200",0,1,4,0,5
"cg10195773",52,2,0,0,54
"cg10196752",2,0,0,0,2
"cg10199040",63,66,74,0,203
"cg10199763",0,0,1,0,1
"cg10199913",5,1,0,0,6
"cg10199929",0,0,1,0,1
"cg10201813",21,0,0,0,21
"cg10202544",3,0,0,0,3
"cg10202675",14,6,0,0,20
"cg10202688",1,0,0,0,1
"cg10202922",0,0,1,0,1
"cg10203223",0,0,1,0,1
"cg10204214",0,0,1,0,1
"cg10205431",1,0,0,0,1
"cg10206370",0,3,0,0,3
"cg10206440",0,1,0,0,1
"cg10206627",0,4,22,0,26
"cg10206830",31,22,4,0,57
"cg10207138",0,0,1,0,1
"cg10207152",408,27,0,0,435
"cg10207460",1,0,0,0,1
"cg10207631",0,7,26,0,33
"cg10207799",6,2,0,0,8
"cg10207917",0,0,3,0,3
"cg10208132",1,0,0,0,1
"cg10209300",126,9,0,0,135
"cg10210086",114,6,0,0,120
"cg10210150",0,1,0,0,1
"cg10210354",0,0,2,0,2
"cg10210605",187,5,0,0,192
"cg10210696",0,1,0,0,1
"cg10211061",0,2,0,0,2
"cg10211500",5,0,1,0,6
"cg10212184",109,73,3,0,185
"cg10212685",0,0,1,0,1
"cg10213633",4,1,1,0,6
"cg10213649",0,0,1,0,1
"cg10213782",0,1,0,0,1
"cg10214762",0,0,0,1,1
"cg10214896",0,0,1,0,1
"cg10216832",0,1,0,0,1
"cg10216884",3,1,0,0,4
"cg10217767",3,2,0,0,5
"cg10218519",2,0,0,0,2
"cg10218673",0,6,8,0,14
"cg10218759",0,0,1,0,1
"cg10219004",0,1,0,0,1
"cg10220850",218,130,21,0,369
"cg10221644",0,0,1,0,1
"cg10222701",0,1,0,0,1
"cg10222850",0,0,1,0,1
"cg10223155",23,1,0,0,24
"cg10223561",6,3,3,0,12
"cg10224939",53,11,1,0,65
"cg10226029",2,0,0,0,2
"cg10226218",1,1,0,0,2
"cg10226952",0,2,0,1,3
"cg10227750",2,0,0,0,2
"cg10227863",0,1,0,0,1
"cg10227934",2,0,0,0,2
"cg10228006",144,10,0,0,154
"cg10228398",1,0,0,0,1
"cg10229748",44,7,0,0,51
"cg10229899",0,1,0,0,1
"cg10231500",6,0,0,0,6
"cg10231902",0,1,0,0,1
"cg10233336",0,0,1,0,1
"cg10234069",2,0,0,0,2
"cg10234377",5,5,3,0,13
"cg10235863",0,2,0,0,2
"cg10235977",0,0,2,0,2
"cg10236528",4,4,0,0,8
"cg10236921",0,1,0,0,1
"cg10237362",12,0,0,0,12
"cg10237451",0,0,2,0,2
"cg10237814",1,0,0,0,1
"cg10238640",3,1,2,0,6
"cg10238675",1,0,0,0,1
"cg10239071",0,1,0,0,1
"cg10239257",0,1,8,0,9
"cg10239545",1,0,0,0,1
"cg10240496",1,0,1,0,2
"cg10240587",2,1,0,0,3
"cg10241005",0,0,1,0,1
"cg10241552",3,0,0,0,3
"cg10242032",0,0,1,0,1
"cg10242476",0,0,1,0,1
"cg10243196",0,1,1,0,2
"cg10243227",1,1,3,0,5
"cg10243301",1,0,0,0,1
"cg10243549",1,0,0,0,1
"cg10243591",0,1,0,0,1
"cg10244368",2,4,2,0,8
"cg10245488",20,6,0,0,26
"cg10247162",0,0,1,0,1
"cg10247252",0,0,1,0,1
"cg10247978",0,0,3,0,3
"cg10248617",1,0,0,0,1
"cg10249011",207,47,1,0,255
"cg10249904",0,2,0,0,2
"cg10250204",1,0,0,0,1
"cg10251364",5,1,1,0,7
"cg10252181",0,1,0,0,1
"cg10252249",0,0,1,0,1
"cg10252344",0,1,1,0,2
"cg10253474",1,0,0,0,1
"cg10254512",0,0,1,0,1
"cg10254578",0,1,0,0,1
"cg10255535",1,0,0,0,1
"cg10256234",0,0,1,0,1
"cg10256304",7,3,1,0,11
"cg10256519",0,1,0,0,1
"cg10257171",5,5,2,0,12
"cg10257308",0,0,2,0,2
"cg10258659",0,0,5,0,5
"cg10258767",1,0,5,0,6
"cg10258860",2,2,2,0,6
"cg10259719",1,0,0,0,1
"cg10260115",0,2,0,0,2
"cg10260440",218,278,44,0,540
"cg10261003",1,0,0,0,1
"cg10261819",0,2,1,0,3
"cg10262188",0,1,0,0,1
"cg10262357",2,0,0,0,2
"cg10262441",1,0,0,0,1
"cg10262955",0,0,1,0,1
"cg10263737",0,1,0,0,1
"cg10265911",2,1,0,0,3
"cg10266099",0,0,1,0,1
"cg10266336",0,1,0,0,1
"cg10266904",0,0,2,0,2
"cg10267698",0,0,1,0,1
"cg10267809",0,0,1,0,1
"cg10268290",0,1,0,0,1
"cg10269063",0,1,0,0,1
"cg10269301",0,0,3,0,3
"cg10269487",0,0,4,0,4
"cg10269560",0,1,0,0,1
"cg10270436",15,14,3,0,32
"cg10271315",0,1,0,0,1
"cg10271831",3,0,0,0,3
"cg10271915",1,0,0,0,1
"cg10272131",1,0,0,0,1
"cg10272336",0,1,0,0,1
"cg10273152",191,574,21,0,786
"cg10273538",61,25,2,0,88
"cg10273899",1,3,7,0,11
"cg10274682",1,0,1,0,2
"cg10275180",2,0,1,0,3
"cg10275183",1,0,0,0,1
"cg10276333",0,5,0,0,5
"cg10276461",1,0,0,0,1
"cg10277548",0,1,1,0,2
"cg10278506",6,0,0,0,6
"cg10278931",0,1,0,0,1
"cg10278962",11,2,0,0,13
"cg10280325",0,0,1,0,1
"cg10280423",5,6,0,0,11
"cg10280535",0,1,0,0,1
"cg10280683",0,0,1,0,1
"cg10280806",0,0,1,0,1
"cg10281502",0,0,1,0,1
"cg10281852",4,3,3,0,10
"cg10281911",0,10,3,0,13
"cg10281936",0,0,2,0,2
"cg10282899",5,2,0,0,7
"cg10282945",0,1,0,0,1
"cg10283364",1,4,0,0,5
"cg10283879",0,0,1,0,1
"cg10284144",1,6,0,0,7
"cg10285798",0,0,1,0,1
"cg10285873",0,0,1,0,1
"cg10286579",0,1,1,0,2
"cg10287829",2,0,0,0,2
"cg10288030",47,39,1,0,87
"cg10288118",13,14,3,0,30
"cg10288214",0,0,1,0,1
"cg10289838",1,0,0,0,1
"cg10290908",170,15,0,0,185
"cg10291138",0,0,1,0,1
"cg10291823",0,0,1,0,1
"cg10292510",79,36,1,0,116
"cg10293230",2,0,0,0,2
"cg10294960",0,1,0,0,1
"cg10295126",3,1,0,0,4
"cg10295683",209,23,1,0,233
"cg10295955",7,9,6,0,22
"cg10296027",1,0,0,0,1
"cg10297088",88,1,0,0,89
"cg10298381",0,0,3,0,3
"cg10298491",15,10,3,0,28
"cg10298507",1,0,0,0,1
"cg10300464",1,0,0,0,1
"cg10301644",14,2,0,0,16
"cg10301660",3,0,0,0,3
"cg10301801",0,0,3,0,3
"cg10303749",0,1,0,0,1
"cg10303912",0,0,0,1,1
"cg10304375",1,0,0,0,1
"cg10305454",0,0,2,0,2
"cg10306028",0,0,1,0,1
"cg10306210",2,1,0,0,3
"cg10306757",0,3,3,0,6
"cg10307051",31,0,0,0,31
"cg10309425",4,0,0,0,4
"cg10309454",0,0,4,0,4
"cg10311680",1,0,4,0,5
"cg10312101",6,0,0,0,6
"cg10312190",3,19,4,0,26
"cg10312566",2,3,4,0,9
"cg10312875",2,2,0,0,4
"cg10314857",6,6,0,0,12
"cg10315120",0,0,1,0,1
"cg10315962",0,1,0,0,1
"cg10316662",3,7,18,0,28
"cg10316742",0,2,0,0,2
"cg10317162",0,1,0,0,1
"cg10317301",0,0,1,0,1
"cg10318359",0,0,1,0,1
"cg10318871",5,0,0,0,5
"cg10319493",1,0,1,0,2
"cg10320211",80,33,3,0,116
"cg10320410",7,2,0,0,9
"cg10320659",0,0,1,0,1
"cg10321714",2,1,0,0,3
"cg10323962",0,0,1,0,1
"cg10324329",1,1,7,0,9
"cg10324365",3,0,1,0,4
"cg10324630",0,1,0,0,1
"cg10325624",0,0,1,0,1
"cg10326073",24,2,1,0,27
"cg10326224",0,0,1,0,1
"cg10327250",1,0,0,0,1
"cg10327424",2,0,0,0,2
"cg10327881",2,0,0,0,2
"cg10327976",13,1,0,0,14
"cg10328297",2,0,0,0,2
"cg10328377",0,0,1,0,1
"cg10328513",8,4,0,0,12
"cg10329699",52,1,0,0,53
"cg10331989",0,0,5,0,5
"cg10332715",0,0,1,0,1
"cg10332723",0,1,1,0,2
"cg10332934",0,0,1,0,1
"cg10333051",1,1,1,0,3
"cg10334648",6,0,0,0,6
"cg10334659",2,0,0,0,2
"cg10335217",0,1,4,0,5
"cg10336578",5,3,0,0,8
"cg10337668",0,0,1,0,1
"cg10337925",0,0,1,0,1
"cg10338829",0,2,1,0,3
"cg10339067",0,0,2,0,2
"cg10339593",0,2,19,0,21
"cg10339665",0,1,0,0,1
"cg10339717",0,1,0,0,1
"cg10339911",1,0,0,0,1
"cg10340263",0,0,1,0,1
"cg10340413",0,0,1,0,1
"cg10340681",0,1,3,0,4
"cg10340872",235,3,0,0,238
"cg10340916",0,0,0,1,1
"cg10341310",0,1,0,0,1
"cg10342590",1,0,1,0,2
"cg10342663",0,0,2,0,2
"cg10342841",0,1,1,0,2
"cg10345007",0,0,1,0,1
"cg10345499",1,0,0,0,1
"cg10346077",0,1,0,0,1
"cg10346147",203,9,0,0,212
"cg10346475",123,83,11,0,217
"cg10346740",1,1,0,0,2
"cg10347290",0,0,1,0,1
"cg10347555",0,0,1,0,1
"cg10347635",0,1,0,0,1
"cg10348178",5,2,0,0,7
"cg10349318",6,0,1,0,7
"cg10350008",1,0,0,0,1
"cg10351349",6,0,0,0,6
"cg10351815",0,2,0,0,2
"cg10352025",2,2,0,0,4
"cg10353737",0,0,1,0,1
"cg10353789",0,1,0,0,1
"cg10354369",92,89,14,0,195
"cg10354811",0,1,0,0,1
"cg10356284",0,1,0,0,1
"cg10356429",0,0,1,0,1
"cg10356657",0,0,1,0,1
"cg10356706",0,0,1,0,1
"cg10358630",18,43,11,0,72
"cg10359235",0,0,2,0,2
"cg10360292",0,2,0,0,2
"cg10361060",12,7,3,0,22
"cg10361589",0,0,0,1,1
"cg10362685",10,0,0,0,10
"cg10362692",167,133,3,0,303
"cg10364153",0,1,0,0,1
"cg10365889",0,0,2,0,2
"cg10366647",1,0,0,0,1
"cg10368834",0,0,1,0,1
"cg10369313",122,716,6,0,844
"cg10369444",221,180,9,0,410
"cg10369955",0,0,1,0,1
"cg10370650",0,1,3,0,4
"cg10370729",7,2,0,0,9
"cg10371057",0,0,1,0,1
"cg10371677",0,0,1,0,1
"cg10372473",323,14,0,0,337
"cg10372701",0,1,1,0,2
"cg10373524",0,0,1,0,1
"cg10375870",0,0,1,0,1
"cg10376904",0,1,0,0,1
"cg10378054",6,12,10,0,28
"cg10379653",1,0,0,0,1
"cg10380165",0,1,0,0,1
"cg10380289",0,0,2,0,2
"cg10380674",40,620,77,0,737
"cg10381055",56,16,2,0,74
"cg10381451",0,1,0,0,1
"cg10381880",5,4,1,0,10
"cg10382653",1,0,1,0,2
"cg10383018",19,1,0,0,20
"cg10383396",1,0,0,0,1
"cg10383549",6,1,0,0,7
"cg10384538",3,3,1,0,7
"cg10384788",8,7,0,0,15
"cg10386096",1,0,0,0,1
"cg10388349",0,1,0,0,1
"cg10388456",0,0,1,0,1
"cg10388667",1,0,0,0,1
"cg10389584",0,1,0,0,1
"cg10389789",0,1,0,0,1
"cg10390329",0,1,0,0,1
"cg10390696",2,0,0,0,2
"cg10390926",0,0,1,0,1
"cg10392614",1,1,1,0,3
"cg10393227",0,1,0,0,1
"cg10395920",1,0,0,0,1
"cg10396673",1,0,1,0,2
"cg10396927",4,0,0,0,4
"cg10398502",23,19,2,0,44
"cg10400944",3,0,0,0,3
"cg10401027",1,0,0,0,1
"cg10401311",17,3,0,0,20
"cg10401541",0,0,2,0,2
"cg10402023",0,1,0,0,1
"cg10403441",1,0,0,0,1
"cg10404764",0,0,1,0,1
"cg10405333",1,0,1,0,2
"cg10406470",172,18,1,0,191
"cg10407637",0,0,1,0,1
"cg10407847",0,0,2,0,2
"cg10408731",1,0,0,0,1
"cg10409327",1,2,1,0,4
"cg10409443",0,0,3,0,3
"cg10410239",0,0,1,0,1
"cg10410904",1,0,0,0,1
"cg10411062",1,0,0,0,1
"cg10411658",0,3,0,0,3
"cg10412384",0,2,0,0,2
"cg10412408",0,1,0,0,1
"cg10413161",0,0,1,0,1
"cg10414717",0,5,0,0,5
"cg10415122",7,1,1,0,9
"cg10415664",0,0,1,0,1
"cg10416225",0,0,1,0,1
"cg10416727",0,1,0,0,1
"cg10416958",0,0,1,0,1
"cg10417217",0,1,0,0,1
"cg10417456",391,812,34,0,1237
"cg10418139",0,0,1,0,1
"cg10418237",1,0,0,0,1
"cg10420044",5,0,0,0,5
"cg10420063",0,1,2,0,3
"cg10420113",2,1,0,0,3
"cg10420532",0,0,1,0,1
"cg10420783",4,0,0,0,4
"cg10420989",151,56,3,0,210
"cg10421808",1,0,0,0,1
"cg10421844",0,0,1,0,1
"cg10421990",2,0,0,0,2
"cg10424442",1,0,0,0,1
"cg10424752",182,8,0,0,190
"cg10424795",14,3,0,0,17
"cg10424892",0,0,1,0,1
"cg10425513",0,0,1,0,1
"cg10425970",9,0,0,0,9
"cg10426017",0,1,0,0,1
"cg10426105",1,0,0,0,1
"cg10426482",0,0,5,0,5
"cg10426778",0,1,3,0,4
"cg10427295",0,0,1,0,1
"cg10429096",1,1,0,0,2
"cg10429580",0,0,2,0,2
"cg10430189",27,19,0,0,46
"cg10430362",0,1,0,0,1
"cg10430428",0,1,0,0,1
"cg10430444",0,1,0,0,1
"cg10430776",1,2,0,0,3
"cg10431365",2,0,0,0,2
"cg10431842",1,1,0,0,2
"cg10431857",1,0,0,0,1
"cg10432423",0,0,1,0,1
"cg10432933",0,1,0,0,1
"cg10433390",3,1,0,0,4
"cg10433438",1,0,0,0,1
"cg10433831",1,0,0,0,1
"cg10434733",6,10,2,0,18
"cg10434797",0,0,2,0,2
"cg10434814",1,5,0,0,6
"cg10434824",5,0,0,0,5
"cg10434881",15,21,11,0,47
"cg10435092",1,0,0,0,1
"cg10435184",0,0,1,0,1
"cg10435376",0,1,1,0,2
"cg10435816",1,0,0,0,1
"cg10436286",7,3,4,0,14
"cg10436546",0,1,0,0,1
"cg10436833",0,0,1,0,1
"cg10439283",2,0,0,0,2
"cg10439742",1,0,0,0,1
"cg10439896",0,2,0,0,2
"cg10439914",0,0,1,0,1
"cg10440956",1,0,0,0,1
"cg10441094",12,0,0,0,12
"cg10441192",1,0,0,0,1
"cg10441640",0,1,0,0,1
"cg10441789",0,1,0,0,1
"cg10443068",52,36,2,0,90
"cg10443315",0,1,0,0,1
"cg10444058",0,2,4,0,6
"cg10444215",5,14,7,0,26
"cg10444717",0,0,1,0,1
"cg10445527",1,9,7,0,17
"cg10445708",10,1,0,0,11
"cg10446746",9,1,0,0,10
"cg10447247",0,1,0,0,1
"cg10448687",60,503,73,0,636
"cg10449561",0,0,1,0,1
"cg10450005",3,1,0,0,4
"cg10450108",2,1,1,0,4
"cg10450887",21,1,0,0,22
"cg10451200",0,0,1,0,1
"cg10451941",0,1,0,0,1
"cg10451977",1,6,1,0,8
"cg10452282",0,0,1,0,1
"cg10452588",0,1,0,0,1
"cg10456168",2,0,0,0,2
"cg10456345",9,0,1,0,10
"cg10457005",1,0,0,0,1
"cg10457119",3,0,0,0,3
"cg10457409",1,1,0,0,2
"cg10457622",0,1,0,0,1
"cg10460024",0,0,3,0,3
"cg10460284",0,1,0,0,1
"cg10460554",0,1,0,0,1
"cg10460838",1,0,0,0,1
"cg10461282",0,0,1,0,1
"cg10461292",0,1,0,0,1
"cg10462048",3,1,0,0,4
"cg10462585",1,0,0,0,1
"cg10462593",1,5,2,0,8
"cg10462970",0,1,0,0,1
"cg10464748",15,1,0,0,16
"cg10464800",1,0,0,0,1
"cg10465285",0,1,0,0,1
"cg10465579",0,0,1,0,1
"cg10466221",18,1,0,0,19
"cg10466351",2,0,0,0,2
"cg10466938",0,7,6,0,13
"cg10467926",0,0,1,0,1
"cg10468761",0,0,1,0,1
"cg10469659",1,0,0,0,1
"cg10470359",1,0,0,0,1
"cg10470697",0,0,2,0,2
"cg10473022",2,0,0,0,2
"cg10473581",0,1,0,0,1
"cg10473780",0,1,3,0,4
"cg10473787",0,2,5,0,7
"cg10474284",8,1,0,0,9
"cg10474631",1,0,0,0,1
"cg10474637",0,1,0,0,1
"cg10475056",3,0,0,0,3
"cg10476539",2,1,0,0,3
"cg10476682",1,0,0,0,1
"cg10477193",1,0,0,0,1
"cg10477313",0,1,1,0,2
"cg10477409",0,1,5,2,8
"cg10478236",0,0,0,2,2
"cg10478237",1,0,0,0,1
"cg10478321",1,0,0,0,1
"cg10478740",1,0,0,0,1
"cg10478863",106,5,0,0,111
"cg10480169",2,0,0,0,2
"cg10480718",1,0,0,0,1
"cg10480950",0,0,1,0,1
"cg10481328",64,24,0,0,88
"cg10483333",4,2,0,0,6
"cg10483393",0,1,1,0,2
"cg10483475",5,2,2,0,9
"cg10483817",13,17,5,0,35
"cg10484848",0,0,2,0,2
"cg10485638",0,0,2,0,2
"cg10485687",761,124,3,0,888
"cg10485774",4,0,0,0,4
"cg10486098",2,2,0,0,4
"cg10487306",0,2,0,0,2
"cg10488260",1,0,0,0,1
"cg10488267",0,2,1,0,3
"cg10488777",0,0,1,0,1
"cg10490473",5,1,1,0,7
"cg10490742",0,1,0,0,1
"cg10490880",1,0,0,0,1
"cg10492650",0,7,0,0,7
"cg10493162",0,0,1,0,1
"cg10493548",0,1,0,0,1
"cg10494770",1,0,0,0,1
"cg10497951",11,4,0,0,15
"cg10498391",3,1,0,0,4
"cg10499577",0,0,1,0,1
"cg10499879",0,0,1,0,1
"cg10499910",0,0,1,0,1
"cg10500581",1,0,0,0,1
"cg10501020",0,1,0,0,1
"cg10502655",1,0,0,0,1
"cg10502823",1,1,0,0,2
"cg10502924",0,2,0,0,2
"cg10503008",0,2,0,0,2
"cg10503203",1,0,0,0,1
"cg10503283",363,686,14,0,1063
"cg10503649",0,3,5,0,8
"cg10503842",0,0,1,0,1
"cg10504120",2,0,0,0,2
"cg10505902",0,0,1,0,1
"cg10506070",5,1,0,0,6
"cg10508022",2,0,1,0,3
"cg10508780",2,0,0,0,2
"cg10514510",195,82,2,0,279
"cg10514593",2,1,2,0,5
"cg10515439",77,130,723,0,930
"cg10515465",2,0,11,0,13
"cg10515630",2,1,0,0,3
"cg10515720",0,0,1,0,1
"cg10515950",4,3,1,0,8
"cg10516204",722,112,1,0,835
"cg10516386",54,31,5,0,90
"cg10517050",1,0,0,0,1
"cg10517176",0,1,0,0,1
"cg10518366",27,2,0,0,29
"cg10518593",31,1,0,0,32
"cg10518816",0,1,0,0,1
"cg10519310",0,1,0,0,1
"cg10519631",4,1,2,0,7
"cg10520591",0,2,3,0,5
"cg10521510",21,3,0,0,24
"cg10522326",0,0,1,0,1
"cg10522785",0,0,1,0,1
"cg10522818",0,0,1,0,1
"cg10523411",1,2,1,0,4
"cg10523757",1,0,0,0,1
"cg10523807",450,55,3,0,508
"cg10524895",0,0,1,0,1
"cg10525945",1,0,0,0,1
"cg10526795",12,0,0,0,12
"cg10527302",1,0,0,0,1
"cg10527606",1,0,0,0,1
"cg10529762",1,1,0,0,2
"cg10531372",0,1,0,0,1
"cg10531521",296,226,7,0,529
"cg10532219",1,0,0,0,1
"cg10533493",68,30,2,0,100
"cg10533739",0,0,1,0,1
"cg10533907",0,1,0,0,1
"cg10534007",0,0,1,0,1
"cg10534425",2,0,0,0,2
"cg10534638",2,0,0,0,2
"cg10535426",1,0,0,0,1
"cg10535725",1,0,0,0,1
"cg10536081",22,0,0,0,22
"cg10536554",46,3,0,0,49
"cg10537017",11,0,0,0,11
"cg10537247",24,12,0,0,36
"cg10537532",0,1,0,0,1
"cg10537820",1,3,9,0,13
"cg10539670",0,0,1,0,1
"cg10542223",0,1,0,0,1
"cg10542672",1,0,0,0,1
"cg10543195",16,7,0,0,23
"cg10543308",757,203,4,0,964
"cg10543376",1,0,0,0,1
"cg10543953",0,1,1,0,2
"cg10544839",15,1,0,0,16
"cg10546542",2,0,0,0,2
"cg10546603",0,0,7,0,7
"cg10547482",73,11,0,0,84
"cg10547487",0,0,1,0,1
"cg10548292",3,0,0,0,3
"cg10548669",0,1,0,0,1
"cg10549641",352,1034,62,0,1448
"cg10549789",4,0,0,0,4
"cg10549974",0,0,3,0,3
"cg10550182",8,4,0,0,12
"cg10550471",3,0,0,0,3
"cg10551016",0,1,0,0,1
"cg10551556",181,28,1,0,210
"cg10554639",0,0,1,0,1
"cg10554825",2,0,0,0,2
"cg10555000",129,3,0,0,132
"cg10555519",0,2,0,0,2
"cg10555985",0,0,1,0,1
"cg10556772",0,1,0,0,1
"cg10557139",1,9,9,0,19
"cg10559517",62,5,0,0,67
"cg10559778",0,1,0,0,1
"cg10560052",0,0,2,0,2
"cg10561091",0,6,0,0,6
"cg10561556",0,1,0,0,1
"cg10561600",2,0,0,0,2
"cg10562414",11,1,0,0,12
"cg10562442",0,0,1,0,1
"cg10563561",1,1,0,0,2
"cg10563643",442,110,89,0,641
"cg10563834",0,0,0,1,1
"cg10563971",0,1,0,0,1
"cg10564285",0,0,1,0,1
"cg10564301",3,0,0,0,3
"cg10564356",3,8,4,0,15
"cg10564826",1,0,0,0,1
"cg10565256",0,0,1,0,1
"cg10567325",0,0,0,1,1
"cg10567975",0,1,0,0,1
"cg10569112",1,1,0,0,2
"cg10569471",1,0,0,0,1
"cg10569694",1,0,0,0,1
"cg10571627",1,0,0,0,1
"cg10571993",1,0,0,0,1
"cg10572125",0,1,0,0,1
"cg10572624",1,1,0,0,2
"cg10573136",12,2,0,0,14
"cg10573450",1,1,0,0,2
"cg10573731",4,0,0,0,4
"cg10573839",0,1,0,0,1
"cg10574132",0,0,1,0,1
"cg10574944",0,0,2,0,2
"cg10575686",1,0,1,0,2
"cg10575940",2,0,0,0,2
"cg10576459",1,0,0,0,1
"cg10576878",1,1,0,0,2
"cg10577586",5,0,0,0,5
"cg10578897",3,0,0,0,3
"cg10580549",1,4,0,0,5
"cg10581188",1,0,0,0,1
"cg10581227",0,1,0,0,1
"cg10581503",151,3,0,0,154
"cg10581631",0,0,1,0,1
"cg10582804",0,0,1,0,1
"cg10583893",0,1,0,0,1
"cg10584427",1,0,0,0,1
"cg10584563",1,0,0,0,1
"cg10584610",0,0,2,0,2
"cg10585733",7,2,0,0,9
"cg10586837",1,0,0,0,1
"cg10587047",0,0,1,0,1
"cg10587621",0,0,1,0,1
"cg10587959",69,4,0,0,73
"cg10588829",0,1,0,0,1
"cg10589137",1,0,0,0,1
"cg10589146",1,0,0,0,1
"cg10589782",33,19,1,0,53
"cg10590095",166,35,2,0,203
"cg10590549",636,34,0,0,670
"cg10590844",0,2,0,0,2
"cg10591111",0,1,2,0,3
"cg10591322",0,0,1,0,1
"cg10591408",99,116,15,0,230
"cg10591605",5,0,0,0,5
"cg10593256",2,1,0,0,3
"cg10594743",4,2,1,0,7
"cg10595298",2,1,1,0,4
"cg10595913",1,0,0,0,1
"cg10596252",2,0,0,0,2
"cg10596977",2,1,0,0,3
"cg10597133",0,0,1,0,1
"cg10597337",3,2,0,0,5
"cg10597558",0,10,6,0,16
"cg10598776",0,1,0,0,1
"cg10600242",15,12,0,0,27
"cg10600851",4,5,0,0,9
"cg10601270",0,0,3,0,3
"cg10601548",0,2,0,0,2
"cg10601749",0,1,0,0,1
"cg10602757",0,0,5,0,5
"cg10602908",8,16,13,0,37
"cg10603719",3,2,0,0,5
"cg10604746",5,0,0,0,5
"cg10606059",0,0,1,0,1
"cg10608333",0,0,1,0,1
"cg10608731",0,0,1,0,1
"cg10609241",0,1,0,0,1
"cg10609300",2,0,0,0,2
"cg10609310",0,1,0,0,1
"cg10609677",1,0,0,0,1
"cg10610244",1,2,0,0,3
"cg10611221",0,0,1,0,1
"cg10612060",1,0,0,0,1
"cg10613894",1,1,0,0,2
"cg10613962",1,0,0,0,1
"cg10615585",5,4,0,0,9
"cg10615662",2,0,0,0,2
"cg10615711",0,0,4,0,4
"cg10617192",0,0,1,0,1
"cg10618450",0,0,1,0,1
"cg10618578",20,14,0,0,34
"cg10619129",12,2,0,0,14
"cg10619344",3,0,0,0,3
"cg10620305",6,3,0,0,9
"cg10621377",0,0,0,1,1
"cg10622068",13,0,0,0,13
"cg10622684",448,52,0,0,500
"cg10622741",0,1,0,0,1
"cg10624203",1,1,0,0,2
"cg10625750",30,4,0,0,34
"cg10626623",0,0,2,0,2
"cg10627006",99,11,0,0,110
"cg10627076",1,0,0,0,1
"cg10627913",1,0,0,0,1
"cg10629793",0,2,0,0,2
"cg10630893",0,0,1,0,1
"cg10631074",0,0,2,0,2
"cg10631225",14,12,25,0,51
"cg10631453",0,0,6,0,6
"cg10631854",0,0,3,0,3
"cg10631902",2,2,4,0,8
"cg10632031",1,0,0,0,1
"cg10632439",0,0,1,0,1
"cg10632656",1,0,0,0,1
"cg10633576",0,1,0,0,1
"cg10635055",0,0,1,0,1
"cg10635686",52,13,1,0,66
"cg10635719",236,29,4,0,269
"cg10636054",1,0,1,0,2
"cg10637337",0,0,1,0,1
"cg10638993",0,0,1,0,1
"cg10639394",0,1,4,0,5
"cg10639497",4,0,0,0,4
"cg10640049",1,0,0,0,1
"cg10640830",1,0,0,0,1
"cg10642295",1,0,0,0,1
"cg10642644",3,3,1,0,7
"cg10643608",751,446,4,0,1201
"cg10644424",0,0,1,0,1
"cg10644878",1,0,1,0,2
"cg10645317",3,5,3,0,11
"cg10646115",0,0,1,0,1
"cg10646653",0,0,1,0,1
"cg10646950",0,0,1,0,1
"cg10646962",7,0,0,0,7
"cg10647105",4,1,0,0,5
"cg10647117",1,0,0,0,1
"cg10647513",0,0,1,0,1
"cg10648125",0,0,1,0,1
"cg10649697",21,0,0,0,21
"cg10649865",0,0,1,0,1
"cg10649903",0,3,8,0,11
"cg10651695",2,0,0,0,2
"cg10652558",0,0,1,0,1
"cg10652662",0,0,0,1,1
"cg10652780",1,0,0,0,1
"cg10653221",0,0,1,0,1
"cg10654280",3,0,1,0,4
"cg10655046",0,0,3,0,3
"cg10655847",0,0,1,0,1
"cg10656359",1,0,0,0,1
"cg10656643",1,0,0,0,1
"cg10656811",1,0,0,0,1
"cg10657465",28,3,0,0,31
"cg10657612",1,0,0,0,1
"cg10657866",0,0,1,0,1
"cg10658205",0,0,1,0,1
"cg10658627",0,1,0,0,1
"cg10659495",1,0,0,0,1
"cg10659748",10,2,0,0,12
"cg10660913",0,1,0,0,1
"cg10661464",1,0,0,0,1
"cg10661558",0,2,0,0,2
"cg10661817",2,1,0,0,3
"cg10661844",1,0,0,0,1
"cg10662172",0,0,1,0,1
"cg10662242",0,1,0,0,1
"cg10662295",2,1,0,0,3
"cg10663140",0,0,1,0,1
"cg10663180",0,0,1,0,1
"cg10664780",3,0,0,0,3
"cg10665390",2,4,0,0,6
"cg10665490",0,0,1,0,1
"cg10666140",4,0,0,0,4
"cg10667394",6,12,2,0,20
"cg10667489",0,0,1,0,1
"cg10667969",1,1,0,0,2
"cg10668452",12,0,0,0,12
"cg10669449",1,0,0,0,1
"cg10669878",1,0,2,0,3
"cg10670246",3,6,0,0,9
"cg10670396",1,0,0,0,1
"cg10670869",17,12,0,0,29
"cg10673248",2,0,4,0,6
"cg10673328",0,0,1,0,1
"cg10673544",2,13,12,0,27
"cg10673915",56,69,3,0,128
"cg10674575",0,1,0,0,1
"cg10674889",0,1,0,0,1
"cg10675006",0,0,1,0,1
"cg10675049",1,1,4,0,6
"cg10675515",7,0,0,0,7
"cg10676438",13,1,0,0,14
"cg10677245",0,1,0,0,1
"cg10677688",209,367,46,0,622
"cg10677787",0,0,1,0,1
"cg10677828",0,0,1,0,1
"cg10678908",2,0,0,0,2
"cg10678937",0,1,0,0,1
"cg10679226",0,0,4,0,4
"cg10680164",8,0,0,0,8
"cg10680488",1,1,0,0,2
"cg10681811",1,2,0,0,3
"cg10682576",864,156,2,0,1022
"cg10689441",412,184,3,0,599
"cg10690082",239,958,247,0,1444
"cg10690677",1,0,0,0,1
"cg10692693",2,0,0,0,2
"cg10692869",2,1,0,0,3
"cg10692878",0,0,1,0,1
"cg10693062",0,0,1,0,1
"cg10693635",1,0,0,0,1
"cg10694761",0,0,1,0,1
"cg10695761",1,0,6,0,7
"cg10698327",4,2,0,0,6
"cg10699986",0,2,3,0,5
"cg10700126",10,1,0,0,11
"cg10700270",4,1,0,0,5
"cg10700459",1,1,0,0,2
"cg10701000",1,0,0,0,1
"cg10701253",43,6,0,0,49
"cg10701607",2,0,0,0,2
"cg10701847",4,1,0,0,5
"cg10702283",0,1,0,0,1
"cg10702450",1,0,0,0,1
"cg10703475",0,1,2,0,3
"cg10704137",0,8,10,0,18
"cg10704457",479,528,11,0,1018
"cg10704966",5,0,0,0,5
"cg10705784",0,1,0,0,1
"cg10706082",1,0,2,0,3
"cg10707794",14,2,2,0,18
"cg10709331",18,4,0,0,22
"cg10709378",0,0,1,0,1
"cg10709708",0,0,1,0,1
"cg10709785",0,3,1,0,4
"cg10710425",0,0,1,0,1
"cg10710468",1,2,0,0,3
"cg10710993",0,0,1,0,1
"cg10711022",0,6,11,0,17
"cg10711255",3,0,1,0,4
"cg10711475",0,1,0,0,1
"cg10711974",1,0,0,0,1
"cg10712044",135,133,13,0,281
"cg10712263",1,0,1,0,2
"cg10712742",0,1,0,0,1
"cg10712902",0,0,0,1,1
"cg10713580",0,0,2,0,2
"cg10714111",0,2,0,0,2
"cg10715161",0,0,1,0,1
"cg10715820",2,1,0,0,3
"cg10716768",0,0,2,0,2
"cg10717480",0,0,2,0,2
"cg10717907",0,0,1,0,1
"cg10718697",0,1,0,0,1
"cg10719746",1,0,0,0,1
"cg10720418",10,4,1,0,15
"cg10720652",0,1,0,0,1
"cg10721997",0,0,3,0,3
"cg10722175",0,0,1,0,1
"cg10725048",662,476,5,0,1143
"cg10725943",0,6,0,0,6
"cg10728179",0,1,0,0,1
"cg10728822",0,0,1,0,1
"cg10729852",0,1,0,0,1
"cg10730425",0,0,12,0,12
"cg10731478",1,0,0,0,1
"cg10733323",0,0,1,0,1
"cg10733677",0,0,2,0,2
"cg10734114",1,0,0,0,1
"cg10734448",1,0,0,0,1
"cg10734604",0,0,1,0,1
"cg10735116",0,0,1,0,1
"cg10735211",0,0,2,0,2
"cg10735792",1,0,0,0,1
"cg10736786",80,3,0,0,83
"cg10737406",1,0,0,0,1
"cg10737663",0,0,3,0,3
"cg10739791",0,1,0,0,1
"cg10741379",0,0,1,0,1
"cg10744268",329,71,0,0,400
"cg10744588",0,0,1,0,1
"cg10747139",1,0,0,0,1
"cg10747256",0,0,6,0,6
"cg10747758",112,130,17,0,259
"cg10748891",0,0,1,0,1
"cg10749409",108,4,0,0,112
"cg10749607",0,0,1,0,1
"cg10751385",0,1,0,0,1
"cg10751605",0,0,2,0,2
"cg10751726",0,0,1,0,1
"cg10753343",1,1,0,0,2
"cg10753398",2,0,0,0,2
"cg10753423",0,0,1,0,1
"cg10754670",0,2,0,0,2
"cg10755884",1,2,1,0,4
"cg10756856",0,0,1,0,1
"cg10758057",0,1,0,0,1
"cg10758267",1,0,0,0,1
"cg10759572",343,11,0,0,354
"cg10760023",1,3,1,0,5
"cg10760508",1,0,0,0,1
"cg10760651",3,1,0,0,4
"cg10760823",36,2,0,0,38
"cg10761028",0,0,1,0,1
"cg10761368",2,0,0,0,2
"cg10761412",0,0,1,0,1
"cg10761807",0,1,0,0,1
"cg10763048",0,1,1,0,2
"cg10764809",0,0,1,0,1
"cg10765144",3,1,0,0,4
"cg10765147",0,0,1,0,1
"cg10765922",0,1,0,0,1
"cg10766127",0,1,0,0,1
"cg10766172",0,0,1,0,1
"cg10766226",3,4,1,0,8
"cg10767295",0,0,1,0,1
"cg10767312",1,2,0,0,3
"cg10767579",6,0,0,0,6
"cg10769313",1,0,0,0,1
"cg10769570",1,0,0,0,1
"cg10771048",1,0,0,0,1
"cg10773928",0,1,0,0,1
"cg10774155",0,0,1,0,1
"cg10774181",1,0,0,0,1
"cg10774367",317,96,1,0,414
"cg10774586",0,0,1,0,1
"cg10774802",2,0,0,0,2
"cg10774808",1,0,0,0,1
"cg10777178",6,0,0,0,6
"cg10777388",0,1,0,0,1
"cg10777407",0,0,6,0,6
"cg10777678",0,0,8,0,8
"cg10777881",0,0,3,0,3
"cg10778415",0,1,0,0,1
"cg10778931",26,8,0,0,34
"cg10779777",0,0,4,0,4
"cg10780313",71,197,5,0,273
"cg10780525",0,1,0,0,1
"cg10781752",0,1,0,0,1
"cg10781942",11,3,0,0,14
"cg10783645",1,1,0,0,2
"cg10783948",0,0,1,0,1
"cg10784548",2,0,0,0,2
"cg10786880",1,0,0,0,1
"cg10787614",29,10,0,0,39
"cg10790704",0,0,1,0,1
"cg10792227",110,125,44,0,279
"cg10792544",0,1,0,0,1
"cg10792548",1,0,0,0,1
"cg10792935",2,0,0,0,2
"cg10793683",0,0,1,0,1
"cg10793705",0,0,0,1,1
"cg10795119",4,1,0,0,5
"cg10795676",1,1,0,0,2
"cg10796141",1,0,1,0,2
"cg10796889",0,0,1,0,1
"cg10797550",8,4,1,0,13
"cg10800261",0,0,1,0,1
"cg10800519",130,72,5,0,207
"cg10801192",0,1,0,0,1
"cg10801238",1,0,0,0,1
"cg10801418",7,1,6,0,14
"cg10802593",0,0,1,0,1
"cg10802894",0,0,1,0,1
"cg10802977",0,0,3,0,3
"cg10803296",0,2,0,0,2
"cg10805220",2,0,4,0,6
"cg10805856",2,3,0,0,5
"cg10806217",0,1,0,0,1
"cg10806459",0,0,1,0,1
"cg10806562",1,4,0,0,5
"cg10807461",1,0,0,0,1
"cg10809193",0,2,2,0,4
"cg10809498",251,665,11,0,927
"cg10809872",7,0,0,0,7
"cg10811509",11,8,1,0,20
"cg10813891",0,0,1,0,1
"cg10814202",48,9,0,0,57
"cg10814364",3,11,4,0,18
"cg10814415",0,0,1,0,1
"cg10815343",0,0,1,0,1
"cg10817408",157,358,46,0,561
"cg10818901",0,1,11,0,12
"cg10819484",4,4,0,0,8
"cg10819684",0,0,1,0,1
"cg10819992",1,1,1,0,3
"cg10820191",1,0,0,0,1
"cg10820262",0,0,2,0,2
"cg10821128",0,0,1,0,1
"cg10821132",3,0,0,0,3
"cg10822391",0,0,1,0,1
"cg10822421",3,0,0,0,3
"cg10824697",1,0,0,0,1
"cg10824722",0,0,2,0,2
"cg10825189",22,6,0,0,28
"cg10825481",1,0,0,0,1
"cg10826786",1,3,3,0,7
"cg10828060",0,0,1,0,1
"cg10828253",0,0,4,0,4
"cg10828910",1,1,2,0,4
"cg10829024",0,1,0,0,1
"cg10830344",1,2,1,0,4
"cg10833829",483,21,0,0,504
"cg10834597",4,0,0,0,4
"cg10836082",24,6,0,0,30
"cg10836120",1,1,0,0,2
"cg10836250",1,0,0,0,1
"cg10836402",0,1,0,0,1
"cg10836477",2,0,0,0,2
"cg10836661",0,0,2,0,2
"cg10836768",721,32,0,0,753
"cg10837251",0,0,2,0,2
"cg10837488",6,9,5,0,20
"cg10839128",294,200,23,0,517
"cg10839488",0,1,0,0,1
"cg10839684",1,0,0,0,1
"cg10839997",0,0,7,0,7
"cg10840615",51,3,0,0,54
"cg10842008",15,15,2,0,32
"cg10842341",1,0,0,0,1
"cg10842775",64,40,6,0,110
"cg10844190",5,3,0,0,8
"cg10844272",0,0,3,0,3
"cg10844279",2,0,0,0,2
"cg10844422",0,0,1,0,1
"cg10844766",0,0,2,0,2
"cg10846922",0,2,1,0,3
"cg10848318",0,1,0,0,1
"cg10851568",0,0,3,0,3
"cg10852160",6,0,0,0,6
"cg10854807",0,3,1,0,4
"cg10854974",6,2,0,0,8
"cg10857489",1,0,1,0,2
"cg10857729",1,0,2,0,3
"cg10858195",183,265,16,0,464
"cg10859317",3,1,0,0,4
"cg10859726",0,0,1,0,1
"cg10859844",0,0,1,0,1
"cg10859897",0,1,0,0,1
"cg10861033",0,1,0,0,1
"cg10861313",0,0,2,0,2
"cg10861426",514,15,0,0,529
"cg10861667",0,0,1,0,1
"cg10862612",129,12,0,0,141
"cg10862981",0,1,0,0,1
"cg10866034",1,5,0,0,6
"cg10866461",0,8,0,0,8
"cg10866833",26,10,0,0,36
"cg10866856",45,1,0,0,46
"cg10867417",3,0,0,0,3
"cg10868394",19,2,0,0,21
"cg10869210",0,1,0,0,1
"cg10869691",1,0,0,0,1
"cg10870033",0,0,1,0,1
"cg10872075",1,0,0,0,1
"cg10872107",1,3,2,0,6
"cg10872967",1,0,0,0,1
"cg10873781",0,0,1,0,1
"cg10874392",2,0,0,0,2
"cg10875261",2,3,0,0,5
"cg10875627",159,74,12,0,245
"cg10877106",2,1,0,0,3
"cg10877442",3,4,0,0,7
"cg10879769",0,2,6,0,8
"cg10881170",2,2,16,0,20
"cg10882379",0,0,1,0,1
"cg10883258",0,1,0,0,1
"cg10883735",2,0,0,0,2
"cg10884614",0,1,1,0,2
"cg10885050",1,0,0,0,1
"cg10885309",0,1,0,0,1
"cg10885471",20,21,7,0,48
"cg10885572",0,0,2,0,2
"cg10885772",0,0,1,0,1
"cg10885940",1,2,1,0,4
"cg10885988",0,1,4,0,5
"cg10886293",0,0,1,0,1
"cg10886493",0,2,0,0,2
"cg10888138",0,0,1,0,1
"cg10888523",11,12,1,0,24
"cg10888877",1,0,0,0,1
"cg10889447",0,0,1,0,1
"cg10889999",3,12,2,0,17
"cg10891008",1037,474,1,0,1512
"cg10891259",1,0,0,0,1
"cg10891951",64,119,27,0,210
"cg10892251",5,30,1,0,36
"cg10892585",0,1,3,0,4
"cg10894232",0,0,1,0,1
"cg10894690",0,0,5,0,5
"cg10895931",13,0,0,0,13
"cg10896230",0,0,2,0,2
"cg10896746",0,1,0,0,1
"cg10898058",1,0,0,0,1
"cg10898367",287,166,3,0,456
"cg10898421",2,3,2,0,7
"cg10898452",9,8,0,0,17
"cg10898856",0,0,1,0,1
"cg10899814",0,3,2,0,5
"cg10900642",272,180,24,0,476
"cg10901099",0,0,5,0,5
"cg10902359",0,0,1,0,1
"cg10902977",0,0,1,0,1
"cg10903254",0,0,1,0,1
"cg10903726",0,0,0,1,1
"cg10904250",5,2,1,0,8
"cg10904773",0,0,1,0,1
"cg10905206",4,0,0,0,4
"cg10905877",1,1,0,0,2
"cg10906102",8,2,4,0,14
"cg10906108",1,0,0,0,1
"cg10906261",0,0,3,0,3
"cg10906530",1,0,0,0,1
"cg10907356",1,0,0,0,1
"cg10908411",0,4,0,0,4
"cg10910682",1,1,0,0,2
"cg10910775",0,2,1,1,4
"cg10911063",0,3,0,0,3
"cg10911276",1,2,0,0,3
"cg10911328",0,1,0,0,1
"cg10911898",0,1,1,0,2
"cg10912036",4,2,1,0,7
"cg10912439",0,0,1,0,1
"cg10913755",0,1,0,0,1
"cg10914422",1,0,0,0,1
"cg10914699",103,30,9,0,142
"cg10915099",1,0,1,0,2
"cg10915263",0,0,1,0,1
"cg10915445",0,0,1,0,1
"cg10915628",1,0,0,0,1
"cg10917156",0,0,0,1,1
"cg10917426",0,0,1,0,1
"cg10918327",2,1,0,0,3
"cg10919660",0,1,0,0,1
"cg10919919",11,15,3,0,29
"cg10920240",1,0,0,0,1
"cg10920722",0,0,1,0,1
"cg10921277",0,1,0,0,1
"cg10922802",0,0,2,0,2
"cg10923219",8,2,0,0,10
"cg10924293",0,2,0,0,2
"cg10924806",6,1,0,0,7
"cg10926512",304,107,1,0,412
"cg10926754",0,1,0,0,1
"cg10926857",0,0,1,0,1
"cg10927068",0,0,1,0,1
"cg10927614",0,0,1,0,1
"cg10928044",0,1,0,0,1
"cg10928348",2,0,0,0,2
"cg10928724",0,0,1,0,1
"cg10928931",0,0,1,0,1
"cg10930513",0,1,0,0,1
"cg10932815",340,52,4,0,396
"cg10933625",1,0,0,0,1
"cg10934546",1,0,1,0,2
"cg10935253",1,2,2,0,5
"cg10935898",0,1,0,0,1
"cg10936153",0,1,0,0,1
"cg10936233",2,0,0,0,2
"cg10936578",9,1,0,0,10
"cg10937024",1,0,0,0,1
"cg10938135",1,0,0,0,1
"cg10939621",8,0,0,0,8
"cg10940203",0,0,2,0,2
"cg10940251",0,0,1,0,1
"cg10940789",0,1,1,0,2
"cg10941102",0,1,0,0,1
"cg10942059",2,8,0,0,10
"cg10942847",1,1,1,0,3
"cg10944401",1,0,1,0,2
"cg10944465",0,0,2,0,2
"cg10945028",273,101,3,0,377
"cg10945881",0,0,1,0,1
"cg10946252",5,1,0,0,6
"cg10946864",2,2,2,0,6
"cg10948220",266,8,0,0,274
"cg10948652",596,25,3,0,624
"cg10948671",0,0,2,0,2
"cg10949413",1,0,0,0,1
"cg10949430",0,1,0,0,1
"cg10950028",0,1,0,0,1
"cg10951976",246,14,1,0,261
"cg10952205",0,0,1,0,1
"cg10952801",0,0,1,0,1
"cg10952925",0,0,1,0,1
"cg10953225",0,1,0,0,1
"cg10954665",0,0,1,0,1
"cg10955633",19,2,0,0,21
"cg10956543",0,1,0,0,1
"cg10956636",0,0,1,0,1
"cg10957584",1,4,5,0,10
"cg10957733",1,0,0,0,1
"cg10959344",260,196,21,0,477
"cg10959649",0,0,1,0,1
"cg10959673",20,5,0,0,25
"cg10959847",0,0,1,0,1
"cg10960122",33,28,1,0,62
"cg10960147",1,0,4,0,5
"cg10960148",1,0,0,0,1
"cg10960198",107,69,11,0,187
"cg10962295",0,1,0,0,1
"cg10965669",1,0,0,0,1
"cg10966582",1,1,0,0,2
"cg10966661",4,5,0,0,9
"cg10966768",17,23,0,0,40
"cg10967101",1,1,0,0,2
"cg10967176",0,0,1,0,1
"cg10968999",0,0,1,0,1
"cg10969465",62,16,5,0,83
"cg10970272",0,0,2,0,2
"cg10971632",2,11,1,0,14
"cg10971928",0,14,13,0,27
"cg10972351",0,0,1,0,1
"cg10972451",0,1,1,0,2
"cg10972625",0,0,5,0,5
"cg10974038",0,0,1,0,1
"cg10975873",4,13,6,0,23
"cg10976135",1,0,0,0,1
"cg10976870",0,2,0,0,2
"cg10977320",2,0,0,0,2
"cg10977833",0,0,1,0,1
"cg10978002",54,54,17,0,125
"cg10978401",1,1,0,0,2
"cg10979474",0,1,0,0,1
"cg10979846",0,1,5,0,6
"cg10979903",1,0,0,0,1
"cg10980542",6,3,0,0,9
"cg10980952",1,1,0,0,2
"cg10981770",0,2,0,0,2
"cg10982280",0,0,1,0,1
"cg10982913",0,1,0,0,1
"cg10982935",0,0,1,0,1
"cg10984525",0,0,1,1,2
"cg10985228",0,1,0,0,1
"cg10986104",1,0,0,0,1
"cg10986220",1,0,0,0,1
"cg10987801",12,0,0,0,12
"cg10988027",1,2,0,0,3
"cg10988124",1,0,3,1,5
"cg10988561",1,3,0,0,4
"cg10989214",0,0,0,1,1
"cg10989862",0,0,1,0,1
"cg10989879",0,0,1,0,1
"cg10989981",0,0,1,0,1
"cg10990184",0,1,0,0,1
"cg10990665",80,9,0,0,89
"cg10990685",0,0,1,0,1
"cg10993465",0,0,1,0,1
"cg10993503",914,166,6,0,1086
"cg10993840",2,1,0,0,3
"cg10993893",0,1,0,0,1
"cg10994343",27,1,0,0,28
"cg10994639",1,0,0,0,1
"cg10995363",2,3,3,0,8
"cg10995637",0,0,1,0,1
"cg10996336",86,4,0,0,90
"cg10997175",135,617,17,0,769
"cg10999122",16,0,0,0,16
"cg10999780",2,0,0,0,2
"cg10999896",0,0,2,0,2
"cg11000027",0,4,7,0,11
"cg11000586",0,0,1,0,1
"cg11001828",9,2,2,0,13
"cg11002430",5,1,0,0,6
"cg11002741",1,0,0,0,1
"cg11003117",0,0,3,0,3
"cg11003426",21,2,0,0,23
"cg11003984",0,0,1,0,1
"cg11003994",5,6,0,0,11
"cg11004508",1,0,0,0,1
"cg11004670",0,0,2,0,2
"cg11005571",13,13,14,0,40
"cg11005628",2,11,2,0,15
"cg11009353",4,0,0,0,4
"cg11009400",0,0,1,0,1
"cg11009520",0,0,1,0,1
"cg11009587",0,2,0,0,2
"cg11009635",1,0,1,0,2
"cg11010652",0,0,1,0,1
"cg11014382",0,2,1,1,4
"cg11014854",1,0,0,0,1
"cg11014875",6,8,8,0,22
"cg11015470",2,1,1,0,4
"cg11016293",0,0,1,0,1
"cg11016411",0,2,0,0,2
"cg11017947",0,2,0,0,2
"cg11019069",23,8,0,0,31
"cg11019308",1,0,0,0,1
"cg11019629",0,1,0,0,1
"cg11023989",0,1,1,0,2
"cg11024416",0,0,1,0,1
"cg11024964",2,2,0,0,4
"cg11026443",534,352,8,0,894
"cg11026874",2,0,0,0,2
"cg11026954",0,1,0,0,1
"cg11029010",0,0,1,0,1
"cg11029642",0,0,1,0,1
"cg11029811",0,1,2,0,3
"cg11031564",1,0,0,0,1
"cg11031660",2,0,0,0,2
"cg11031669",1,0,2,0,3
"cg11032064",0,1,0,0,1
"cg11032157",0,0,2,0,2
"cg11032994",0,1,0,0,1
"cg11033609",1,0,0,0,1
"cg11034168",1,0,0,0,1
"cg11034708",0,1,0,0,1
"cg11036359",2,0,0,0,2
"cg11036546",0,0,2,0,2
"cg11037327",3,1,0,0,4
"cg11037416",0,1,0,0,1
"cg11037749",1,0,0,0,1
"cg11038081",4,1,0,0,5
"cg11038491",0,1,0,0,1
"cg11039289",6,1,0,0,7
"cg11041042",1,0,0,0,1
"cg11042402",1,0,0,0,1
"cg11042620",564,235,1,0,800
"cg11044010",0,1,0,0,1
"cg11044085",3,0,0,0,3
"cg11044575",0,0,1,0,1
"cg11045033",0,2,1,0,3
"cg11045293",0,0,1,0,1
"cg11045417",3,0,0,0,3
"cg11046393",0,1,0,0,1
"cg11046578",1,0,1,0,2
"cg11046917",3,0,0,0,3
"cg11047457",219,457,6,0,682
"cg11048722",0,1,0,0,1
"cg11049961",0,0,1,0,1
"cg11051318",0,0,1,0,1
"cg11053666",0,0,1,0,1
"cg11055649",0,1,0,0,1
"cg11055967",0,0,2,0,2
"cg11056757",16,0,0,0,16
"cg11058087",183,164,0,0,347
"cg11058512",3,5,1,0,9
"cg11058707",1,0,0,0,1
"cg11058939",4,1,0,0,5
"cg11059246",3,0,0,0,3
"cg11059934",51,9,0,0,60
"cg11060379",0,1,1,0,2
"cg11061251",8,16,12,0,36
"cg11061559",4,0,0,0,4
"cg11063324",124,44,12,0,180
"cg11063819",17,6,1,0,24
"cg11063970",1,0,0,0,1
"cg11064915",0,1,2,0,3
"cg11065064",0,0,1,0,1
"cg11065408",2,0,0,0,2
"cg11065418",1234,136,3,0,1373
"cg11065694",0,2,1,0,3
"cg11067885",6,1,0,0,7
"cg11068258",0,0,1,0,1
"cg11068401",0,1,0,0,1
"cg11068523",0,0,1,0,1
"cg11069106",2,2,0,0,4
"cg11069798",13,1,0,0,14
"cg11070000",0,1,0,0,1
"cg11070301",0,2,0,0,2
"cg11070353",0,1,0,0,1
"cg11071084",7,4,0,0,11
"cg11073394",0,0,1,0,1
"cg11073407",0,0,1,0,1
"cg11073684",0,0,1,0,1
"cg11075273",0,0,1,0,1
"cg11076663",2,0,1,0,3
"cg11077457",0,5,1,0,6
"cg11077562",119,30,0,0,149
"cg11078773",3,0,0,0,3
"cg11078990",0,1,7,0,8
"cg11080642",311,742,20,0,1073
"cg11080915",0,1,0,0,1
"cg11081068",47,7,0,0,54
"cg11081390",621,33,1,0,655
"cg11085454",1,0,1,0,2
"cg11085771",8,3,0,0,11
"cg11085971",14,3,0,0,17
"cg11086883",0,1,1,0,2
"cg11087295",1,0,0,0,1
"cg11087438",0,1,1,0,2
"cg11088227",0,0,1,0,1
"cg11089493",21,4,1,0,26
"cg11090176",0,1,0,0,1
"cg11091383",1,1,4,0,6
"cg11093538",4,2,0,0,6
"cg11093872",0,1,0,0,1
"cg11095383",4,6,0,0,10
"cg11095632",3,6,1,0,10
"cg11096033",14,1,0,0,15
"cg11097433",0,1,0,0,1
"cg11098548",0,0,1,0,1
"cg11099901",0,1,0,0,1
"cg11099918",12,5,0,0,17
"cg11100258",0,1,0,0,1
"cg11100341",24,0,0,0,24
"cg11100351",0,0,1,0,1
"cg11100804",0,1,0,0,1
"cg11101032",77,48,0,0,125
"cg11102122",1,0,0,0,1
"cg11102218",1,0,0,0,1
"cg11102395",0,0,1,0,1
"cg11102844",198,57,2,0,257
"cg11102858",0,0,1,0,1
"cg11103147",2,0,0,0,2
"cg11103258",1,0,0,0,1
"cg11104440",0,1,0,0,1
"cg11104471",0,1,0,0,1
"cg11104619",1,0,0,0,1
"cg11105143",149,8,0,0,157
"cg11105212",0,0,1,0,1
"cg11105884",0,2,2,0,4
"cg11105927",1087,327,3,0,1417
"cg11107524",326,46,0,0,372
"cg11109684",0,1,0,0,1
"cg11109800",2,0,0,0,2
"cg11109859",9,4,1,0,14
"cg11113688",0,0,1,0,1
"cg11114487",2,0,0,0,2
"cg11115005",0,1,0,0,1
"cg11115097",216,101,15,0,332
"cg11115253",1,0,0,0,1
"cg11115267",0,0,1,0,1
"cg11116364",0,1,0,0,1
"cg11116776",1,0,0,0,1
"cg11117122",0,0,2,0,2
"cg11117183",4,1,0,0,5
"cg11119575",0,0,1,0,1
"cg11122456",86,14,0,0,100
"cg11123049",2,1,0,0,3
"cg11123942",1,0,0,0,1
"cg11124142",2,0,1,0,3
"cg11125104",0,0,1,0,1
"cg11126247",0,0,1,0,1
"cg11127704",0,3,0,0,3
"cg11127886",0,0,1,0,1
"cg11130031",1,4,19,0,24
"cg11130097",5,10,2,0,17
"cg11131508",5,9,0,0,14
"cg11133161",276,55,5,0,336
"cg11134322",894,374,8,0,1276
"cg11134425",0,0,2,0,2
"cg11134532",0,0,2,0,2
"cg11134850",1,1,0,0,2
"cg11135168",3,2,0,0,5
"cg11135347",275,247,2,0,524
"cg11136406",2,42,28,0,72
"cg11136987",0,0,1,0,1
"cg11137761",1,15,189,0,205
"cg11138318",0,2,0,0,2
"cg11138823",17,20,23,0,60
"cg11139628",0,1,0,0,1
"cg11139763",6,1,0,0,7
"cg11139864",0,0,1,0,1
"cg11140287",400,647,25,0,1072
"cg11140393",5,0,0,0,5
"cg11141368",21,5,0,0,26
"cg11141692",1,0,0,0,1
"cg11143507",1,1,0,0,2
"cg11144701",0,0,1,0,1
"cg11144986",0,0,2,0,2
"cg11145162",0,1,0,0,1
"cg11145273",0,1,0,0,1
"cg11147317",1,0,1,0,2
"cg11147497",88,28,3,0,119
"cg11147511",0,0,1,0,1
"cg11147888",80,236,184,0,500
"cg11147953",0,1,1,0,2
"cg11148381",1,1,2,0,4
"cg11148697",1,0,0,0,1
"cg11149390",0,1,0,0,1
"cg11151176",1,0,0,0,1
"cg11151345",4,4,0,0,8
"cg11151395",0,0,1,0,1
"cg11151665",125,13,3,0,141
"cg11151725",78,84,2,0,164
"cg11152012",1,0,0,0,1
"cg11152223",1125,211,4,0,1340
"cg11153808",0,0,2,0,2
"cg11154559",4,5,0,0,9
"cg11154608",3,2,4,0,9
"cg11154970",3,2,0,0,5
"cg11155547",0,0,1,0,1
"cg11155673",1,0,0,0,1
"cg11155811",3,4,1,0,8
"cg11155992",0,0,1,0,1
"cg11156817",0,1,0,0,1
"cg11158198",1,2,0,0,3
"cg11159141",2,1,0,0,3
"cg11159299",3,2,0,0,5
"cg11161208",2,1,1,0,4
"cg11161226",1,0,0,0,1
"cg11161264",0,0,1,0,1
"cg11161550",0,0,1,0,1
"cg11161881",4,2,0,0,6
"cg11162942",66,4,1,0,71
"cg11163362",204,285,4,0,493
"cg11163677",0,4,4,0,8
"cg11164269",1,0,0,0,1
"cg11164980",15,0,0,0,15
"cg11165316",112,229,160,0,501
"cg11166258",0,0,5,0,5
"cg11168432",1,0,0,0,1
"cg11169340",0,1,1,0,2
"cg11170573",0,2,0,0,2
"cg11171224",0,0,1,0,1
"cg11171259",0,1,0,0,1
"cg11173261",348,19,0,0,367
"cg11174476",6,1,0,0,7
"cg11176656",0,0,1,0,1
"cg11178321",0,1,0,0,1
"cg11178371",673,8,0,0,681
"cg11178666",0,0,1,0,1
"cg11178975",2,0,0,0,2
"cg11179570",0,0,1,0,1
"cg11182645",0,0,1,0,1
"cg11183253",5,0,0,0,5
"cg11183418",3,2,0,0,5
"cg11184057",4,10,0,0,14
"cg11184905",1,0,1,0,2
"cg11186155",1,0,0,0,1
"cg11186406",1,0,0,0,1
"cg11187525",1,0,0,0,1
"cg11187612",25,2,0,0,27
"cg11187903",1,0,0,0,1
"cg11190240",1,3,0,0,4
"cg11191744",552,852,95,0,1499
"cg11193416",0,1,0,0,1
"cg11194443",0,0,1,0,1
"cg11195163",0,0,1,0,1
"cg11195650",5,0,0,0,5
"cg11195909",0,0,3,0,3
"cg11197088",0,2,3,0,5
"cg11198869",8,2,0,0,10
"cg11199437",0,4,4,0,8
"cg11200070",2,0,0,0,2
"cg11200437",1,1,0,0,2
"cg11200462",0,0,1,0,1
"cg11200963",1,0,0,0,1
"cg11201371",0,0,1,0,1
"cg11201584",32,1,0,0,33
"cg11202254",1,0,0,0,1
"cg11202620",158,874,10,0,1042
"cg11203287",8,0,0,0,8
"cg11204664",0,4,0,0,4
"cg11204953",0,1,5,0,6
"cg11204987",1,2,0,0,3
"cg11205296",0,0,1,0,1
"cg11206824",2,0,0,0,2
"cg11208147",1,0,0,0,1
"cg11208853",2,1,5,0,8
"cg11213235",0,1,0,0,1
"cg11213757",1,0,0,0,1
"cg11214259",2,0,0,0,2
"cg11216823",0,0,1,0,1
"cg11217108",0,0,3,0,3
"cg11217542",1,0,0,0,1
"cg11217676",0,0,2,0,2
"cg11218049",0,23,8,0,31
"cg11218154",0,1,0,0,1
"cg11218642",539,52,7,0,598
"cg11220245",1,1,0,0,2
"cg11220623",0,1,0,0,1
"cg11220811",1,0,0,0,1
"cg11221741",8,1,0,0,9
"cg11222383",1,0,0,0,1
"cg11222482",1,0,0,0,1
"cg11222596",1,2,0,0,3
"cg11222626",4,0,0,0,4
"cg11222703",0,0,0,1,1
"cg11223286",0,1,2,0,3
"cg11223892",0,2,0,0,2
"cg11224153",2,0,0,0,2
"cg11224188",2,1,1,0,4
"cg11224271",4,8,12,0,24
"cg11224334",5,1,0,0,6
"cg11227172",0,1,2,0,3
"cg11227941",469,9,0,0,478
"cg11229476",3,0,0,0,3
"cg11229571",3,0,0,0,3
"cg11231156",6,6,0,0,12
"cg11231240",3,3,0,0,6
"cg11231342",50,116,130,0,296
"cg11231454",4,1,0,0,5
"cg11231715",0,1,0,0,1
"cg11231864",2,0,2,0,4
"cg11232276",3,1,1,0,5
"cg11232309",2,0,0,0,2
"cg11234875",416,27,2,0,445
"cg11235218",0,0,1,0,1
"cg11235583",1,0,0,0,1
"cg11236244",0,0,4,0,4
"cg11236795",2,0,0,0,2
"cg11237272",0,1,0,0,1
"cg11237495",9,0,0,0,9
"cg11239335",321,213,16,0,550
"cg11239506",3,3,0,0,6
"cg11239558",1,0,0,0,1
"cg11240431",0,0,1,0,1
"cg11241059",1,1,1,0,3
"cg11243185",2,0,0,0,2
"cg11243634",609,11,0,0,620
"cg11244051",0,0,1,0,1
"cg11244648",0,0,6,0,6
"cg11245084",0,0,1,0,1
"cg11246482",2,1,0,0,3
"cg11246563",0,1,0,0,1
"cg11246579",6,0,0,0,6
"cg11248320",1,0,0,0,1
"cg11248828",2,0,0,0,2
"cg11249173",50,19,4,0,73
"cg11250207",0,0,1,0,1
"cg11250817",3,0,0,0,3
"cg11251170",133,60,11,0,204
"cg11251200",0,1,0,0,1
"cg11251827",1,0,0,0,1
"cg11252339",3,2,0,0,5
"cg11252574",0,0,1,0,1
"cg11252600",2,9,20,0,31
"cg11253526",0,0,1,0,1
"cg11254234",0,1,0,0,1
"cg11254893",0,0,1,0,1
"cg11255010",0,0,1,0,1
"cg11255427",0,0,1,0,1
"cg11255565",0,0,6,0,6
"cg11255872",1,0,0,0,1
"cg11255913",1,0,0,0,1
"cg11256253",41,6,0,0,47
"cg11256760",0,1,0,0,1
"cg11258485",0,1,0,0,1
"cg11259152",8,4,1,0,13
"cg11259446",1,6,6,0,13
"cg11261211",3,2,1,0,6
"cg11262744",1,0,0,0,1
"cg11262874",7,8,2,0,17
"cg11263997",1,0,0,0,1
"cg11265843",0,1,0,0,1
"cg11266667",1,0,0,0,1
"cg11267019",0,0,1,0,1
"cg11268053",0,0,4,0,4
"cg11269212",0,1,1,0,2
"cg11270387",0,0,1,0,1
"cg11270633",0,0,1,0,1
"cg11270977",0,0,2,0,2
"cg11271430",0,0,1,0,1
"cg11271685",2,1,1,0,4
"cg11271713",0,1,1,0,2
"cg11271925",0,0,1,0,1
"cg11272074",9,9,0,0,18
"cg11272475",0,1,0,0,1
"cg11275015",0,4,2,0,6
"cg11275862",1,0,1,0,2
"cg11276044",0,1,1,0,2
"cg11276382",1,0,0,0,1
"cg11277087",1,1,0,0,2
"cg11277105",0,0,2,0,2
"cg11277190",3,0,0,0,3
"cg11277260",575,719,6,0,1300
"cg11278016",1,0,0,0,1
"cg11278110",0,0,1,0,1
"cg11278311",0,0,1,0,1
"cg11278494",2,0,0,0,2
"cg11280984",0,0,1,0,1
"cg11281224",0,0,1,0,1
"cg11282100",128,1,0,0,129
"cg11282782",6,0,0,0,6
"cg11282846",0,1,0,0,1
"cg11284489",3,2,0,0,5
"cg11286294",0,2,0,0,2
"cg11286653",0,1,7,0,8
"cg11286901",0,0,1,0,1
"cg11287885",1,5,2,0,8
"cg11287886",1,0,0,0,1
"cg11288663",0,0,1,0,1
"cg11289023",0,1,0,0,1
"cg11289591",3,0,0,0,3
"cg11291379",1,0,0,0,1
"cg11291456",14,7,0,0,21
"cg11292332",0,0,1,0,1
"cg11292604",2,12,0,0,14
"cg11294123",1,0,0,0,1
"cg11294312",0,0,3,0,3
"cg11295385",0,1,0,0,1
"cg11295469",0,1,0,0,1
"cg11295718",0,0,1,0,1
"cg11296268",1,0,0,0,1
"cg11296405",9,1,7,0,17
"cg11297271",0,0,1,0,1
"cg11299304",1,0,0,0,1
"cg11299873",1,0,0,0,1
"cg11299892",0,0,5,0,5
"cg11300126",0,0,1,0,1
"cg11301208",0,1,0,0,1
"cg11301493",0,0,3,0,3
"cg11301695",1,0,0,0,1
"cg11301795",4,36,3,0,43
"cg11302065",0,1,0,0,1
"cg11302633",1,0,0,0,1
"cg11302733",267,16,0,0,283
"cg11303486",167,10,0,0,177
"cg11304015",3,0,0,0,3
"cg11304264",0,3,0,0,3
"cg11304639",0,1,0,0,1
"cg11304742",533,155,5,0,693
"cg11305792",213,240,7,0,460
"cg11306007",1,0,0,0,1
"cg11306361",0,1,1,0,2
"cg11307134",0,0,3,0,3
"cg11307360",1,0,0,0,1
"cg11307562",0,0,1,0,1
"cg11307679",986,116,4,0,1106
"cg11307741",95,6,0,0,101
"cg11308746",0,0,2,0,2
"cg11309866",1,0,0,0,1
"cg11309891",0,2,0,0,2
"cg11310087",1,0,0,0,1
"cg11310341",1,0,0,0,1
"cg11310954",0,1,0,0,1
"cg11311049",0,2,1,0,3
"cg11311843",1,0,0,0,1
"cg11313014",0,0,1,0,1
"cg11313429",2,0,0,0,2
"cg11314757",0,0,1,0,1
"cg11316048",0,1,0,0,1
"cg11316751",1,0,0,0,1
"cg11318476",0,1,0,0,1
"cg11319512",84,15,0,0,99
"cg11319724",0,0,1,0,1
"cg11320438",3,0,0,0,3
"cg11320553",2,0,0,0,2
"cg11320568",0,1,0,0,1
"cg11320701",0,1,0,0,1
"cg11321392",1,0,0,0,1
"cg11321839",0,1,4,0,5
"cg11322124",0,0,23,0,23
"cg11322924",0,0,1,0,1
"cg11324041",3,0,0,0,3
"cg11324748",0,0,1,0,1
"cg11325127",2,2,0,0,4
"cg11325989",0,2,0,0,2
"cg11327318",0,0,1,0,1
"cg11327366",172,18,0,0,190
"cg11330075",1,2,0,1,4
"cg11330501",4,0,1,0,5
"cg11330843",0,0,4,0,4
"cg11333241",0,1,0,0,1
"cg11333436",88,14,1,0,103
"cg11333454",140,2,0,0,142
"cg11333681",0,2,0,0,2
"cg11334694",0,2,1,0,3
"cg11334709",3,0,0,0,3
"cg11334728",1,0,11,0,12
"cg11334772",0,1,1,0,2
"cg11335679",0,0,1,0,1
"cg11336249",0,0,1,0,1
"cg11336389",129,31,7,0,167
"cg11336827",5,0,0,0,5
"cg11336837",0,0,1,0,1
"cg11336938",0,1,0,0,1
"cg11337629",0,0,1,0,1
"cg11338917",1,0,1,0,2
"cg11340941",0,0,1,0,1
"cg11341215",4,0,0,0,4
"cg11342925",16,10,4,0,30
"cg11343464",0,0,1,0,1
"cg11344530",25,6,0,0,31
"cg11344921",0,0,1,0,1
"cg11345438",0,0,1,0,1
"cg11345718",33,8,1,0,42
"cg11346962",0,1,5,0,6
"cg11347531",217,14,1,0,232
"cg11348757",1,4,3,1,9
"cg11348905",0,1,0,0,1
"cg11349594",0,0,1,0,1
"cg11349761",0,2,1,0,3
"cg11349969",13,2,0,0,15
"cg11350972",0,0,1,0,1
"cg11351333",3,0,0,0,3
"cg11351835",3,6,0,0,9
"cg11351841",1,4,0,0,5
"cg11351958",0,1,0,0,1
"cg11353380",0,0,1,0,1
"cg11354479",0,1,0,0,1
"cg11356004",4,3,0,0,7
"cg11357221",156,90,4,0,250
"cg11357385",2,1,0,0,3
"cg11357507",1,0,0,0,1
"cg11357608",0,0,1,0,1
"cg11358720",0,0,1,0,1
"cg11359737",17,0,0,0,17
"cg11360299",0,0,2,0,2
"cg11360768",0,0,1,0,1
"cg11361409",4,9,1,0,14
"cg11362080",0,0,1,0,1
"cg11362434",1,2,0,0,3
"cg11363090",7,0,0,0,7
"cg11364420",1,1,0,0,2
"cg11364621",0,2,0,0,2
"cg11365205",0,0,0,1,1
"cg11365261",1,0,1,0,2
"cg11365298",1,0,0,0,1
"cg11366829",0,0,1,0,1
"cg11367038",1,0,0,0,1
"cg11367055",0,1,0,0,1
"cg11367927",1,0,0,0,1
"cg11368699",1,0,0,0,1
"cg11369485",1,0,0,0,1
"cg11369615",1,1,0,0,2
"cg11370299",2,0,0,0,2
"cg11371122",0,0,2,0,2
"cg11371566",0,1,0,0,1
"cg11371619",0,1,0,0,1
"cg11371953",1,0,0,0,1
"cg11372704",1,0,0,0,1
"cg11374778",1,1,2,0,4
"cg11374834",1,1,1,0,3
"cg11375145",1,0,2,0,3
"cg11377056",1,0,0,0,1
"cg11377279",0,0,2,0,2
"cg11379028",0,2,2,0,4
"cg11379972",2,0,0,0,2
"cg11380281",1,1,0,0,2
"cg11380499",2,0,0,0,2
"cg11380503",3,2,0,0,5
"cg11380811",0,1,0,0,1
"cg11380908",0,1,0,0,1
"cg11380914",0,0,2,0,2
"cg11382324",0,1,0,0,1
"cg11382976",16,1,2,0,19
"cg11382979",1,0,0,0,1
"cg11383148",1,0,0,0,1
"cg11383165",1,0,0,0,1
"cg11383798",1,0,0,0,1
"cg11383944",0,0,1,0,1
"cg11384481",0,0,1,0,1
"cg11385338",0,0,1,0,1
"cg11386034",1,0,0,0,1
"cg11386276",283,334,78,0,695
"cg11386360",7,1,0,0,8
"cg11386746",21,3,0,0,24
"cg11386866",1,0,1,0,2
"cg11387248",0,1,0,0,1
"cg11390628",0,1,0,0,1
"cg11390933",11,5,0,0,16
"cg11391793",4,3,0,0,7
"cg11393297",1,0,0,0,1
"cg11394820",0,1,0,0,1
"cg11395044",1,0,0,0,1
"cg11395062",0,0,1,0,1
"cg11395488",0,2,0,0,2
"cg11396122",1,0,0,0,1
"cg11396746",1,0,0,0,1
"cg11397033",1,0,0,0,1
"cg11397143",3,0,0,0,3
"cg11398308",23,0,0,0,23
"cg11399576",1,1,0,0,2
"cg11400391",1,0,0,0,1
"cg11400401",0,1,0,0,1
"cg11401699",1,0,0,0,1
"cg11401929",0,0,10,0,10
"cg11402396",0,1,0,0,1
"cg11403261",73,102,2,0,177
"cg11404203",1,0,0,0,1
"cg11404420",3,1,0,0,4
"cg11405631",0,1,0,0,1
"cg11405695",0,0,1,0,1
"cg11407198",1,0,0,0,1
"cg11407373",0,0,1,0,1
"cg11408303",7,0,0,0,7
"cg11409295",0,1,1,0,2
"cg11409308",1,0,0,0,1
"cg11411203",0,0,1,0,1
"cg11412164",1,1,0,0,2
"cg11412582",1,0,2,0,3
"cg11413071",2,0,0,0,2
"cg11413496",0,0,2,0,2
"cg11413862",9,1,0,0,10
"cg11415548",1,0,2,0,3
"cg11415653",0,1,0,0,1
"cg11416080",2,0,0,0,2
"cg11416552",0,0,1,0,1
"cg11416843",0,0,1,0,1
"cg11417319",0,0,3,0,3
"cg11417547",0,1,0,0,1
"cg11418308",12,2,0,0,14
"cg11419217",3,15,16,0,34
"cg11419646",0,1,0,0,1
"cg11420644",0,1,0,0,1
"cg11420780",0,2,0,0,2
"cg11420782",1,0,0,0,1
"cg11421025",5,0,0,0,5
"cg11422233",3,0,0,0,3
"cg11422335",1,1,0,0,2
"cg11423280",177,16,3,0,196
"cg11423443",28,4,0,0,32
"cg11423822",7,9,1,0,17
"cg11424472",0,0,1,0,1
"cg11425754",2,0,0,0,2
"cg11426313",0,0,3,0,3
"cg11427377",4,6,1,0,11
"cg11427900",329,134,22,0,485
"cg11428279",1,0,0,0,1
"cg11429177",78,34,4,0,116
"cg11429746",0,0,13,0,13
"cg11429969",4,1,0,0,5
"cg11430105",2,0,1,0,3
"cg11430362",0,1,0,0,1
"cg11430719",0,0,1,0,1
"cg11431055",0,0,1,0,1
"cg11432574",3,5,3,0,11
"cg11433081",0,0,1,0,1
"cg11433344",0,0,1,0,1
"cg11433672",0,1,0,0,1
"cg11434282",2,0,0,0,2
"cg11435354",1,0,0,0,1
"cg11436222",0,1,0,0,1
"cg11436767",0,0,1,0,1
"cg11437836",1,0,0,0,1
"cg11437923",0,1,3,0,4
"cg11438555",2,0,0,0,2
"cg11439050",1,0,0,0,1
"cg11439390",1,0,0,0,1
"cg11439699",3,0,0,0,3
"cg11440764",0,0,1,0,1
"cg11441245",2,2,0,0,4
"cg11441416",0,2,0,0,2
"cg11441966",1,0,0,0,1
"cg11442071",0,0,1,0,1
"cg11442110",5,0,0,0,5
"cg11443506",2,0,0,0,2
"cg11445902",1,0,0,0,1
"cg11446038",1,0,0,0,1
"cg11446433",0,1,1,0,2
"cg11447162",0,0,1,0,1
"cg11447187",0,0,1,0,1
"cg11447319",0,1,3,0,4
"cg11447854",1,1,0,0,2
"cg11448030",693,561,5,0,1259
"cg11448348",0,2,1,0,3
"cg11448547",0,0,0,1,1
"cg11449341",2,0,0,0,2
"cg11450766",1,0,0,0,1
"cg11451281",8,13,0,0,21
"cg11451367",0,1,0,0,1
"cg11452455",3,0,0,0,3
"cg11452537",1,0,0,0,1
"cg11453289",1,0,0,0,1
"cg11454270",1,0,0,0,1
"cg11455169",1,0,0,0,1
"cg11456303",1,0,0,0,1
"cg11457478",0,0,1,0,1
"cg11457643",1,0,0,0,1
"cg11458585",5,1,0,0,6
"cg11458799",5,4,1,0,10
"cg11459603",0,0,1,0,1
"cg11460563",0,0,5,0,5
"cg11460778",5,0,0,0,5
"cg11461568",1,0,1,0,2
"cg11462840",7,5,0,0,12
"cg11463280",0,0,2,0,2
"cg11464377",0,0,1,0,1
"cg11465404",0,0,1,0,1
"cg11466309",1,0,0,0,1
"cg11467262",0,0,1,0,1
"cg11467335",0,0,1,0,1
"cg11468003",1,0,0,0,1
"cg11468233",0,2,1,0,3
"cg11468348",165,367,45,0,577
"cg11469349",3,1,1,0,5
"cg11469529",3,2,0,0,5
"cg11469691",14,3,0,0,17
"cg11471354",0,1,0,0,1
"cg11471638",14,0,0,0,14
"cg11473001",0,0,1,0,1
"cg11473034",1,0,0,0,1
"cg11473856",219,14,0,0,233
"cg11474093",2,0,0,0,2
"cg11474182",0,0,4,0,4
"cg11474468",0,1,2,0,3
"cg11474553",0,0,1,0,1
"cg11476878",1,0,0,0,1
"cg11478766",1,0,0,0,1
"cg11480068",97,7,0,0,104
"cg11481089",0,0,1,0,1
"cg11482935",2,1,0,0,3
"cg11483845",0,0,1,0,1
"cg11484543",0,0,3,0,3
"cg11485463",0,0,1,0,1
"cg11486094",9,10,1,0,20
"cg11488101",4,0,0,0,4
"cg11489821",38,9,1,0,48
"cg11490076",0,0,1,0,1
"cg11490961",0,1,0,0,1
"cg11490963",1,0,0,0,1
"cg11491436",2,0,0,0,2
"cg11491652",19,0,0,0,19
"cg11492102",0,1,0,0,1
"cg11494091",0,3,0,0,3
"cg11496209",0,0,0,1,1
"cg11496236",8,0,0,0,8
"cg11496364",0,0,6,0,6
"cg11497169",0,0,1,0,1
"cg11497864",1,0,0,0,1
"cg11499689",6,0,0,0,6
"cg11499807",0,0,1,0,1
"cg11501236",1,0,0,0,1
"cg11501413",1,0,0,0,1
"cg11501438",0,0,2,0,2
"cg11502075",4,3,0,0,7
"cg11503287",1,2,2,0,5
"cg11503599",5,0,2,0,7
"cg11503966",0,0,1,0,1
"cg11504176",0,1,0,0,1
"cg11504245",1,0,0,0,1
"cg11506157",0,2,1,0,3
"cg11506843",2,9,10,0,21
"cg11507713",1,0,0,0,1
"cg11507793",0,0,2,0,2
"cg11509822",0,1,0,0,1
"cg11510523",2,0,0,0,2
"cg11511035",1,0,0,0,1
"cg11511120",0,1,0,0,1
"cg11511278",2,0,0,0,2
"cg11511702",128,22,1,0,151
"cg11511869",1,0,0,0,1
"cg11512014",2,5,1,0,8
"cg11512333",0,0,1,0,1
"cg11512407",3,3,0,0,6
"cg11513856",0,0,1,0,1
"cg11514055",0,0,1,0,1
"cg11516613",0,5,7,0,12
"cg11518507",0,0,1,0,1
"cg11519321",0,0,1,0,1
"cg11520194",0,1,5,0,6
"cg11520614",0,1,0,0,1
"cg11520938",0,0,1,0,1
"cg11521453",0,0,1,0,1
"cg11522804",0,1,0,0,1
"cg11523381",197,7,0,0,204
"cg11523499",2,1,0,0,3
"cg11523905",0,1,0,0,1
"cg11524260",0,2,5,0,7
"cg11524309",4,0,3,0,7
"cg11524576",1,0,0,0,1
"cg11524593",4,0,0,0,4
"cg11525120",384,65,5,0,454
"cg11526367",4,0,0,0,4
"cg11526455",4,1,0,0,5
"cg11527034",0,0,2,0,2
"cg11527344",0,1,0,0,1
"cg11527367",8,0,1,0,9
"cg11528029",0,1,0,0,1
"cg11528448",0,1,0,0,1
"cg11528572",14,3,0,0,17
"cg11528594",0,0,1,0,1
"cg11529787",0,0,1,0,1
"cg11530582",12,1,2,0,15
"cg11532182",1,0,0,0,1
"cg11532921",0,1,0,0,1
"cg11532971",4,6,0,0,10
"cg11533628",1,6,1,0,8
"cg11533851",0,0,1,0,1
"cg11533881",2,3,0,0,5
"cg11533926",184,6,1,0,191
"cg11535343",1,0,0,0,1
"cg11535419",1,1,0,0,2
"cg11535445",19,13,1,0,33
"cg11537399",2,0,0,0,2
"cg11537447",1,0,0,0,1
"cg11538389",2,5,5,0,12
"cg11539066",0,0,1,0,1
"cg11540001",1,3,0,0,4
"cg11540053",23,1,0,0,24
"cg11540707",1,0,0,0,1
"cg11541124",1,0,1,0,2
"cg11541404",584,67,3,0,654
"cg11541678",0,0,1,0,1
"cg11544115",1,0,0,0,1
"cg11544377",0,0,1,0,1
"cg11544953",206,25,0,0,231
"cg11546632",0,0,1,0,1
"cg11549020",46,24,5,0,75
"cg11549265",0,0,1,0,1
"cg11549871",7,7,0,0,14
"cg11551019",0,0,2,0,2
"cg11551296",0,1,0,0,1
"cg11552072",0,0,1,0,1
"cg11552079",78,16,4,0,98
"cg11553654",894,207,7,0,1108
"cg11553721",0,1,1,0,2
"cg11554331",0,0,1,0,1
"cg11555228",6,5,1,0,12
"cg11556408",0,0,1,0,1
"cg11557382",0,0,1,0,1
"cg11557415",0,3,1,0,4
"cg11557922",1,0,0,0,1
"cg11557959",0,0,1,0,1
"cg11558106",1,2,0,0,3
"cg11558453",0,0,1,0,1
"cg11558576",0,1,0,0,1
"cg11558633",0,0,1,0,1
"cg11558654",5,8,1,0,14
"cg11559852",0,0,1,0,1
"cg11560119",0,1,0,0,1
"cg11560593",39,0,0,0,39
"cg11561630",3,0,0,0,3
"cg11563127",0,1,0,0,1
"cg11563264",3,0,0,0,3
"cg11563321",0,1,0,0,1
"cg11563434",0,0,1,0,1
"cg11564005",52,1,0,0,53
"cg11564652",1,1,0,0,2
"cg11567012",0,1,1,0,2
"cg11568799",6,2,0,0,8
"cg11569008",0,1,1,0,2
"cg11570582",1,0,0,0,1
"cg11572559",1,0,0,1,2
"cg11572977",0,0,1,0,1
"cg11573123",162,4,0,0,166
"cg11573197",8,1,0,0,9
"cg11574174",0,0,1,0,1
"cg11574248",0,1,2,0,3
"cg11574645",303,18,0,0,321
"cg11575123",2,1,0,0,3
"cg11575784",2,2,1,0,5
"cg11575922",0,0,2,0,2
"cg11576274",0,2,0,0,2
"cg11576302",0,1,0,0,1
"cg11576367",0,0,1,0,1
"cg11577174",0,0,2,0,2
"cg11577661",2,0,0,0,2
"cg11577765",122,4,0,0,126
"cg11577942",0,0,2,0,2
"cg11579907",1,0,0,0,1
"cg11581271",0,2,0,0,2
"cg11582998",2,0,0,0,2
"cg11583100",0,1,0,0,1
"cg11583211",0,1,0,0,1
"cg11583907",0,0,2,0,2
"cg11584613",1,0,0,0,1
"cg11586216",0,0,1,0,1
"cg11587748",0,1,0,0,1
"cg11587839",0,1,1,0,2
"cg11588423",2,0,0,0,2
"cg11588975",0,2,0,0,2
"cg11589532",3,0,0,0,3
"cg11589664",1,0,14,0,15
"cg11590807",3,0,0,0,3
"cg11590993",1,0,0,0,1
"cg11591148",0,1,0,0,1
"cg11591331",0,0,1,0,1
"cg11592135",2,0,0,0,2
"cg11592149",118,36,2,0,156
"cg11592242",1,4,6,0,11
"cg11592938",3,2,0,0,5
"cg11593123",0,0,1,0,1
"cg11593895",3,0,0,0,3
"cg11594566",1,0,0,0,1
"cg11594733",76,7,0,0,83
"cg11595993",1,5,3,0,9
"cg11596075",0,0,1,0,1
"cg11596845",1,0,1,0,2
"cg11597080",0,0,1,0,1
"cg11597969",0,3,3,0,6
"cg11598492",1,0,0,0,1
"cg11598736",0,1,1,0,2
"cg11598897",0,1,0,0,1
"cg11599269",1,0,0,0,1
"cg11599457",1,0,0,0,1
"cg11601545",7,0,0,0,7
"cg11602798",0,0,1,0,1
"cg11603406",0,1,0,0,1
"cg11604024",0,0,1,0,1
"cg11604182",0,0,2,0,2
"cg11604715",0,0,1,0,1
"cg11607474",3,0,0,0,3
"cg11607603",0,0,1,0,1
"cg11607737",0,0,1,0,1
"cg11608241",0,6,2,0,8
"cg11608447",1,8,0,0,9
"cg11609895",36,7,0,0,43
"cg11609940",0,0,1,0,1
"cg11610140",0,4,0,0,4
"cg11612140",1,0,0,0,1
"cg11612727",0,0,1,0,1
"cg11613425",0,0,1,0,1
"cg11615464",366,234,26,0,626
"cg11615495",0,6,2,0,8
"cg11616177",1,0,0,0,1
"cg11616547",0,1,0,0,1
"cg11616592",3,0,0,0,3
"cg11616732",1,0,0,0,1
"cg11616919",2,0,0,0,2
"cg11617965",28,36,0,0,64
"cg11618788",1,0,0,0,1
"cg11619264",5,0,0,0,5
"cg11619707",2,3,0,0,5
"cg11620204",3,1,0,0,4
"cg11621897",5,0,0,0,5
"cg11624085",4,10,14,0,28
"cg11626396",1,0,0,0,1
"cg11626882",0,0,1,0,1
"cg11627894",2,1,2,0,5
"cg11628584",0,0,1,0,1
"cg11629355",0,1,1,0,2
"cg11629919",1,0,0,0,1
"cg11630939",1,0,0,0,1
"cg11631579",0,4,1,0,5
"cg11632499",11,1,0,0,12
"cg11633126",1,0,0,0,1
"cg11633204",2,0,0,0,2
"cg11633473",1,1,0,0,2
"cg11635100",1,1,1,0,3
"cg11636631",0,0,2,0,2
"cg11636702",0,1,0,0,1
"cg11636960",0,1,0,0,1
"cg11637566",1,0,1,0,2
"cg11637792",0,0,1,0,1
"cg11638015",5,0,0,0,5
"cg11638921",1,0,0,0,1
"cg11640146",16,0,0,0,16
"cg11640979",0,0,2,0,2
"cg11641738",78,27,5,0,110
"cg11642250",2,0,0,0,2
"cg11642615",5,6,0,0,11
"cg11644717",0,1,0,0,1
"cg11644909",1,0,0,0,1
"cg11644973",0,1,0,0,1
"cg11645198",1,0,1,0,2
"cg11646366",1,0,0,0,1
"cg11646485",81,9,0,0,90
"cg11647478",0,0,1,0,1
"cg11648383",16,1,0,0,17
"cg11648402",21,10,1,0,32
"cg11648996",0,1,1,0,2
"cg11649288",0,1,0,0,1
"cg11649641",1,2,0,0,3
"cg11650805",0,0,1,0,1
"cg11651106",0,0,1,1,2
"cg11651238",0,0,1,0,1
"cg11651569",0,1,0,0,1
"cg11652095",1,0,0,0,1
"cg11652329",0,1,0,0,1
"cg11654133",2,1,0,0,3
"cg11655556",0,1,0,0,1
"cg11655995",97,11,0,0,108
"cg11656405",53,41,23,0,117
"cg11656748",0,0,1,0,1
"cg11656920",1,2,0,0,3
"cg11658054",1,2,1,0,4
"cg11658955",0,1,0,0,1
"cg11659320",3,0,0,0,3
"cg11659391",1,2,1,0,4
"cg11660569",857,36,0,0,893
"cg11661134",0,1,0,0,1
"cg11661534",1,1,0,0,2
"cg11662187",2,0,0,0,2
"cg11662452",0,1,1,0,2
"cg11662714",0,1,0,0,1
"cg11662871",1,0,0,0,1
"cg11663554",3,1,0,0,4
"cg11664379",5,0,0,0,5
"cg11666438",0,0,1,0,1
"cg11666731",5,2,0,0,7
"cg11667031",29,9,2,0,40
"cg11667117",1,0,0,0,1
"cg11667643",0,0,3,0,3
"cg11667823",18,1,0,0,19
"cg11669319",7,14,26,0,47
"cg11669400",701,118,5,0,824
"cg11669538",0,1,0,0,1
"cg11669539",9,0,5,0,14
"cg11670321",1,0,0,0,1
"cg11670713",3,1,0,0,4
"cg11673505",93,19,0,0,112
"cg11673833",0,0,1,0,1
"cg11674508",179,1,0,0,180
"cg11674953",1,2,6,0,9
"cg11675359",211,558,1,0,770
"cg11675917",1,0,0,0,1
"cg11677597",5,1,0,0,6
"cg11677891",1,1,0,0,2
"cg11678250",0,1,0,0,1
"cg11680055",0,1,0,0,1
"cg11681219",0,2,0,0,2
"cg11681259",0,2,0,0,2
"cg11682263",12,12,0,0,24
"cg11682881",14,0,0,0,14
"cg11683050",2,0,0,0,2
"cg11684679",0,0,1,0,1
"cg11684734",0,1,0,0,1
"cg11684857",0,1,1,0,2
"cg11686069",1,0,0,0,1
"cg11686204",0,0,1,0,1
"cg11686427",0,0,1,0,1
"cg11687341",0,1,0,0,1
"cg11689605",7,0,0,0,7
"cg11689744",6,0,0,0,6
"cg11692452",0,0,4,0,4
"cg11693019",0,0,1,0,1
"cg11694026",2,0,0,0,2
"cg11694968",0,1,0,0,1
"cg11696173",133,70,93,0,296
"cg11696685",0,0,1,0,1
"cg11696823",0,0,1,0,1
"cg11696829",0,0,1,0,1
"cg11697695",5,1,0,0,6
"cg11697861",0,1,0,0,1
"cg11698529",0,1,0,0,1
"cg11698918",1,1,1,0,3
"cg11699845",0,2,1,0,3
"cg11700349",7,1,5,0,13
"cg11700735",0,0,1,0,1
"cg11700985",1,9,2,0,12
"cg11702513",1,2,0,0,3
"cg11704667",1,0,0,0,1
"cg11704818",3,0,0,0,3
"cg11706213",1,0,0,0,1
"cg11706835",0,0,0,1,1
"cg11707296",15,2,9,0,26
"cg11707556",3,2,1,0,6
"cg11709413",2,0,0,0,2
"cg11709905",4,0,0,0,4
"cg11710256",5,0,0,0,5
"cg11710656",0,1,0,0,1
"cg11710764",0,0,1,0,1
"cg11711062",3,3,5,0,11
"cg11712105",1,2,0,0,3
"cg11712459",0,1,0,0,1
"cg11715424",0,0,1,0,1
"cg11716884",0,0,1,0,1
"cg11717315",0,0,1,0,1
"cg11717743",1,0,1,0,2
"cg11717881",0,0,1,0,1
"cg11718312",0,0,1,0,1
"cg11718739",1,2,3,0,6
"cg11718741",0,0,0,1,1
"cg11721026",1,0,0,0,1
"cg11721084",0,0,3,0,3
"cg11721740",3,1,0,0,4
"cg11722850",1,0,0,0,1
"cg11723055",2,0,0,0,2
"cg11724671",2,3,1,0,6
"cg11725009",1,0,1,0,2
"cg11725718",1,0,2,0,3
"cg11728826",1,1,0,0,2
"cg11729241",4,1,0,0,5
"cg11729481",0,0,1,0,1
"cg11730374",388,31,0,0,419
"cg11730547",1,1,0,0,2
"cg11731031",1,0,0,0,1
"cg11731309",3,0,0,0,3
"cg11731337",0,1,0,0,1
"cg11731746",425,9,0,0,434
"cg11731845",1,0,2,0,3
"cg11732197",0,0,1,0,1
"cg11733222",1,0,0,0,1
"cg11733408",0,7,6,0,13
"cg11734164",0,0,1,0,1
"cg11734324",0,0,1,0,1
"cg11734492",1,0,0,0,1
"cg11734682",1,0,0,0,1
"cg11735371",0,0,1,0,1
"cg11735864",0,0,1,0,1
"cg11736557",1,0,0,0,1
"cg11736774",0,1,0,0,1
"cg11737062",0,0,1,0,1
"cg11737433",0,1,0,0,1
"cg11738634",46,10,2,0,58
"cg11739512",0,5,3,0,8
"cg11740619",1,0,0,0,1
"cg11741432",0,1,0,0,1
"cg11742383",2,0,0,0,2
"cg11744777",0,0,1,0,1
"cg11745084",233,10,0,0,243
"cg11745357",2,4,0,0,6
"cg11745481",7,0,0,0,7
"cg11745795",1,0,0,0,1
"cg11746498",46,4,1,0,51
"cg11746806",0,0,1,0,1
"cg11747247",1,0,0,0,1
"cg11747876",3,0,1,0,4
"cg11748881",3,0,0,0,3
"cg11750165",0,1,2,0,3
"cg11751231",0,1,0,0,1
"cg11751233",199,147,5,0,351
"cg11752118",3,1,2,0,6
"cg11752817",0,0,1,0,1
"cg11753004",99,16,0,0,115
"cg11753328",0,0,3,0,3
"cg11754117",0,0,2,0,2
"cg11754652",1,0,0,0,1
"cg11754914",0,2,1,0,3
"cg11754921",0,0,1,0,1
"cg11755020",1,1,0,0,2
"cg11755395",0,1,0,0,1
"cg11756336",62,22,2,0,86
"cg11757672",877,205,5,0,1087
"cg11758022",1,0,1,0,2
"cg11759283",1,0,0,0,1
"cg11759359",4,2,0,0,6
"cg11760361",4,2,0,0,6
"cg11760389",6,0,0,0,6
"cg11760700",1,4,5,0,10
"cg11761954",26,1,0,0,27
"cg11762838",0,0,2,0,2
"cg11763293",0,1,0,0,1
"cg11763643",0,0,2,0,2
"cg11766676",0,1,3,0,4
"cg11768021",6,0,1,0,7
"cg11768612",2,1,1,0,4
"cg11769420",0,0,1,0,1
"cg11769841",1,0,1,0,2
"cg11769925",97,124,50,0,271
"cg11770325",2,0,0,0,2
"cg11770355",0,1,0,0,1
"cg11771692",7,4,13,0,24
"cg11772310",0,2,0,0,2
"cg11772995",0,0,0,1,1
"cg11773920",0,0,1,0,1
"cg11774232",0,0,2,0,2
"cg11774545",0,0,1,0,1
"cg11774633",1,0,0,0,1
"cg11775291",0,0,1,0,1
"cg11776325",2,0,0,0,2
"cg11776336",0,1,0,0,1
"cg11777290",0,0,1,0,1
"cg11777390",0,2,6,0,8
"cg11777978",0,0,1,0,1
"cg11779605",4,1,0,0,5
"cg11780005",0,6,14,0,20
"cg11781154",142,382,33,0,557
"cg11781306",6,1,1,0,8
"cg11781535",1,4,2,0,7
"cg11781723",6,0,1,0,7
"cg11781854",0,0,1,0,1
"cg11781977",93,32,0,0,125
"cg11782409",1,0,0,0,1
"cg11782634",0,1,0,0,1
"cg11783003",1,0,0,0,1
"cg11783367",0,0,1,0,1
"cg11783520",14,7,2,0,23
"cg11784147",4,0,0,0,4
"cg11784319",0,0,1,0,1
"cg11784437",0,0,0,2,2
"cg11784667",0,1,0,0,1
"cg11785465",7,5,10,0,22
"cg11786283",9,1,0,0,10
"cg11786428",7,0,2,0,9
"cg11786476",0,0,1,0,1
"cg11787062",0,0,1,0,1
"cg11788010",0,0,1,0,1
"cg11788447",3,1,0,0,4
"cg11789062",8,10,4,0,22
"cg11789281",1,0,0,0,1
"cg11789992",16,1,1,0,18
"cg11790580",0,1,0,0,1
"cg11791725",0,1,1,0,2
"cg11791847",778,474,15,0,1267
"cg11792281",2,1,0,0,3
"cg11792888",0,1,0,0,1
"cg11793499",1,0,0,0,1
"cg11793581",4,5,0,0,9
"cg11794151",420,162,9,0,591
"cg11794877",0,3,1,0,4
"cg11795459",0,1,1,0,2
"cg11796746",1,0,0,0,1
"cg11796856",1,0,0,0,1
"cg11797099",0,1,0,0,1
"cg11797265",12,3,0,0,15
"cg11797398",5,4,0,0,9
"cg11797573",0,0,14,0,14
"cg11797803",0,5,5,0,10
"cg11797994",0,0,3,0,3
"cg11798685",0,3,1,0,4
"cg11798864",0,0,2,0,2
"cg11800251",1,0,0,0,1
"cg11800577",42,64,34,0,140
"cg11800635",1,0,0,0,1
"cg11800888",721,104,5,0,830
"cg11801317",1,0,1,0,2
"cg11802188",1,0,0,0,1
"cg11802274",4,4,1,1,10
"cg11803278",0,0,1,0,1
"cg11803635",0,0,1,0,1
"cg11805027",1,0,0,0,1
"cg11805252",12,6,0,0,18
"cg11805548",1,0,0,0,1
"cg11805852",1,0,0,0,1
"cg11806305",407,64,1,0,472
"cg11806559",5,0,0,0,5
"cg11806680",8,1,1,0,10
"cg11806813",307,76,7,0,390
"cg11807261",1,0,0,0,1
"cg11807290",0,0,0,1,1
"cg11807329",1,0,0,0,1
"cg11807492",0,3,0,0,3
"cg11808099",1,14,7,0,22
"cg11808237",3,0,0,0,3
"cg11809269",1,0,0,0,1
"cg11809449",0,1,0,0,1
"cg11810888",0,0,1,0,1
"cg11811184",22,1,0,0,23
"cg11811632",2,0,0,0,2
"cg11811859",1,0,0,0,1
"cg11811873",0,1,1,0,2
"cg11811959",142,2,0,0,144
"cg11812439",0,0,1,0,1
"cg11812525",1,0,0,0,1
"cg11814107",0,0,1,0,1
"cg11814219",0,1,0,0,1
"cg11814421",0,1,0,0,1
"cg11814956",1,0,0,0,1
"cg11815388",1,0,0,0,1
"cg11816852",9,3,0,0,12
"cg11817611",0,0,1,0,1
"cg11817910",0,1,0,0,1
"cg11818241",0,1,0,0,1
"cg11818631",0,2,1,0,3
"cg11819497",0,1,1,0,2
"cg11819646",252,9,0,0,261
"cg11820828",0,4,1,0,5
"cg11822208",1,3,1,0,5
"cg11822772",0,0,1,0,1
"cg11824301",1,0,0,0,1
"cg11824771",0,3,0,0,3
"cg11824823",0,1,0,0,1
"cg11825524",1,0,0,0,1
"cg11825564",60,41,0,0,101
"cg11829528",53,61,8,0,122
"cg11829841",1,1,0,0,2
"cg11830433",0,0,1,0,1
"cg11832308",3,0,5,0,8
"cg11834064",0,1,0,0,1
"cg11834744",25,2,0,0,27
"cg11836119",1,0,0,0,1
"cg11836587",0,1,0,0,1
"cg11836817",0,0,1,0,1
"cg11837275",2,0,0,0,2
"cg11837451",604,38,0,0,642
"cg11837744",3,0,0,0,3
"cg11840525",0,0,2,0,2
"cg11841331",0,0,1,0,1
"cg11842425",0,0,1,0,1
"cg11842791",0,0,1,0,1
"cg11842944",0,1,0,0,1
"cg11843516",1,0,0,0,1
"cg11843753",0,0,1,0,1
"cg11843814",1,0,0,0,1
"cg11844172",0,1,0,0,1
"cg11844369",0,0,0,1,1
"cg11844927",12,2,0,0,14
"cg11845410",3,0,0,0,3
"cg11845486",26,2,0,0,28
"cg11846151",18,0,0,0,18
"cg11846226",68,4,0,0,72
"cg11847115",0,0,2,0,2
"cg11848060",0,0,1,0,1
"cg11848496",0,2,1,0,3
"cg11849384",3,0,0,0,3
"cg11849420",1,0,0,0,1
"cg11849493",0,0,1,0,1
"cg11851257",0,0,1,0,1
"cg11852073",111,5,1,0,117
"cg11854217",0,1,3,0,4
"cg11854356",2,0,4,0,6
"cg11854664",1,1,0,0,2
"cg11854740",4,0,0,0,4
"cg11854877",0,0,2,0,2
"cg11855615",0,1,0,0,1
"cg11856111",0,0,1,0,1
"cg11856308",0,0,1,0,1
"cg11856489",0,0,1,0,1
"cg11857452",14,3,0,0,17
"cg11858880",1,0,0,0,1
"cg11859176",70,9,0,0,79
"cg11859345",351,219,5,0,575
"cg11859426",0,0,3,0,3
"cg11859641",2,0,1,0,3
"cg11860840",1,0,0,0,1
"cg11861206",19,27,2,0,48
"cg11861308",5,3,1,1,10
"cg11861845",2,0,0,1,3
"cg11861940",39,0,0,0,39
"cg11863339",0,1,0,0,1
"cg11863573",0,1,0,0,1
"cg11863819",465,38,1,0,504
"cg11864592",0,1,0,0,1
"cg11864993",3,2,6,0,11
"cg11865834",0,1,1,0,2
"cg11866789",0,0,1,0,1
"cg11867295",1,0,0,0,1
"cg11867393",1,0,0,0,1
"cg11867420",2,3,0,0,5
"cg11867459",25,0,0,0,25
"cg11867651",1,1,1,0,3
"cg11867858",487,16,0,0,503
"cg11868553",1,0,0,0,1
"cg11869186",16,2,0,0,18
"cg11870702",2,0,0,0,2
"cg11872086",0,0,1,0,1
"cg11872186",1,0,0,0,1
"cg11872443",239,4,0,0,243
"cg11872478",4,0,0,0,4
"cg11872645",0,0,1,0,1
"cg11874630",0,0,1,0,1
"cg11874762",1,6,0,0,7
"cg11875155",0,0,1,0,1
"cg11876524",7,4,3,0,14
"cg11877232",0,0,2,0,2
"cg11877424",0,0,1,0,1
"cg11878182",0,0,1,0,1
"cg11879378",0,0,0,1,1
"cg11879998",5,0,0,0,5
"cg11880023",0,1,0,0,1
"cg11880701",1,0,0,0,1
"cg11881003",2,0,1,0,3
"cg11881141",1,0,0,0,1
"cg11882405",0,1,0,0,1
"cg11883221",2,0,0,0,2
"cg11883358",0,0,3,0,3
"cg11883538",23,10,0,0,33
"cg11884217",2,3,1,0,6
"cg11884248",0,0,1,0,1
"cg11884316",1,0,0,0,1
"cg11884689",1,0,0,0,1
"cg11884957",6,1,0,0,7
"cg11885100",0,0,2,0,2
"cg11886286",0,1,0,0,1
"cg11886777",1,1,5,0,7
"cg11887774",0,0,1,0,1
"cg11887827",0,0,1,0,1
"cg11887864",0,1,0,0,1
"cg11888420",2,2,1,0,5
"cg11889098",0,0,1,0,1
"cg11890744",7,5,0,0,12
"cg11890793",2,0,0,0,2
"cg11891431",0,0,1,0,1
"cg11892071",1,0,0,0,1
"cg11893399",1,0,0,0,1
"cg11893547",0,1,0,0,1
"cg11894273",0,0,2,0,2
"cg11894324",3,2,1,1,7
"cg11896012",2,0,0,0,2
"cg11896111",1,0,0,0,1
"cg11896623",313,225,3,0,541
"cg11898129",1,0,0,0,1
"cg11899239",4,0,0,0,4
"cg11899622",0,2,0,0,2
"cg11899772",1,0,0,0,1
"cg11900465",1,1,1,0,3
"cg11901271",0,0,2,0,2
"cg11902296",19,12,1,0,32
"cg11902406",1,1,0,0,2
"cg11902554",9,0,0,0,9
"cg11902995",0,0,1,0,1
"cg11903210",0,0,1,0,1
"cg11904204",1,0,1,0,2
"cg11904385",1,0,4,0,5
"cg11905131",0,0,2,0,2
"cg11905824",0,1,0,0,1
"cg11905915",6,3,1,0,10
"cg11907532",7,0,0,0,7
"cg11907810",7,0,0,0,7
"cg11909526",0,1,0,0,1
"cg11910105",0,2,6,0,8
"cg11911305",0,1,0,0,1
"cg11912513",0,1,3,0,4
"cg11913137",0,1,0,0,1
"cg11913695",0,0,1,0,1
"cg11914256",0,0,1,0,1
"cg11914812",0,2,0,0,2
"cg11914967",6,0,0,0,6
"cg11915635",15,3,0,0,18
"cg11915671",0,1,0,0,1
"cg11917288",1,0,0,0,1
"cg11917734",0,1,0,0,1
"cg11917755",0,0,3,0,3
"cg11918051",52,46,2,0,100
"cg11918057",0,1,0,0,1
"cg11920576",10,5,1,0,16
"cg11924380",0,1,2,0,3
"cg11925066",0,1,0,0,1
"cg11925631",256,13,0,0,269
"cg11926425",1,0,0,0,1
"cg11926928",3,5,0,0,8
"cg11926971",35,16,0,0,51
"cg11927260",4,1,0,0,5
"cg11927738",0,0,2,0,2
"cg11927995",1,0,0,0,1
"cg11928962",24,0,0,0,24
"cg11929604",0,0,1,0,1
"cg11930700",46,30,0,0,76
"cg11930746",1,0,0,0,1
"cg11931697",1,0,1,0,2
"cg11931798",14,1,0,0,15
"cg11931804",0,0,1,0,1
"cg11933047",0,0,1,0,1
"cg11935282",0,0,1,0,1
"cg11936277",1,0,0,0,1
"cg11936304",0,0,1,0,1
"cg11937681",0,0,3,0,3
"cg11937778",26,1,0,0,27
"cg11937892",0,1,1,0,2
"cg11938051",0,4,6,2,12
"cg11938395",0,0,1,0,1
"cg11938958",1,0,1,0,2
"cg11939992",0,1,3,1,5
"cg11940136",3,0,0,0,3
"cg11940920",1,0,0,0,1
"cg11941300",0,0,1,0,1
"cg11941878",2,0,1,0,3
"cg11941967",1,4,5,0,10
"cg11942780",4,1,2,0,7
"cg11942910",1,0,0,0,1
"cg11943372",0,1,0,0,1
"cg11943545",22,10,0,0,32
"cg11943753",2,0,0,0,2
"cg11943817",0,1,0,0,1
"cg11944024",2,0,0,0,2
"cg11944219",0,0,1,0,1
"cg11945472",1,0,0,0,1
"cg11946583",4,0,0,0,4
"cg11947310",0,7,4,0,11
"cg11948328",0,1,0,0,1
"cg11948339",2,0,0,0,2
"cg11949115",2,0,0,0,2
"cg11949172",2,1,1,0,4
"cg11949699",0,0,1,0,1
"cg11951844",0,1,0,0,1
"cg11952263",1,2,0,0,3
"cg11952858",0,0,1,0,1
"cg11953079",0,5,0,0,5
"cg11953868",0,1,0,0,1
"cg11953885",1,1,0,0,2
"cg11953974",1,0,0,0,1
"cg11954725",0,0,2,0,2
"cg11955508",9,10,0,0,19
"cg11955727",0,0,4,0,4
"cg11957128",1,6,1,0,8
"cg11958221",0,0,1,0,1
"cg11958792",1,1,0,0,2
"cg11958933",4,23,12,0,39
"cg11959954",1,2,0,0,3
"cg11960212",1,0,0,0,1
"cg11961834",0,3,7,0,10
"cg11962291",1,0,0,0,1
"cg11962649",0,1,0,0,1
"cg11963854",0,0,1,0,1
"cg11964099",9,4,0,0,13
"cg11964474",0,1,0,0,1
"cg11964613",0,0,1,0,1
"cg11964823",1,0,0,0,1
"cg11965331",0,0,1,0,1
"cg11965372",5,5,0,0,10
"cg11966215",1,0,0,0,1
"cg11967057",4,8,5,0,17
"cg11967648",193,138,2,0,333
"cg11968166",210,231,16,0,457
"cg11969064",1,0,0,0,1
"cg11969334",0,1,0,0,1
"cg11970085",3,0,0,0,3
"cg11970804",2,3,0,0,5
"cg11970982",2,5,5,0,12
"cg11973167",135,5,0,0,140
"cg11973587",114,701,17,0,832
"cg11973623",1,0,0,0,1
"cg11973716",14,0,0,0,14
"cg11974937",0,0,2,0,2
"cg11975999",15,3,0,0,18
"cg11978022",0,1,0,0,1
"cg11978387",0,0,1,0,1
"cg11978435",88,22,0,0,110
"cg11978700",2,0,0,0,2
"cg11978784",1,0,0,0,1
"cg11979055",1,0,4,0,5
"cg11979129",0,4,4,0,8
"cg11979591",1,0,0,0,1
"cg11979759",1,0,0,0,1
"cg11980781",0,0,1,0,1
"cg11980898",1,0,0,0,1
"cg11981010",0,0,1,0,1
"cg11981372",0,0,1,0,1
"cg11982718",0,0,1,0,1
"cg11983277",0,0,1,0,1
"cg11983867",1,0,0,0,1
"cg11984269",1,1,0,0,2
"cg11984911",0,0,2,0,2
"cg11986221",2,0,0,0,2
"cg11988531",0,0,1,0,1
"cg11988985",0,1,1,0,2
"cg11989931",0,0,1,0,1
"cg11990281",3,0,8,0,11
"cg11990305",0,1,4,0,5
"cg11992333",47,18,0,0,65
"cg11993253",45,1,0,0,46
"cg11993991",0,0,1,0,1
"cg11994584",0,0,1,0,1
"cg11994864",0,0,1,0,1
"cg11995638",1,0,0,0,1
"cg11996397",0,0,2,0,2
"cg11996527",6,0,0,0,6
"cg11996618",2,1,0,0,3
"cg11996791",0,1,5,0,6
"cg11996829",1,0,0,0,1
"cg11997223",0,0,1,0,1
"cg11998916",1,0,0,0,1
"cg11999044",0,3,1,0,4
"cg11999665",0,1,0,0,1
"cg12001709",0,0,2,0,2
"cg12001723",1,2,2,0,5
"cg12003026",3,1,6,0,10
"cg12003318",1,0,0,0,1
"cg12003496",4,9,11,0,24
"cg12003990",0,0,1,0,1
"cg12004762",0,0,1,0,1
"cg12005122",2,1,1,0,4
"cg12005599",0,0,1,0,1
"cg12007584",2,1,0,0,3
"cg12008080",0,0,1,0,1
"cg12008991",0,1,0,0,1
"cg12008996",0,0,5,0,5
"cg12010373",0,0,1,0,1
"cg12010754",8,2,0,0,10
"cg12011596",0,0,1,0,1
"cg12012058",1,0,0,0,1
"cg12013590",1,0,0,0,1
"cg12014145",1,0,2,0,3
"cg12014726",54,5,0,0,59
"cg12015264",1,0,0,0,1
"cg12015355",2,0,0,0,2
"cg12015748",0,1,1,0,2
"cg12017321",0,1,0,0,1
"cg12019814",0,0,1,0,1
"cg12020954",66,1,0,0,67
"cg12021641",1,0,1,0,2
"cg12021843",732,40,1,0,773
"cg12022142",36,33,1,0,70
"cg12022824",1,0,0,0,1
"cg12023844",0,0,1,0,1
"cg12024190",0,0,1,0,1
"cg12024236",0,0,2,0,2
"cg12024968",8,2,0,0,10
"cg12026538",0,0,1,1,2
"cg12027076",9,3,0,0,12
"cg12027365",0,0,2,0,2
"cg12027376",1,0,4,0,5
"cg12027401",4,0,0,0,4
"cg12028326",0,0,1,0,1
"cg12029507",0,1,0,0,1
"cg12031103",1,0,0,0,1
"cg12032347",0,0,1,0,1
"cg12032821",0,1,0,0,1
"cg12033031",3,1,0,0,4
"cg12033679",1,0,0,0,1
"cg12034086",4,1,0,0,5
"cg12034199",0,1,1,0,2
"cg12034227",3,7,3,0,13
"cg12034745",2,0,0,0,2
"cg12034979",0,0,0,1,1
"cg12035144",0,1,0,0,1
"cg12036389",22,15,3,0,40
"cg12036829",6,2,0,0,8
"cg12037916",168,373,26,0,567
"cg12038352",0,1,0,0,1
"cg12038583",1,0,1,0,2
"cg12038788",1,0,0,0,1
"cg12038958",3,1,0,0,4
"cg12039314",1,0,0,0,1
"cg12041245",10,0,0,0,10
"cg12041338",0,0,0,1,1
"cg12041456",0,1,2,0,3
"cg12041841",505,46,0,0,551
"cg12042055",0,2,1,0,3
"cg12042787",0,0,1,0,1
"cg12043473",0,1,0,0,1
"cg12043793",0,1,0,0,1
"cg12044250",15,2,1,0,18
"cg12044338",0,1,0,0,1
"cg12044749",3,0,0,0,3
"cg12045237",0,1,0,0,1
"cg12045430",0,1,3,0,4
"cg12046183",2,0,0,0,2
"cg12047721",0,0,2,0,2
"cg12048339",28,18,2,0,48
"cg12048345",0,0,1,0,1
"cg12048375",0,0,1,0,1
"cg12049322",324,228,19,0,571
"cg12049367",0,0,1,0,1
"cg12049769",2,0,1,0,3
"cg12049961",1,0,0,0,1
"cg12050288",9,1,0,0,10
"cg12050706",0,2,2,0,4
"cg12051096",1,2,1,0,4
"cg12051203",3,0,2,0,5
"cg12053105",1,4,0,0,5
"cg12054177",0,1,0,0,1
"cg12054698",0,1,0,0,1
"cg12055075",0,1,0,0,1
"cg12055940",3,1,3,0,7
"cg12056733",0,0,1,0,1
"cg12057368",37,4,0,0,41
"cg12058539",2,0,0,0,2
"cg12058781",45,45,1,0,91
"cg12059804",2,1,0,0,3
"cg12060132",1,0,1,0,2
"cg12061113",1,0,0,0,1
"cg12062127",1,0,0,0,1
"cg12062492",1,0,0,0,1
"cg12062843",1,6,9,0,16
"cg12062886",0,0,2,0,2
"cg12063218",0,0,1,0,1
"cg12063583",0,0,1,0,1
"cg12063821",0,0,3,0,3
"cg12063918",0,1,0,0,1
"cg12064507",0,0,1,0,1
"cg12065562",6,0,0,0,6
"cg12066583",0,1,0,0,1
"cg12067024",0,1,0,0,1
"cg12068411",0,0,1,0,1
"cg12068737",0,1,0,0,1
"cg12069991",16,0,0,0,16
"cg12070304",139,102,5,0,246
"cg12070351",0,0,2,0,2
"cg12072677",233,166,21,0,420
"cg12073208",0,0,1,0,1
"cg12073326",3,1,0,0,4
"cg12073828",1,0,0,0,1
"cg12073910",1170,127,1,0,1298
"cg12073911",0,1,0,0,1
"cg12074035",0,0,1,0,1
"cg12074375",10,0,0,0,10
"cg12074655",0,0,2,0,2
"cg12074915",3,2,0,0,5
"cg12076546",1,0,0,0,1
"cg12077331",8,0,0,0,8
"cg12078397",1,0,0,0,1
"cg12078937",1,0,0,0,1
"cg12079020",22,2,0,0,24
"cg12079923",1,0,0,0,1
"cg12080757",0,6,0,0,6
"cg12080791",0,2,0,0,2
"cg12082065",1,0,0,0,1
"cg12083655",4,5,0,0,9
"cg12084073",1,0,0,0,1
"cg12084407",270,51,2,0,323
"cg12084602",0,0,3,0,3
"cg12084866",1,1,0,0,2
"cg12085321",1,1,0,0,2
"cg12085619",0,0,1,0,1
"cg12086384",1,0,0,0,1
"cg12087615",3,0,0,0,3
"cg12089350",0,1,0,0,1
"cg12089827",0,1,0,0,1
"cg12090654",0,0,4,0,4
"cg12092392",0,1,0,0,1
"cg12093005",0,0,1,0,1
"cg12093443",5,0,0,0,5
"cg12094029",0,1,0,0,1
"cg12094917",0,0,2,0,2
"cg12095067",0,1,0,0,1
"cg12095132",1,0,0,0,1
"cg12095324",0,1,0,0,1
"cg12095533",4,0,0,0,4
"cg12097243",1,3,2,0,6
"cg12099505",16,2,0,0,18
"cg12099785",0,1,0,0,1
"cg12100116",0,1,0,0,1
"cg12100614",1,0,0,0,1
"cg12100965",0,0,1,0,1
"cg12101572",28,31,2,0,61
"cg12101665",0,0,1,0,1
"cg12102432",48,8,3,0,59
"cg12103052",1,0,0,0,1
"cg12103792",0,0,1,0,1
"cg12103802",53,101,40,0,194
"cg12104496",0,0,1,0,1
"cg12104661",5,7,2,0,14
"cg12105374",1,0,0,0,1
"cg12105920",0,0,4,0,4
"cg12106346",1019,704,8,0,1731
"cg12107367",0,4,0,1,5
"cg12108337",2,0,0,0,2
"cg12109221",10,1,0,0,11
"cg12109482",0,1,0,0,1
"cg12109747",1,0,0,0,1
"cg12110333",0,3,1,0,4
"cg12110929",1,0,0,0,1
"cg12111164",1,0,0,0,1
"cg12112110",0,0,1,0,1
"cg12112521",0,0,1,0,1
"cg12112691",0,1,0,0,1
"cg12113101",0,0,1,0,1
"cg12113231",1,0,0,0,1
"cg12113395",1,0,0,0,1
"cg12116524",0,0,1,0,1
"cg12116697",1,5,5,0,11
"cg12117384",1,0,0,0,1
"cg12117860",0,0,1,0,1
"cg12118088",0,0,2,0,2
"cg12118972",1,2,1,0,4
"cg12119068",98,8,0,0,106
"cg12119383",1,0,2,0,3
"cg12120251",0,0,0,1,1
"cg12120491",26,3,0,0,29
"cg12121085",1,0,0,0,1
"cg12121446",0,0,1,0,1
"cg12121634",18,680,43,0,741
"cg12122961",0,2,0,0,2
"cg12123692",0,0,1,0,1
"cg12124032",320,91,2,0,413
"cg12124368",0,1,0,0,1
"cg12124409",0,0,1,0,1
"cg12126936",8,11,1,0,20
"cg12127356",1,0,0,0,1
"cg12128206",0,1,0,0,1
"cg12128330",21,9,0,0,30
"cg12128869",0,2,4,0,6
"cg12130523",1,0,0,0,1
"cg12130852",2,2,0,0,4
"cg12131939",0,0,1,0,1
"cg12133498",0,0,2,0,2
"cg12134994",1,0,0,0,1
"cg12135548",0,0,1,0,1
"cg12136274",1,0,0,0,1
"cg12136632",0,1,0,0,1
"cg12136731",2,2,0,0,4
"cg12136906",1,0,2,0,3
"cg12137247",3,1,0,0,4
"cg12138150",0,0,0,1,1
"cg12139156",8,1,0,0,9
"cg12139329",1,0,0,0,1
"cg12139479",4,0,0,0,4
"cg12139533",11,0,0,0,11
"cg12139873",3,1,0,0,4
"cg12140178",5,1,3,0,9
"cg12140391",0,0,1,0,1
"cg12141319",1,1,1,0,3
"cg12141744",2,2,0,0,4
"cg12142888",1,0,0,0,1
"cg12143648",22,1,0,0,23
"cg12143651",0,1,0,0,1
"cg12143767",82,4,0,0,86
"cg12145015",0,2,0,0,2
"cg12145456",1,0,0,0,1
"cg12145472",0,1,0,0,1
"cg12147643",0,0,1,0,1
"cg12147799",2,0,0,0,2
"cg12148574",0,0,1,0,1
"cg12149851",0,0,1,0,1
"cg12151850",0,1,1,0,2
"cg12153292",0,0,2,0,2
"cg12153529",0,1,0,0,1
"cg12153593",0,1,0,0,1
"cg12154749",1,0,0,0,1
"cg12155443",0,0,1,0,1
"cg12156301",243,601,13,0,857
"cg12156990",1,0,0,0,1
"cg12157184",0,0,0,2,2
"cg12157194",0,3,2,0,5
"cg12158546",1,0,0,0,1
"cg12158912",1,0,0,0,1
"cg12159028",1,0,0,1,2
"cg12159330",4,3,2,0,9
"cg12159836",317,323,47,0,687
"cg12159987",7,1,1,0,9
"cg12160317",1,0,0,0,1
"cg12161625",0,2,0,0,2
"cg12161970",0,0,2,0,2
"cg12162195",0,1,0,0,1
"cg12164975",160,181,15,0,356
"cg12165613",0,1,0,0,1
"cg12166782",1,1,0,0,2
"cg12170219",0,1,8,0,9
"cg12170560",5,32,1,0,38
"cg12170644",1,0,0,0,1
"cg12171360",0,1,0,0,1
"cg12171394",51,15,2,0,68
"cg12172295",0,0,1,0,1
"cg12173216",0,0,1,0,1
"cg12176110",0,0,1,0,1
"cg12176815",0,1,0,0,1
"cg12177058",0,0,1,0,1
"cg12177562",0,2,0,0,2
"cg12178088",0,1,0,0,1
"cg12179209",0,0,0,1,1
"cg12181798",4,1,0,0,5
"cg12181832",0,0,1,0,1
"cg12183124",1,5,0,0,6
"cg12183355",2,0,0,0,2
"cg12183549",2,0,0,0,2
"cg12184120",1,1,0,0,2
"cg12184168",3,0,0,0,3
"cg12184445",4,4,0,0,8
"cg12190125",296,143,14,0,453
"cg12190841",0,1,0,0,1
"cg12192813",0,0,1,0,1
"cg12194033",1,1,0,0,2
"cg12194929",1,0,0,0,1
"cg12195289",2,0,0,0,2
"cg12195444",0,3,1,0,4
"cg12195620",0,0,1,0,1
"cg12195624",2,0,0,0,2
"cg12197557",3,3,0,0,6
"cg12197573",0,3,3,0,6
"cg12201142",0,0,1,0,1
"cg12201380",12,0,0,0,12
"cg12202469",0,9,0,0,9
"cg12202772",0,1,0,0,1
"cg12203416",4,0,0,0,4
"cg12204727",0,0,1,0,1
"cg12204875",0,0,1,0,1
"cg12205645",10,6,3,0,19
"cg12205742",6,13,5,0,24
"cg12205929",0,0,1,0,1
"cg12206290",5,0,0,0,5
"cg12206403",0,1,3,0,4
"cg12207494",0,0,1,0,1
"cg12210618",1,0,0,0,1
"cg12210824",0,0,13,0,13
"cg12211957",0,0,2,0,2
"cg12212060",1,0,0,0,1
"cg12212101",0,1,0,0,1
"cg12212365",0,0,1,0,1
"cg12213494",0,2,2,0,4
"cg12214083",0,1,0,0,1
"cg12214695",1,0,0,0,1
"cg12215675",0,1,0,0,1
"cg12216213",0,0,1,0,1
"cg12216318",0,0,1,0,1
"cg12216838",9,1,0,0,10
"cg12217897",10,0,0,0,10
"cg12218542",0,1,0,0,1
"cg12218732",0,2,19,0,21
"cg12219123",1,0,0,0,1
"cg12219332",1,0,0,0,1
"cg12220622",0,1,0,0,1
"cg12221682",213,33,2,0,248
"cg12221710",2,3,0,0,5
"cg12221729",240,125,5,0,370
"cg12221927",0,1,0,0,1
"cg12222398",0,3,2,0,5
"cg12223562",0,1,0,0,1
"cg12223801",35,257,6,0,298
"cg12224834",1,0,1,0,2
"cg12224855",89,460,214,0,763
"cg12224879",0,1,0,0,1
"cg12225710",5,0,0,0,5
"cg12226265",3,0,0,0,3
"cg12227063",0,1,2,2,5
"cg12227105",2,0,0,0,2
"cg12227410",0,0,1,0,1
"cg12227411",1,0,0,0,1
"cg12227611",1,0,0,0,1
"cg12228534",0,1,0,0,1
"cg12229018",1,0,1,0,2
"cg12230293",1,0,0,0,1
"cg12230668",71,1,0,0,72
"cg12232866",0,0,1,0,1
"cg12233160",0,0,1,0,1
"cg12233283",0,1,0,0,1
"cg12233991",1,0,0,0,1
"cg12234059",1059,78,0,0,1137
"cg12236368",51,2,0,0,53
"cg12236505",18,12,0,0,30
"cg12237060",0,0,1,0,1
"cg12239326",0,1,0,0,1
"cg12239672",0,0,1,0,1
"cg12239870",0,1,0,0,1
"cg12240051",0,0,1,0,1
"cg12240828",1,0,0,0,1
"cg12240975",0,0,1,0,1
"cg12241997",4,2,0,0,6
"cg12242204",50,2,0,0,52
"cg12242502",0,1,0,0,1
"cg12243034",0,0,1,0,1
"cg12243909",12,3,0,0,15
"cg12243976",0,0,0,1,1
"cg12244002",1,0,0,0,1
"cg12245252",0,1,0,0,1
"cg12245637",1,0,0,0,1
"cg12245770",1,0,0,0,1
"cg12246165",1,0,0,0,1
"cg12248480",19,1,0,0,20
"cg12249976",1,1,0,0,2
"cg12249987",0,0,1,0,1
"cg12251021",0,4,1,0,5
"cg12252256",0,0,1,0,1
"cg12252326",1,0,0,0,1
"cg12252776",0,0,1,0,1
"cg12255362",0,0,0,1,1
"cg12259923",7,4,1,0,12
"cg12260249",0,0,0,1,1
"cg12260840",0,0,1,0,1
"cg12262460",0,0,1,0,1
"cg12263024",0,0,1,0,1
"cg12263794",44,0,0,0,44
"cg12263828",0,2,3,0,5
"cg12264032",0,1,21,0,22
"cg12265609",1,0,0,0,1
"cg12265892",0,0,1,0,1
"cg12266722",82,9,0,0,91
"cg12267732",1,0,0,0,1
"cg12268519",1,0,0,0,1
"cg12269905",1,0,0,0,1
"cg12269972",1,0,0,0,1
"cg12270140",1,1,0,0,2
"cg12270717",1,2,1,0,4
"cg12272236",1,0,1,0,2
"cg12273939",61,7,0,0,68
"cg12276001",0,2,0,0,2
"cg12277888",0,0,1,0,1
"cg12278653",0,0,1,0,1
"cg12280796",440,35,1,0,476
"cg12282124",502,39,0,0,541
"cg12283218",26,1,0,0,27
"cg12283695",2,0,1,0,3
"cg12284736",1,0,0,0,1
"cg12285627",2,0,8,0,10
"cg12285804",0,0,1,0,1
"cg12286403",3,0,0,0,3
"cg12287055",6,1,0,0,7
"cg12287372",0,0,1,0,1
"cg12288947",0,0,1,0,1
"cg12289001",9,4,0,0,13
"cg12290400",0,1,0,0,1
"cg12290875",5,3,1,0,9
"cg12291208",0,0,1,0,1
"cg12291348",0,1,1,0,2
"cg12291380",0,3,2,0,5
"cg12291957",1,0,0,0,1
"cg12291982",0,2,0,0,2
"cg12292084",2,2,0,1,5
"cg12292953",454,79,6,0,539
"cg12293026",3,1,0,0,4
"cg12294208",0,1,0,0,1
"cg12298312",83,7,0,0,90
"cg12298598",0,3,0,0,3
"cg12298619",0,0,1,0,1
"cg12299303",0,3,0,2,5
"cg12299886",0,0,1,0,1
"cg12300500",0,0,1,0,1
"cg12300729",0,1,0,0,1
"cg12301275",0,0,1,0,1
"cg12301794",0,0,1,0,1
"cg12302407",0,0,2,0,2
"cg12302560",2,0,0,0,2
"cg12303413",0,0,4,0,4
"cg12303470",1,0,0,0,1
"cg12304053",0,0,1,0,1
"cg12304903",0,0,2,0,2
"cg12305805",0,1,0,0,1
"cg12305853",1,0,0,0,1
"cg12307032",0,1,0,0,1
"cg12307722",0,0,1,0,1
"cg12308102",0,0,1,0,1
"cg12308665",0,1,0,0,1
"cg12309596",40,1,0,0,41
"cg12310395",0,6,2,0,8
"cg12310562",1,1,1,0,3
"cg12311600",0,0,1,0,1
"cg12312819",0,1,4,0,5
"cg12312863",0,1,0,0,1
"cg12313476",2,0,0,0,2
"cg12314121",2,2,3,0,7
"cg12314361",3,0,0,0,3
"cg12315011",259,113,16,0,388
"cg12316181",0,2,0,0,2
"cg12317458",0,0,1,0,1
"cg12317505",216,96,14,0,326
"cg12318175",1,0,0,0,1
"cg12319281",1,0,0,0,1
"cg12321046",1,1,0,0,2
"cg12322549",18,6,0,0,24
"cg12323192",1,0,0,0,1
"cg12324318",0,1,0,0,1
"cg12325640",0,0,1,0,1
"cg12326308",0,1,0,0,1
"cg12327827",0,1,0,0,1
"cg12328289",0,0,2,0,2
"cg12328582",1,5,2,0,8
"cg12328831",0,0,2,0,2
"cg12329407",101,32,4,0,137
"cg12329476",0,0,1,0,1
"cg12329672",0,0,1,0,1
"cg12330727",638,716,11,0,1365
"cg12335047",0,1,0,0,1
"cg12335997",0,0,1,0,1
"cg12336591",16,9,8,0,33
"cg12336935",45,1,1,0,47
"cg12337053",7,0,0,0,7
"cg12338114",2,0,0,0,2
"cg12338731",1,2,3,0,6
"cg12339904",0,1,1,0,2
"cg12340381",267,239,25,0,531
"cg12340596",0,0,2,0,2
"cg12340868",0,0,1,0,1
"cg12340891",0,2,1,0,3
"cg12341314",1,3,5,0,9
"cg12341343",1,0,0,0,1
"cg12342402",0,0,1,0,1
"cg12342626",1,1,0,0,2
"cg12344104",0,2,0,0,2
"cg12344300",1,0,0,0,1
"cg12344600",0,1,0,0,1
"cg12345156",1,0,0,0,1
"cg12346284",1,0,2,0,3
"cg12346317",0,0,1,0,1
"cg12346592",0,1,0,0,1
"cg12346619",1,0,0,0,1
"cg12347674",0,0,1,0,1
"cg12347721",0,0,1,0,1
"cg12347727",9,2,0,0,11
"cg12347945",8,0,0,0,8
"cg12348862",0,1,1,0,2
"cg12350094",7,0,0,0,7
"cg12350288",1,0,0,0,1
"cg12350783",0,2,4,0,6
"cg12351290",0,0,3,0,3
"cg12351554",0,0,1,0,1
"cg12352059",0,1,0,0,1
"cg12352460",5,0,0,0,5
"cg12352549",4,0,0,0,4
"cg12352622",1,12,7,0,20
"cg12352912",8,1,0,0,9
"cg12353452",1,0,0,0,1
"cg12356787",0,0,2,0,2
"cg12357396",0,1,1,0,2
"cg12359492",17,1,0,0,18
"cg12359503",1,4,3,0,8
"cg12359511",0,1,0,0,1
"cg12359739",1,2,0,0,3
"cg12360245",17,17,0,0,34
"cg12360637",1,0,0,0,1
"cg12360690",3,0,0,0,3
"cg12361190",0,0,1,0,1
"cg12361425",1,0,0,0,1
"cg12361546",6,0,0,0,6
"cg12361987",0,1,0,0,1
"cg12362508",0,0,1,0,1
"cg12362980",0,1,0,0,1
"cg12365603",0,0,1,0,1
"cg12365667",1,0,0,0,1
"cg12365792",0,1,0,0,1
"cg12366648",2,0,0,0,2
"cg12367962",1,0,0,0,1
"cg12368066",0,0,3,0,3
"cg12369063",1,2,4,0,7
"cg12370657",0,0,1,0,1
"cg12370933",0,1,0,0,1
"cg12372008",0,1,0,0,1
"cg12372503",0,1,0,0,1
"cg12373195",0,1,0,0,1
"cg12374519",0,0,1,0,1
"cg12376350",0,0,0,1,1
"cg12376824",0,0,2,0,2
"cg12377408",1,1,0,0,2
"cg12378321",0,2,1,0,3
"cg12379764",1,0,0,0,1
"cg12380458",13,1,0,0,14
"cg12380683",9,1,0,0,10
"cg12380743",0,0,1,0,1
"cg12382229",17,1,0,0,18
"cg12382363",0,1,0,0,1
"cg12385553",1,0,0,1,2
"cg12385981",2,1,0,0,3
"cg12386752",0,0,2,0,2
"cg12387434",0,2,0,0,2
"cg12387604",1,0,0,0,1
"cg12388838",0,1,0,0,1
"cg12389786",1,0,0,0,1
"cg12389888",0,1,0,0,1
"cg12390237",1,0,0,0,1
"cg12390269",6,0,0,0,6
"cg12390332",0,1,0,0,1
"cg12390588",0,0,1,0,1
"cg12392475",2,10,3,0,15
"cg12393411",7,0,0,0,7
"cg12393795",0,1,0,0,1
"cg12394879",0,0,1,0,1
"cg12396023",1,1,0,0,2
"cg12397357",2,0,0,0,2
"cg12398314",2,0,0,0,2
"cg12398752",0,0,1,0,1
"cg12399301",0,0,1,0,1
"cg12399393",0,1,1,0,2
"cg12399600",1,0,0,0,1
"cg12399860",16,1,0,0,17
"cg12400459",0,0,2,0,2
"cg12400556",0,2,1,0,3
"cg12401158",2,2,0,0,4
"cg12404182",0,1,0,0,1
"cg12405121",0,1,1,0,2
"cg12405371",0,0,1,0,1
"cg12406683",1,1,0,0,2
"cg12407979",0,1,0,0,1
"cg12408100",0,0,1,0,1
"cg12408911",0,0,2,0,2
"cg12409297",1,0,0,0,1
"cg12410570",1,1,2,0,4
"cg12410615",1,0,0,0,1
"cg12412364",0,0,0,1,1
"cg12412775",0,0,1,0,1
"cg12415060",0,2,0,0,2
"cg12416290",223,181,11,0,415
"cg12417590",0,0,1,0,1
"cg12417729",1,0,0,0,1
"cg12420107",21,2,1,0,24
"cg12420383",0,2,0,0,2
"cg12420437",0,0,0,2,2
"cg12420723",1,0,0,0,1
"cg12421097",0,0,1,0,1
"cg12421513",0,0,1,0,1
"cg12423311",0,0,1,0,1
"cg12423947",1,0,0,0,1
"cg12424762",0,0,1,0,1
"cg12424965",12,2,0,0,14
"cg12427303",1,0,0,0,1
"cg12429788",41,25,1,0,67
"cg12429884",35,10,3,0,48
"cg12430264",0,2,0,0,2
"cg12430335",1,0,0,0,1
"cg12431453",3,1,1,0,5
"cg12431879",0,0,1,0,1
"cg12432010",0,1,0,0,1
"cg12432145",0,4,15,0,19
"cg12432496",3,6,3,0,12
"cg12433408",13,1,0,0,14
"cg12434526",687,25,0,0,712
"cg12434544",5,2,2,0,9
"cg12434591",2,0,0,0,2
"cg12434616",4,3,0,0,7
"cg12435575",1,0,0,0,1
"cg12435824",0,1,2,0,3
"cg12436427",0,0,1,0,1
"cg12437012",1,1,0,0,2
"cg12437380",0,0,1,0,1
"cg12438318",1,0,0,0,1
"cg12439259",1,0,0,0,1
"cg12439695",3,0,0,1,4
"cg12440350",0,0,2,0,2
"cg12440391",13,3,0,0,16
"cg12441246",9,3,1,0,13
"cg12442242",9,2,0,0,11
"cg12442980",0,1,8,0,9
"cg12444081",0,1,0,0,1
"cg12445028",0,0,1,0,1
"cg12447066",1,1,0,0,2
"cg12447329",0,0,1,0,1
"cg12447346",6,0,0,0,6
"cg12449876",0,0,1,0,1
"cg12450230",0,1,0,0,1
"cg12450907",0,1,0,0,1
"cg12452265",0,0,1,0,1
"cg12452512",0,2,0,0,2
"cg12452792",1,0,1,0,2
"cg12453585",29,5,0,0,34
"cg12453675",0,1,0,0,1
"cg12453901",4,0,0,0,4
"cg12454156",0,1,0,0,1
"cg12454658",1,0,0,0,1
"cg12454778",1,0,0,0,1
"cg12456446",0,1,0,0,1
"cg12456552",0,0,1,0,1
"cg12456573",0,1,9,0,10
"cg12456681",0,0,1,0,1
"cg12457043",10,4,1,0,15
"cg12457640",6,10,18,0,34
"cg12457721",4,6,2,0,12
"cg12459603",31,1,0,0,32
"cg12460133",0,0,1,0,1
"cg12460322",0,3,2,0,5
"cg12460661",0,0,2,0,2
"cg12460766",548,16,0,0,564
"cg12463089",1,0,0,0,1
"cg12463913",1,1,1,0,3
"cg12464148",22,2,0,0,24
"cg12464395",13,1,0,0,14
"cg12465516",1,0,0,0,1
"cg12466950",3,0,0,0,3
"cg12468496",3,7,15,0,25
"cg12470551",0,0,1,0,1
"cg12471120",5,20,1,0,26
"cg12471549",0,0,1,0,1
"cg12474013",0,1,0,0,1
"cg12474117",0,0,1,0,1
"cg12474452",0,0,1,0,1
"cg12474939",1,0,0,0,1
"cg12475495",1,0,0,0,1
"cg12475603",1,0,0,0,1
"cg12475994",2,0,1,0,3
"cg12476044",1,0,0,0,1
"cg12476298",1,0,0,0,1
"cg12477347",1,0,1,0,2
"cg12477454",4,0,0,0,4
"cg12478330",3,0,0,0,3
"cg12478440",25,0,0,0,25
"cg12478793",0,2,0,0,2
"cg12479019",2,0,3,0,5
"cg12479516",1,1,0,0,2
"cg12481433",0,0,1,0,1
"cg12481610",0,0,1,0,1
"cg12482011",1,0,0,0,1
"cg12482213",2,1,2,0,5
"cg12482231",0,1,0,0,1
"cg12482432",89,2,0,0,91
"cg12482983",0,0,1,0,1
"cg12483682",3,1,0,0,4
"cg12483946",0,1,0,0,1
"cg12484688",0,0,1,0,1
"cg12485185",1,0,0,0,1
"cg12485793",0,0,1,0,1
"cg12486756",0,1,0,0,1
"cg12487005",1,0,0,0,1
"cg12487062",32,3,0,0,35
"cg12488100",0,0,1,0,1
"cg12489675",38,58,3,0,99
"cg12489964",0,0,1,0,1
"cg12490927",242,12,0,0,254
"cg12492157",0,0,2,0,2
"cg12493439",1,0,0,0,1
"cg12494166",1,0,0,0,1
"cg12494277",6,22,0,0,28
"cg12494301",0,2,0,0,2
"cg12495676",0,1,0,0,1
"cg12495991",0,1,0,0,1
"cg12497171",1,0,0,0,1
"cg12499259",2,4,0,0,6
"cg12500774",7,11,3,0,21
"cg12501274",0,1,4,0,5
"cg12501523",24,1,0,0,25
"cg12502155",42,0,0,0,42
"cg12502826",0,1,0,0,1
"cg12503090",1,0,0,0,1
"cg12503971",0,5,2,0,7
"cg12504030",0,0,2,0,2
"cg12504098",0,0,1,0,1
"cg12504284",0,0,1,0,1
"cg12504641",0,1,0,0,1
"cg12504828",1,0,0,0,1
"cg12505124",456,122,12,0,590
"cg12505483",0,2,0,0,2
"cg12507167",3,3,4,0,10
"cg12508426",3,5,5,0,13
"cg12510108",0,0,1,0,1
"cg12510110",11,1,0,0,12
"cg12510271",691,433,12,0,1136
"cg12510723",6,2,0,0,8
"cg12511579",1,1,1,0,3
"cg12512039",1,1,1,0,3
"cg12512196",0,0,1,0,1
"cg12512286",2,1,0,0,3
"cg12512953",1,1,2,0,4
"cg12514547",11,14,14,0,39
"cg12514620",0,2,1,0,3
"cg12514654",103,386,18,0,507
"cg12515684",0,1,0,0,1
"cg12515942",0,2,0,0,2
"cg12516164",0,0,1,0,1
"cg12516501",8,0,0,0,8
"cg12518259",1,0,0,0,1
"cg12519178",0,0,1,0,1
"cg12520065",1,1,0,0,2
"cg12520727",35,3,0,0,38
"cg12521634",80,69,17,0,166
"cg12522049",0,0,4,0,4
"cg12522874",0,0,1,0,1
"cg12523109",1,0,0,0,1
"cg12523675",2,0,0,0,2
"cg12524776",174,22,0,0,196
"cg12525104",4,1,0,0,5
"cg12525317",0,0,2,0,2
"cg12525774",205,299,66,0,570
"cg12526084",0,1,0,0,1
"cg12526287",9,18,7,0,34
"cg12528485",8,7,1,0,16
"cg12529161",0,0,4,0,4
"cg12529917",2,5,0,0,7
"cg12530080",0,0,0,1,1
"cg12531065",0,0,1,0,1
"cg12532028",10,2,0,0,12
"cg12532393",0,0,5,0,5
"cg12532477",1,0,0,0,1
"cg12532653",0,0,2,0,2
"cg12534902",0,1,0,0,1
"cg12535579",1,0,0,0,1
"cg12537386",0,0,1,0,1
"cg12537613",1,1,0,0,2
"cg12537913",25,3,0,0,28
"cg12538282",1,0,0,0,1
"cg12538597",1,0,0,0,1
"cg12539194",32,0,0,0,32
"cg12539711",0,0,1,0,1
"cg12540042",0,0,1,0,1
"cg12543337",122,3,0,0,125
"cg12543748",1,0,0,0,1
"cg12545097",38,10,0,0,48
"cg12545252",3,0,0,0,3
"cg12546660",0,0,3,0,3
"cg12546981",1,0,0,0,1
"cg12547681",0,2,0,0,2
"cg12548043",0,0,1,0,1
"cg12549079",1,1,0,0,2
"cg12549201",0,0,1,0,1
"cg12549355",0,0,0,2,2
"cg12549480",3,0,0,0,3
"cg12549571",0,2,1,0,3
"cg12549595",3,0,0,0,3
"cg12551330",1,0,3,0,4
"cg12552209",2,1,0,0,3
"cg12554272",3,0,0,0,3
"cg12554430",1,0,0,0,1
"cg12554654",1,0,0,0,1
"cg12554775",0,0,1,0,1
"cg12555084",0,0,1,0,1
"cg12555380",0,2,0,0,2
"cg12555652",3,0,0,0,3
"cg12555752",0,0,1,0,1
"cg12555816",0,0,1,0,1
"cg12555879",2,1,0,0,3
"cg12556924",14,20,4,0,38
"cg12557508",0,0,1,0,1
"cg12558269",692,546,7,0,1245
"cg12558855",87,12,0,0,99
"cg12559170",0,0,1,0,1
"cg12559181",0,1,1,0,2
"cg12559223",3,28,46,0,77
"cg12560809",0,1,6,0,7
"cg12560849",25,25,7,0,57
"cg12563008",2,0,0,0,2
"cg12563818",4,2,0,0,6
"cg12564526",1,0,4,0,5
"cg12565055",1,3,0,0,4
"cg12565821",11,11,0,0,22
"cg12566536",0,1,2,0,3
"cg12566626",0,1,0,0,1
"cg12566762",1,0,0,0,1
"cg12567282",1,0,0,0,1
"cg12567482",0,1,0,0,1
"cg12572077",0,0,1,0,1
"cg12573158",0,0,1,0,1
"cg12573674",1,0,0,0,1
"cg12575762",0,1,0,0,1
"cg12575954",0,0,1,0,1
"cg12576321",978,201,1,0,1180
"cg12576523",686,545,6,0,1237
"cg12576739",0,1,0,0,1
"cg12577482",2,1,0,0,3
"cg12578116",7,0,0,0,7
"cg12579640",156,512,170,0,838
"cg12579644",2,2,0,0,4
"cg12579844",0,0,1,0,1
"cg12579995",0,0,1,0,1
"cg12580248",2,2,7,0,11
"cg12580503",0,2,23,0,25
"cg12580892",0,1,0,0,1
"cg12581241",4,4,1,0,9
"cg12582896",1,0,0,0,1
"cg12582905",0,0,1,0,1
"cg12583336",0,1,0,0,1
"cg12583367",1,0,0,0,1
"cg12584442",0,1,0,0,1
"cg12584510",0,1,0,0,1
"cg12585162",227,89,18,0,334
"cg12586707",1,0,0,0,1
"cg12587234",0,0,1,0,1
"cg12588279",1,0,0,0,1
"cg12589143",1,0,0,0,1
"cg12589274",1,0,0,0,1
"cg12589961",6,0,1,0,7
"cg12590063",941,139,0,0,1080
"cg12591125",0,1,0,0,1
"cg12591381",17,4,0,0,21
"cg12592455",0,1,1,0,2
"cg12592683",1,0,0,0,1
"cg12592815",0,0,2,0,2
"cg12593421",13,0,0,0,13
"cg12593611",5,6,1,0,12
"cg12593714",0,1,0,0,1
"cg12595439",0,1,0,0,1
"cg12595460",1,0,0,0,1
"cg12596645",0,1,1,0,2
"cg12596665",0,0,4,0,4
"cg12597233",0,1,1,0,2
"cg12597422",170,136,63,0,369
"cg12597462",0,0,1,0,1
"cg12597878",0,1,1,0,2
"cg12599235",561,26,1,0,588
"cg12600069",0,1,0,0,1
"cg12600631",0,0,1,0,1
"cg12601062",1,0,0,0,1
"cg12601355",1,0,0,0,1
"cg12601520",31,11,1,0,43
"cg12601682",0,2,0,0,2
"cg12603650",663,116,1,0,780
"cg12604368",251,13,0,0,264
"cg12605273",0,0,3,0,3
"cg12606007",14,0,0,0,14
"cg12606193",1,1,0,0,2
"cg12607967",0,1,0,0,1
"cg12609546",7,0,0,0,7
"cg12609665",0,0,4,0,4
"cg12610098",1,5,1,0,7
"cg12610440",159,202,29,0,390
"cg12611007",85,8,0,0,93
"cg12612277",0,1,1,0,2
"cg12614458",50,24,0,0,74
"cg12614667",1,1,0,0,2
"cg12614708",0,0,1,0,1
"cg12616421",2,2,4,0,8
"cg12616701",1,0,0,0,1
"cg12617125",0,1,0,0,1
"cg12617549",1,0,0,0,1
"cg12618044",0,1,2,0,3
"cg12618988",0,2,1,0,3
"cg12619326",0,0,1,0,1
"cg12621141",53,7,0,0,60
"cg12621966",2,0,0,0,2
"cg12622027",0,0,1,0,1
"cg12622271",2,0,0,0,2
"cg12622938",0,1,2,0,3
"cg12623145",0,0,2,0,2
"cg12623456",1,2,3,0,6
"cg12623605",0,0,1,0,1
"cg12623918",0,5,6,0,11
"cg12624051",0,1,0,0,1
"cg12624235",0,0,1,0,1
"cg12624580",1,9,0,0,10
"cg12624825",0,0,1,0,1
"cg12625263",0,1,0,0,1
"cg12627983",0,0,1,0,1
"cg12628606",2,1,2,0,5
"cg12629250",3,1,0,0,4
"cg12629698",0,0,1,0,1
"cg12629783",0,0,7,0,7
"cg12630336",1,0,0,0,1
"cg12630401",6,2,0,0,8
"cg12631085",29,1,0,0,30
"cg12631464",15,12,1,0,28
"cg12632398",11,0,0,0,11
"cg12632549",49,5,0,0,54
"cg12640186",0,1,0,0,1
"cg12640389",0,1,0,0,1
"cg12640746",0,1,0,0,1
"cg12640856",1,0,0,0,1
"cg12641021",2,0,0,0,2
"cg12641135",1,2,0,0,3
"cg12642155",0,0,1,0,1
"cg12643502",0,0,1,0,1
"cg12643732",0,0,1,0,1
"cg12643778",1,0,0,0,1
"cg12643877",8,7,1,0,16
"cg12644017",1,0,0,0,1
"cg12644484",0,1,1,0,2
"cg12644564",2,0,0,0,2
"cg12644927",0,1,0,0,1
"cg12647098",0,1,1,0,2
"cg12647302",0,1,0,0,1
"cg12648482",0,0,1,0,1
"cg12649695",2,0,0,0,2
"cg12650985",3,0,0,0,3
"cg12651293",0,0,1,0,1
"cg12651851",0,1,0,0,1
"cg12652144",4,3,0,0,7
"cg12652826",0,0,1,0,1
"cg12653133",18,7,5,0,30
"cg12653789",13,4,0,0,17
"cg12654140",15,2,0,0,17
"cg12654190",19,4,0,0,23
"cg12654655",2,2,1,0,5
"cg12654770",0,1,1,0,2
"cg12655061",4,0,1,0,5
"cg12656006",0,0,3,0,3
"cg12656374",1,1,0,0,2
"cg12658802",4,0,0,0,4
"cg12659254",2,0,0,0,2
"cg12659446",0,0,3,0,3
"cg12659672",0,0,1,0,1
"cg12659692",2,0,4,0,6
"cg12659754",0,0,1,0,1
"cg12660146",0,1,0,0,1
"cg12661256",0,1,0,0,1
"cg12662017",1,2,0,0,3
"cg12662374",0,0,1,0,1
"cg12663357",0,1,0,0,1
"cg12664291",3,2,0,0,5
"cg12664806",0,3,0,0,3
"cg12665724",0,2,0,0,2
"cg12665787",0,0,1,0,1
"cg12665877",3,2,0,0,5
"cg12667595",2,2,0,0,4
"cg12667818",0,0,1,0,1
"cg12668411",1,0,0,0,1
"cg12669137",0,1,0,0,1
"cg12670123",1,0,0,0,1
"cg12671018",0,0,1,0,1
"cg12671627",0,1,0,0,1
"cg12671895",0,0,1,0,1
"cg12672980",69,9,0,0,78
"cg12673840",15,0,0,0,15
"cg12673860",0,3,0,0,3
"cg12675387",0,0,1,0,1
"cg12678274",14,8,2,0,24
"cg12678329",24,103,2,0,129
"cg12680424",1,0,0,0,1
"cg12681771",0,1,0,0,1
"cg12682458",6,7,0,0,13
"cg12683036",0,0,1,0,1
"cg12685995",1,0,0,0,1
"cg12687463",0,0,1,0,1
"cg12687990",0,1,0,0,1
"cg12688265",0,1,0,0,1
"cg12689235",2,0,0,0,2
"cg12689996",9,1,0,0,10
"cg12690496",2,0,0,0,2
"cg12692557",0,2,0,2,4
"cg12693959",0,0,1,0,1
"cg12695360",7,1,1,0,9
"cg12695819",0,0,1,0,1
"cg12696860",15,7,0,0,22
"cg12696903",0,0,2,0,2
"cg12697337",0,0,1,0,1
"cg12697393",1,1,0,0,2
"cg12697650",0,0,3,0,3
"cg12699187",0,1,1,0,2
"cg12699200",1,0,0,0,1
"cg12702165",0,1,1,0,2
"cg12702920",198,1549,124,0,1871
"cg12705263",1,0,0,0,1
"cg12705408",0,1,0,0,1
"cg12705449",0,0,1,0,1
"cg12707353",1,4,2,0,7
"cg12707402",371,59,0,0,430
"cg12708689",2,0,0,0,2
"cg12708864",16,14,0,0,30
"cg12709207",1,2,2,0,5
"cg12709266",10,9,0,0,19
"cg12711699",2,4,4,0,10
"cg12712729",3,0,22,0,25
"cg12712730",0,1,0,0,1
"cg12713223",1,0,0,0,1
"cg12713835",1,0,0,0,1
"cg12714121",0,1,0,0,1
"cg12715741",1,4,0,0,5
"cg12715759",82,12,0,0,94
"cg12715811",0,0,1,0,1
"cg12716453",0,0,0,1,1
"cg12716603",0,1,2,0,3
"cg12718339",1,1,0,0,2
"cg12718832",0,1,0,0,1
"cg12719417",113,4,0,0,117
"cg12719661",0,0,1,0,1
"cg12720083",0,0,1,0,1
"cg12721145",2,1,1,0,4
"cg12721186",0,0,1,0,1
"cg12723258",7,0,0,0,7
"cg12723904",10,1,1,0,12
"cg12724108",8,0,0,0,8
"cg12724498",0,1,0,0,1
"cg12724942",0,0,10,0,10
"cg12725782",0,0,1,0,1
"cg12726568",0,1,0,0,1
"cg12726604",0,1,0,0,1
"cg12726663",5,8,13,0,26
"cg12728240",0,0,1,0,1
"cg12728516",0,0,1,0,1
"cg12728543",126,2,0,0,128
"cg12729006",0,0,1,0,1
"cg12731126",1,0,1,0,2
"cg12732673",1,1,1,0,3
"cg12732715",0,0,2,0,2
"cg12734537",0,1,0,0,1
"cg12735489",3,2,0,0,5
"cg12736830",132,14,0,0,146
"cg12737574",0,0,1,0,1
"cg12738399",58,13,0,0,71
"cg12738610",0,0,1,0,1
"cg12741001",0,1,0,0,1
"cg12741170",0,0,1,0,1
"cg12742799",1,0,1,0,2
"cg12743110",2,0,0,0,2
"cg12743359",0,1,0,0,1
"cg12743556",1,0,0,0,1
"cg12747007",4,0,0,0,4
"cg12747167",1,0,0,0,1
"cg12748616",0,0,1,0,1
"cg12748850",0,0,1,0,1
"cg12749087",1,2,0,0,3
"cg12749280",0,2,3,0,5
"cg12750800",204,46,5,0,255
"cg12751899",0,0,1,0,1
"cg12751966",0,0,1,0,1
"cg12753165",0,0,1,0,1
"cg12753220",1,0,0,0,1
"cg12753413",36,4,0,0,40
"cg12753482",0,0,1,0,1
"cg12754609",0,0,1,0,1
"cg12755035",96,35,7,0,138
"cg12758422",0,0,1,0,1
"cg12759597",0,0,1,0,1
"cg12760580",0,0,1,0,1
"cg12762708",0,0,2,0,2
"cg12762733",1,0,0,0,1
"cg12763038",6,2,0,0,8
"cg12763118",0,1,0,0,1
"cg12763546",0,2,0,0,2
"cg12765138",579,72,4,0,655
"cg12766229",5,0,0,0,5
"cg12766242",0,2,0,0,2
"cg12768018",1,0,0,0,1
"cg12768463",0,1,6,0,7
"cg12769333",1,9,19,0,29
"cg12769994",0,1,1,0,2
"cg12770471",51,2,0,0,53
"cg12770696",42,0,0,0,42
"cg12771670",6,2,1,0,9
"cg12772203",0,1,0,0,1
"cg12772435",42,9,0,0,51
"cg12773217",0,0,1,0,1
"cg12774854",0,0,1,0,1
"cg12774971",1,0,1,0,2
"cg12775110",1,0,0,0,1
"cg12775354",0,0,1,0,1
"cg12780133",0,1,0,0,1
"cg12780324",0,0,0,1,1
"cg12780819",3,0,0,0,3
"cg12781248",1,0,0,0,1
"cg12781734",0,1,0,0,1
"cg12783320",1,0,0,0,1
"cg12789010",1,0,0,0,1
"cg12789833",10,0,0,0,10
"cg12790061",1,0,0,0,1
"cg12791136",0,1,0,0,1
"cg12791476",0,3,0,0,3
"cg12794109",283,143,3,0,429
"cg12794168",0,0,1,0,1
"cg12794269",0,0,1,0,1
"cg12794474",2,0,0,0,2
"cg12794781",1,0,1,0,2
"cg12795015",7,1,0,0,8
"cg12795310",1,0,0,0,1
"cg12795731",0,1,0,0,1
"cg12795959",0,1,0,0,1
"cg12797492",0,0,1,0,1
"cg12797816",0,0,1,0,1
"cg12798257",2,1,3,0,6
"cg12799170",1,1,0,0,2
"cg12799906",0,1,0,0,1
"cg12800069",4,0,0,0,4
"cg12800145",48,1,0,0,49
"cg12801469",0,0,1,0,1
"cg12801552",0,1,0,0,1
"cg12801862",0,0,1,0,1
"cg12802246",45,5,0,0,50
"cg12802442",1,0,0,0,1
"cg12802915",6,0,2,0,8
"cg12803811",0,0,1,0,1
"cg12803845",1,0,0,0,1
"cg12805160",0,1,0,0,1
"cg12805190",0,0,1,0,1
"cg12805629",3,4,8,0,15
"cg12805984",1,0,0,0,1
"cg12806149",3,0,0,0,3
"cg12808270",2,0,0,0,2
"cg12809341",1,0,0,1,2
"cg12809883",256,288,1,0,545
"cg12810701",3,0,0,0,3
"cg12812382",1,1,0,0,2
"cg12813011",4,0,0,0,4
"cg12813805",229,230,34,0,493
"cg12814019",0,0,0,1,1
"cg12814147",2,6,4,0,12
"cg12814224",0,0,1,0,1
"cg12814244",0,0,1,0,1
"cg12815381",0,0,1,0,1
"cg12816978",0,1,0,0,1
"cg12817298",34,37,4,0,75
"cg12818201",0,0,0,1,1
"cg12819781",53,3,0,0,56
"cg12819820",0,1,3,0,4
"cg12820999",0,1,0,0,1
"cg12821182",1,0,0,0,1
"cg12821220",8,1,0,0,9
"cg12821645",6,1,0,0,7
"cg12821710",1,0,0,0,1
"cg12822133",1,0,0,0,1
"cg12823039",2,1,0,0,3
"cg12824777",9,2,0,0,11
"cg12826209",4,0,0,0,4
"cg12827637",0,0,1,0,1
"cg12828313",0,8,0,0,8
"cg12829452",0,1,0,0,1
"cg12830153",0,1,1,0,2
"cg12830519",0,0,1,0,1
"cg12830829",0,1,0,0,1
"cg12831983",2,0,0,0,2
"cg12832129",21,0,1,0,22
"cg12832449",1,0,0,0,1
"cg12833102",0,0,1,0,1
"cg12834944",4,8,0,0,12
"cg12836624",3,3,1,0,7
"cg12837642",0,0,1,0,1
"cg12837896",0,1,0,0,1
"cg12838194",14,16,11,0,41
"cg12838926",1,0,0,0,1
"cg12839110",0,0,4,0,4
"cg12839700",0,0,1,0,1
"cg12839830",0,0,3,0,3
"cg12842231",0,0,1,0,1
"cg12843464",1,0,0,0,1
"cg12844298",4,1,0,0,5
"cg12845900",9,0,1,0,10
"cg12846131",0,0,1,0,1
"cg12846367",3,4,0,0,7
"cg12847005",3,0,0,0,3
"cg12847185",0,2,0,0,2
"cg12847842",0,0,1,0,1
"cg12848118",0,1,0,0,1
"cg12848119",0,0,1,0,1
"cg12848182",3,0,0,0,3
"cg12849689",15,1,0,0,16
"cg12850075",1,0,0,0,1
"cg12850546",0,1,0,0,1
"cg12852384",0,0,2,0,2
"cg12852407",2,0,0,0,2
"cg12855044",1,0,1,0,2
"cg12856064",1,1,0,0,2
"cg12856521",0,0,1,0,1
"cg12857407",0,0,2,0,2
"cg12857644",39,145,148,0,332
"cg12858542",0,1,1,0,2
"cg12858900",0,1,0,0,1
"cg12859409",0,0,1,0,1
"cg12860731",0,1,1,0,2
"cg12860753",1,0,0,0,1
"cg12861598",3,0,0,0,3
"cg12862982",0,2,0,0,2
"cg12863372",0,0,1,0,1
"cg12865608",0,0,2,0,2
"cg12866103",0,0,2,0,2
"cg12866538",10,2,0,0,12
"cg12866780",1,0,0,0,1
"cg12867594",0,0,4,0,4
"cg12867892",111,9,0,0,120
"cg12868306",1,0,0,0,1
"cg12868494",1,0,0,0,1
"cg12869362",0,0,1,0,1
"cg12869466",2,2,1,0,5
"cg12870571",0,2,1,0,3
"cg12872625",18,1,0,0,19
"cg12872888",3,5,2,0,10
"cg12873221",1,1,4,0,6
"cg12874074",0,1,0,0,1
"cg12874210",2,1,0,0,3
"cg12874388",84,226,164,0,474
"cg12874587",15,9,1,0,25
"cg12875312",0,3,3,0,6
"cg12876900",0,0,1,0,1
"cg12877253",2,0,0,0,2
"cg12877378",7,2,0,0,9
"cg12878615",147,17,0,0,164
"cg12878786",74,2,0,0,76
"cg12878951",14,1,0,0,15
"cg12879551",1,0,0,0,1
"cg12879853",117,101,39,0,257
"cg12879909",0,1,0,0,1
"cg12880227",0,0,2,0,2
"cg12880777",0,1,0,0,1
"cg12880856",1,0,0,0,1
"cg12881105",50,9,8,0,67
"cg12881133",1,0,0,0,1
"cg12881259",38,567,23,0,628
"cg12882126",1,0,0,0,1
"cg12882188",1,0,0,0,1
"cg12882389",0,4,5,0,9
"cg12882999",2,0,0,0,2
"cg12884351",3,0,0,0,3
"cg12884916",1,0,1,0,2
"cg12887080",0,3,0,0,3
"cg12888097",0,0,1,0,1
"cg12888990",3,0,0,0,3
"cg12890750",0,0,1,0,1
"cg12890911",0,0,1,0,1
"cg12893428",0,2,0,0,2
"cg12894110",5,0,0,0,5
"cg12894748",1,4,0,0,5
"cg12895516",0,0,1,0,1
"cg12896959",1,0,0,0,1
"cg12897439",4,1,0,0,5
"cg12897458",10,0,0,0,10
"cg12897568",2,1,1,0,4
"cg12898496",3,0,0,0,3
"cg12899052",0,0,1,0,1
"cg12900044",0,1,0,0,1
"cg12900045",1,0,0,0,1
"cg12901435",264,138,3,0,405
"cg12903798",0,0,1,0,1
"cg12904198",10,17,0,0,27
"cg12904343",0,0,0,1,1
"cg12904531",1,3,3,0,7
"cg12904566",3,2,4,0,9
"cg12904922",1,0,0,0,1
"cg12905119",1,0,0,0,1
"cg12905620",0,1,0,0,1
"cg12905839",39,9,0,0,48
"cg12906295",1,0,0,0,1
"cg12906530",5,0,0,0,5
"cg12906589",85,17,1,0,103
"cg12906702",7,2,0,0,9
"cg12906880",42,23,12,0,77
"cg12907032",7,0,0,0,7
"cg12907644",1,0,0,0,1
"cg12908429",1,0,0,0,1
"cg12909057",0,0,1,0,1
"cg12910199",1,0,0,0,1
"cg12910810",0,1,0,0,1
"cg12910969",17,3,0,0,20
"cg12911313",139,20,4,0,163
"cg12911528",228,276,59,0,563
"cg12911791",0,1,0,0,1
"cg12911907",3,0,0,0,3
"cg12912387",0,1,0,0,1
"cg12912929",0,0,7,0,7
"cg12913778",0,0,1,0,1
"cg12913991",5,0,0,0,5
"cg12915362",0,0,1,0,1
"cg12915715",0,0,3,0,3
"cg12916646",0,2,0,0,2
"cg12917360",7,2,3,0,12
"cg12918081",0,2,2,0,4
"cg12918186",0,1,1,0,2
"cg12919025",1,2,1,0,4
"cg12920168",0,0,1,0,1
"cg12920393",1,0,2,0,3
"cg12921196",0,0,1,0,1
"cg12921375",1,0,0,0,1
"cg12922337",1,0,0,0,1
"cg12923443",0,1,0,0,1
"cg12923728",1,1,1,0,3
"cg12924518",101,3,0,0,104
"cg12925904",0,0,1,0,1
"cg12927617",0,0,1,0,1
"cg12927726",0,0,1,0,1
"cg12928578",0,0,1,0,1
"cg12929700",0,0,1,0,1
"cg12929969",0,1,0,0,1
"cg12931428",3,0,0,0,3
"cg12931520",0,1,0,0,1
"cg12931526",2,0,0,0,2
"cg12932539",0,13,3,0,16
"cg12934430",1,4,20,0,25
"cg12934569",465,697,8,0,1170
"cg12935209",0,1,0,0,1
"cg12937141",0,3,0,0,3
"cg12937186",1,0,0,0,1
"cg12937807",0,0,1,0,1
"cg12937950",2,0,4,0,6
"cg12941426",4,0,0,0,4
"cg12941675",415,1420,97,0,1932
"cg12941884",98,5,0,0,103
"cg12943080",4,0,0,0,4
"cg12943255",1,0,0,0,1
"cg12943643",0,0,2,0,2
"cg12944870",3,1,0,0,4
"cg12946518",0,1,6,0,7
"cg12946560",1,0,0,0,1
"cg12946856",0,0,1,0,1
"cg12947096",1,0,0,0,1
"cg12947373",1,1,0,0,2
"cg12947492",0,0,1,0,1
"cg12947768",2,0,0,0,2
"cg12947852",2,1,0,0,3
"cg12948213",418,5,0,0,423
"cg12948739",1,0,0,0,1
"cg12949141",0,1,2,0,3
"cg12949355",1,0,0,0,1
"cg12949678",296,149,16,0,461
"cg12949927",1,3,1,0,5
"cg12950492",1,0,0,0,1
"cg12952136",1,0,0,0,1
"cg12952179",2,0,0,0,2
"cg12952273",0,0,2,0,2
"cg12952605",2,1,0,0,3
"cg12952691",1,0,0,0,1
"cg12953621",1,0,0,0,1
"cg12953657",37,24,2,0,63
"cg12953952",1,0,0,0,1
"cg12954250",1,0,0,0,1
"cg12954718",1,0,0,0,1
"cg12955039",0,0,1,0,1
"cg12955444",0,0,1,0,1
"cg12956023",0,0,1,0,1
"cg12958054",0,2,2,0,4
"cg12959106",4,4,0,0,8
"cg12959367",819,230,5,0,1054
"cg12959558",1,0,0,0,1
"cg12961845",32,9,3,0,44
"cg12963237",0,0,1,0,1
"cg12963936",25,2,0,0,27
"cg12964019",127,23,0,0,150
"cg12965438",86,11,0,0,97
"cg12965927",1,0,0,0,1
"cg12966936",1,0,0,0,1
"cg12966981",268,0,1,0,269
"cg12967370",0,0,1,0,1
"cg12970081",0,1,0,0,1
"cg12970292",1,1,2,0,4
"cg12970742",11,10,19,0,40
"cg12970815",0,0,2,0,2
"cg12970951",1,0,0,0,1
"cg12972081",1,1,0,0,2
"cg12973017",1,1,0,0,2
"cg12973165",4,1,0,0,5
"cg12973239",1,0,0,0,1
"cg12974917",6,0,0,0,6
"cg12975779",0,1,1,0,2
"cg12976999",0,0,1,0,1
"cg12977162",1,0,0,0,1
"cg12977696",0,0,1,0,1
"cg12977811",0,2,0,0,2
"cg12977827",10,0,0,0,10
"cg12977937",4,0,0,0,4
"cg12977946",375,53,4,0,432
"cg12978357",0,1,0,0,1
"cg12978587",0,0,3,0,3
"cg12979383",46,2,0,0,48
"cg12980185",0,0,1,0,1
"cg12980788",0,3,1,0,4
"cg12980798",14,18,21,0,53
"cg12981234",5,0,1,0,6
"cg12982097",0,1,0,0,1
"cg12982565",0,0,1,0,1
"cg12982767",0,0,1,0,1
"cg12983654",0,0,4,0,4
"cg12984017",7,1,0,0,8
"cg12984107",3,0,0,0,3
"cg12984254",0,1,0,0,1
"cg12984284",0,0,1,0,1
"cg12984369",1,6,3,0,10
"cg12985770",0,1,0,0,1
"cg12986027",0,0,1,0,1
"cg12986037",0,0,4,0,4
"cg12988711",0,0,1,0,1
"cg12989473",0,1,0,0,1
"cg12989644",22,13,1,0,36
"cg12990591",0,1,0,0,1
"cg12990730",1,0,0,0,1
"cg12991976",1,1,0,0,2
"cg12992040",1,0,0,0,1
"cg12992554",0,0,1,0,1
"cg12994228",1,0,0,0,1
"cg12994908",1,6,0,0,7
"cg12996161",156,217,73,0,446
"cg12997252",0,0,0,1,1
"cg12998575",2,0,0,0,2
"cg12999291",1,0,0,0,1
"cg12999889",0,1,0,0,1
"cg13000219",0,0,1,0,1
"cg13000635",1,1,1,0,3
"cg13000698",20,1,0,0,21
"cg13001543",0,0,2,0,2
"cg13001844",1,0,0,0,1
"cg13002346",1,0,3,0,4
"cg13002424",4,0,0,0,4
"cg13003163",1,1,0,0,2
"cg13003329",169,11,2,0,182
"cg13004173",2,0,0,0,2
"cg13004897",0,1,0,0,1
"cg13005068",1,0,0,0,1
"cg13005634",7,2,6,0,15
"cg13005910",2,0,0,0,2
"cg13006693",0,1,0,0,1
"cg13007109",0,1,0,0,1
"cg13007712",20,4,0,0,24
"cg13007877",3,3,0,0,6
"cg13008331",0,1,0,0,1
"cg13008977",1,0,0,0,1
"cg13009111",0,6,12,0,18
"cg13009819",1,0,0,0,1
"cg13011104",0,0,2,0,2
"cg13011331",18,7,0,0,25
"cg13011749",1,0,0,0,1
"cg13012248",2,0,0,0,2
"cg13013473",6,0,0,0,6
"cg13015300",7,0,0,0,7
"cg13017239",0,0,3,0,3
"cg13018274",1,3,1,0,5
"cg13018278",0,0,1,0,1
"cg13018402",1,0,0,0,1
"cg13019465",2,1,0,0,3
"cg13019553",0,2,0,0,2
"cg13019677",10,1,0,0,11
"cg13019766",1,0,0,0,1
"cg13021084",42,12,0,0,54
"cg13021275",0,1,0,0,1
"cg13021417",68,40,5,0,113
"cg13022616",1,0,0,0,1
"cg13022905",31,1,0,0,32
"cg13023119",0,6,0,0,6
"cg13024075",14,0,0,0,14
"cg13024117",1,0,0,0,1
"cg13025482",0,1,0,0,1
"cg13025553",0,0,1,0,1
"cg13027177",1,0,7,0,8
"cg13027544",0,1,0,0,1
"cg13027965",1,0,0,0,1
"cg13028335",12,0,0,0,12
"cg13028630",0,0,1,0,1
"cg13029635",21,6,0,0,27
"cg13030804",0,1,0,0,1
"cg13031097",2,1,0,0,3
"cg13031882",0,1,2,0,3
"cg13033054",1,1,0,0,2
"cg13033675",0,0,1,0,1
"cg13035254",0,0,1,0,1
"cg13035715",0,4,0,0,4
"cg13036359",17,12,0,0,29
"cg13036415",0,1,0,0,1
"cg13036549",0,0,3,0,3
"cg13036878",9,0,0,0,9
"cg13036944",0,0,1,0,1
"cg13038125",75,14,0,0,89
"cg13039545",10,0,0,0,10
"cg13041389",169,170,3,0,342
"cg13041775",68,3,0,0,71
"cg13043937",0,2,1,0,3
"cg13044029",0,0,1,0,1
"cg13044445",6,0,0,0,6
"cg13044525",1,0,0,0,1
"cg13045010",4,1,0,0,5
"cg13046724",0,0,1,0,1
"cg13046814",0,2,4,0,6
"cg13047559",1,0,0,0,1
"cg13048285",2,3,1,0,6
"cg13048485",608,52,0,0,660
"cg13049124",0,0,1,0,1
"cg13049984",1,0,0,0,1
"cg13050142",705,203,2,0,910
"cg13050736",0,1,0,0,1
"cg13051013",0,0,1,0,1
"cg13051649",1,0,0,0,1
"cg13051865",3,0,2,0,5
"cg13053372",0,0,2,0,2
"cg13054403",0,4,6,0,10
"cg13054674",0,2,1,0,3
"cg13054881",0,2,0,0,2
"cg13055278",0,0,1,0,1
"cg13055636",1,0,0,0,1
"cg13056943",1,0,0,0,1
"cg13057098",0,1,0,0,1
"cg13057368",1,0,0,0,1
"cg13058233",0,2,0,0,2
"cg13059459",0,0,1,0,1
"cg13059696",1,0,2,0,3
"cg13059982",0,2,2,0,4
"cg13060607",75,228,162,0,465
"cg13061403",3,0,0,0,3
"cg13061995",0,1,2,0,3
"cg13062095",0,1,0,0,1
"cg13062842",0,1,0,0,1
"cg13064305",0,0,1,0,1
"cg13064346",0,1,0,0,1
"cg13066015",35,23,0,0,58
"cg13066682",0,0,1,0,1
"cg13067005",0,0,1,0,1
"cg13068141",0,0,5,0,5
"cg13068311",0,1,2,0,3
"cg13069211",1,0,0,0,1
"cg13070738",0,0,2,0,2
"cg13070781",0,0,1,0,1
"cg13071609",206,91,10,0,307
"cg13072508",1,0,0,0,1
"cg13074711",0,0,3,0,3
"cg13075423",2,0,0,0,2
"cg13076757",2,8,2,0,12
"cg13076940",6,2,2,0,10
"cg13077061",0,1,0,0,1
"cg13077413",0,1,0,0,1
"cg13077750",3,0,0,0,3
"cg13079277",0,0,3,0,3
"cg13079840",6,3,3,0,12
"cg13080532",162,586,101,0,849
"cg13080904",0,0,1,0,1
"cg13081381",0,1,6,0,7
"cg13082351",0,0,2,0,2
"cg13082604",13,0,0,0,13
"cg13082642",2,0,0,0,2
"cg13083035",1,1,4,0,6
"cg13083260",1,0,0,0,1
"cg13083427",1,0,0,0,1
"cg13085046",0,0,1,0,1
"cg13086512",0,1,0,0,1
"cg13087275",1,1,0,0,2
"cg13087299",1,0,0,0,1
"cg13087761",0,1,0,0,1
"cg13087943",1,4,3,0,8
"cg13087979",0,0,1,0,1
"cg13089318",2,0,0,0,2
"cg13089369",17,2,0,0,19
"cg13089454",0,1,0,0,1
"cg13089765",140,6,0,0,146
"cg13091131",0,0,1,0,1
"cg13092165",0,2,1,0,3
"cg13093847",21,14,3,0,38
"cg13094002",1,0,4,0,5
"cg13094583",1,0,0,0,1
"cg13095732",1,0,1,0,2
"cg13095991",121,251,75,0,447
"cg13096099",1,0,0,0,1
"cg13096688",0,0,1,0,1
"cg13096708",64,67,197,0,328
"cg13097296",103,14,0,0,117
"cg13098319",1,2,0,0,3
"cg13098438",0,3,0,0,3
"cg13099261",9,2,0,0,11
"cg13100182",2,0,0,0,2
"cg13101318",2,6,2,0,10
"cg13101948",0,1,0,0,1
"cg13101990",1,0,0,0,1
"cg13102244",0,0,1,0,1
"cg13102250",3,0,0,0,3
"cg13102269",1,1,0,0,2
"cg13103145",0,1,1,0,2
"cg13104442",8,2,0,0,10
"cg13104745",1,1,0,0,2
"cg13105167",206,273,67,0,546
"cg13105872",4,0,0,0,4
"cg13105945",0,0,1,0,1
"cg13106148",3,0,2,0,5
"cg13107266",0,0,1,0,1
"cg13107655",0,0,1,0,1
"cg13107810",180,257,70,0,507
"cg13108181",1,0,0,0,1
"cg13108289",1,1,1,0,3
"cg13108681",1,1,0,0,2
"cg13108687",7,8,9,0,24
"cg13109030",0,0,1,0,1
"cg13109725",0,0,4,0,4
"cg13110839",1,0,0,0,1
"cg13111263",14,19,1,0,34
"cg13114125",0,0,1,0,1
"cg13114387",2,9,0,0,11
"cg13114711",72,3,0,0,75
"cg13115056",1,0,1,0,2
"cg13115411",1,0,0,0,1
"cg13115424",1,1,0,0,2
"cg13115440",0,0,2,0,2
"cg13115750",1,0,0,0,1
"cg13115957",10,0,0,0,10
"cg13116071",1,0,0,0,1
"cg13116289",0,0,1,0,1
"cg13116508",0,3,5,0,8
"cg13117809",0,3,2,0,5
"cg13117822",1,2,0,0,3
"cg13118287",9,5,0,0,14
"cg13118410",0,0,1,0,1
"cg13118559",0,0,1,0,1
"cg13119495",5,0,0,0,5
"cg13120677",1,0,0,0,1
"cg13120798",0,0,2,0,2
"cg13121377",1,2,0,0,3
"cg13125997",0,0,4,0,4
"cg13126378",157,9,0,0,166
"cg13126529",2,1,0,0,3
"cg13126643",0,0,1,0,1
"cg13127591",1,0,0,0,1
"cg13127699",3,0,0,0,3
"cg13127825",0,0,1,0,1
"cg13128577",0,0,7,0,7
"cg13128865",0,0,1,0,1
"cg13128905",1,0,0,0,1
"cg13129612",0,0,1,0,1
"cg13130526",64,6,0,0,70
"cg13130552",2,1,0,0,3
"cg13130880",6,2,0,0,8
"cg13131111",1,0,0,0,1
"cg13132986",0,0,1,0,1
"cg13134082",9,1,0,0,10
"cg13134484",1,0,0,0,1
"cg13134736",0,2,0,0,2
"cg13134864",0,0,2,0,2
"cg13135420",0,0,2,0,2
"cg13135711",5,0,0,0,5
"cg13136344",1,0,2,0,3
"cg13138089",0,1,0,0,1
"cg13138539",0,1,0,0,1
"cg13138954",0,1,0,0,1
"cg13139593",9,1,0,0,10
"cg13139730",0,0,1,0,1
"cg13140597",0,1,0,0,1
"cg13140681",0,1,0,0,1
"cg13142750",0,0,1,0,1
"cg13142949",1,0,0,0,1
"cg13145229",1,0,0,0,1
"cg13145670",0,1,0,0,1
"cg13145811",16,1,0,0,17
"cg13146674",0,1,0,0,1
"cg13146883",6,3,0,0,9
"cg13146939",0,4,4,0,8
"cg13147290",0,0,1,0,1
"cg13147301",0,0,3,0,3
"cg13147721",1,0,0,0,1
"cg13148003",1,0,0,0,1
"cg13149281",0,0,1,0,1
"cg13149459",0,0,0,1,1
"cg13149573",1,0,0,0,1
"cg13149745",2,0,0,0,2
"cg13150233",200,41,0,0,241
"cg13150977",0,4,4,0,8
"cg13151345",0,0,6,0,6
"cg13151500",1,0,0,0,1
"cg13152990",1,1,0,0,2
"cg13153652",1,0,0,0,1
"cg13153966",1,1,0,0,2
"cg13154140",1,0,0,0,1
"cg13154622",1,2,1,0,4
"cg13155295",3,0,0,0,3
"cg13155877",12,1,0,0,13
"cg13155974",0,0,1,0,1
"cg13156012",0,0,1,0,1
"cg13156643",8,0,0,0,8
"cg13157246",0,0,3,0,3
"cg13157694",0,0,1,0,1
"cg13157888",0,1,0,0,1
"cg13160738",1,2,3,0,6
"cg13160888",1,0,0,0,1
"cg13161263",0,1,0,0,1
"cg13162692",0,1,0,0,1
"cg13162960",1,0,0,0,1
"cg13163866",0,0,2,0,2
"cg13164234",0,0,1,0,1
"cg13165928",1,1,0,0,2
"cg13166577",3,2,0,0,5
"cg13168565",7,0,0,0,7
"cg13168638",20,3,0,0,23
"cg13169286",10,0,0,0,10
"cg13170468",1,1,2,0,4
"cg13171009",0,0,1,0,1
"cg13171016",0,1,0,0,1
"cg13171107",0,1,1,0,2
"cg13171642",5,13,3,0,21
"cg13172627",1,0,0,0,1
"cg13173045",0,1,0,0,1
"cg13173111",0,0,1,0,1
"cg13173722",0,0,2,0,2
"cg13174071",4,0,0,0,4
"cg13174343",3,2,6,0,11
"cg13174427",262,493,25,0,780
"cg13174735",0,6,13,0,19
"cg13174838",0,0,1,0,1
"cg13175385",1,0,2,0,3
"cg13176022",0,0,1,0,1
"cg13176270",1,0,0,0,1
"cg13177258",0,0,3,0,3
"cg13177830",0,0,1,0,1
"cg13178295",4,5,0,0,9
"cg13178798",0,2,1,0,3
"cg13179056",1,0,0,0,1
"cg13179329",0,1,0,0,1
"cg13180974",1,1,1,0,3
"cg13181284",0,0,2,0,2
"cg13181444",0,0,1,0,1
"cg13182541",0,0,1,0,1
"cg13182809",572,724,52,0,1348
"cg13183056",0,1,0,0,1
"cg13183998",0,0,2,0,2
"cg13184800",1,1,1,0,3
"cg13185745",0,1,2,0,3
"cg13185911",0,1,0,0,1
"cg13186232",1,2,0,0,3
"cg13186710",1,0,0,0,1
"cg13188468",0,0,1,0,1
"cg13188681",0,1,0,0,1
"cg13188807",0,1,0,0,1
"cg13189486",13,5,1,0,19
"cg13191760",1,0,0,0,1
"cg13192049",4,0,1,0,5
"cg13195185",0,1,0,0,1
"cg13195463",27,1,0,0,28
"cg13196216",1,2,0,0,3
"cg13196432",0,0,1,0,1
"cg13197450",1,0,0,0,1
"cg13197732",5,1,0,0,6
"cg13197733",0,0,1,0,1
"cg13199178",0,0,1,0,1
"cg13199411",0,1,0,0,1
"cg13199486",6,0,0,0,6
"cg13199842",4,0,0,0,4
"cg13200496",0,0,1,0,1
"cg13200888",1,4,6,0,11
"cg13200953",0,1,0,0,1
"cg13201362",1,0,0,0,1
"cg13202415",1,0,0,0,1
"cg13202514",7,0,0,0,7
"cg13202571",74,26,0,0,100
"cg13203749",163,55,2,0,220
"cg13204181",1,2,0,0,3
"cg13206199",4,0,0,0,4
"cg13206386",5,11,0,0,16
"cg13208590",0,0,1,0,1
"cg13208922",1,0,0,0,1
"cg13209046",1,0,0,0,1
"cg13211671",0,1,0,0,1
"cg13212677",3,1,0,0,4
"cg13214448",0,1,0,0,1
"cg13215667",3,1,0,0,4
"cg13216621",4,7,3,0,14
"cg13217746",0,0,1,0,1
"cg13218423",6,2,2,0,10
"cg13219008",0,0,1,0,1
"cg13219190",0,1,1,0,2
"cg13219505",0,0,2,0,2
"cg13219560",31,6,0,0,37
"cg13219922",0,0,2,0,2
"cg13222006",0,0,1,0,1
"cg13223095",0,1,0,0,1
"cg13223561",0,2,7,0,9
"cg13223938",10,6,1,0,17
"cg13224081",4,8,0,0,12
"cg13224573",1,1,2,0,4
"cg13224855",59,0,0,0,59
"cg13225272",6,0,0,0,6
"cg13226290",2,0,0,0,2
"cg13226712",9,2,0,0,11
"cg13227480",192,260,13,0,465
"cg13228290",1,0,0,0,1
"cg13228810",1,0,0,0,1
"cg13230077",0,0,4,0,4
"cg13231067",43,8,0,0,51
"cg13231117",5,3,0,0,8
"cg13231717",0,1,0,0,1
"cg13232781",0,1,0,0,1
"cg13234587",5,1,0,0,6
"cg13234706",35,1,0,0,36
"cg13234880",1,0,1,0,2
"cg13235287",1,0,0,0,1
"cg13237630",3,0,0,0,3
"cg13240109",4,0,0,0,4
"cg13242192",0,1,0,0,1
"cg13242999",395,169,2,0,566
"cg13243311",1,0,0,0,1
"cg13243497",2,0,0,0,2
"cg13243779",0,3,2,0,5
"cg13243985",1,0,0,0,1
"cg13244538",20,7,1,0,28
"cg13244563",2,0,0,0,2
"cg13244886",354,97,10,0,461
"cg13245246",0,2,3,0,5
"cg13246206",0,0,1,0,1
"cg13246563",2,0,0,0,2
"cg13247233",0,0,1,0,1
"cg13248315",18,1,0,0,19
"cg13250767",0,1,4,0,5
"cg13250903",0,1,0,0,1
"cg13252024",0,1,0,0,1
"cg13252613",10,0,1,0,11
"cg13253660",0,0,1,0,1
"cg13253945",0,0,1,0,1
"cg13254553",1,0,0,0,1
"cg13256546",0,0,1,0,1
"cg13257190",1,0,0,0,1
"cg13258091",2,1,0,0,3
"cg13258799",1,0,0,0,1
"cg13259172",0,0,2,0,2
"cg13259368",3,0,0,0,3
"cg13260217",4,7,0,0,11
"cg13260314",6,5,0,0,11
"cg13261544",0,1,5,0,6
"cg13263691",4,4,0,0,8
"cg13264466",0,0,2,0,2
"cg13265607",6,0,0,0,6
"cg13265730",1,0,0,0,1
"cg13266423",4,0,0,0,4
"cg13266852",1,0,0,0,1
"cg13267836",6,0,0,0,6
"cg13268396",3,1,0,0,4
"cg13268728",10,4,12,0,26
"cg13272157",0,1,0,0,1
"cg13272688",14,23,0,0,37
"cg13273236",0,1,0,0,1
"cg13273345",1,0,0,0,1
"cg13273373",0,1,1,0,2
"cg13273672",0,0,1,0,1
"cg13274304",33,2,0,0,35
"cg13275724",0,1,0,0,1
"cg13276305",0,0,8,0,8
"cg13276501",1,4,3,0,8
"cg13276510",1,0,0,0,1
"cg13277393",5,11,0,0,16
"cg13278241",126,364,175,0,665
"cg13278448",0,1,1,0,2
"cg13278890",0,0,1,0,1
"cg13279055",15,4,0,0,19
"cg13279713",1,0,0,0,1
"cg13279955",0,1,0,0,1
"cg13279956",4,4,8,0,16
"cg13280524",0,0,1,0,1
"cg13282977",6,1,2,0,9
"cg13284070",1,4,5,0,10
"cg13284181",0,0,0,1,1
"cg13284864",0,0,1,0,1
"cg13284933",0,1,0,0,1
"cg13285009",2,4,0,0,6
"cg13285043",3,0,0,0,3
"cg13285328",2,0,1,0,3
"cg13285339",1,0,0,0,1
"cg13287203",0,0,1,0,1
"cg13289364",0,0,1,0,1
"cg13290719",3,0,0,0,3
"cg13292428",9,2,1,0,12
"cg13292984",11,4,0,0,15
"cg13294032",0,1,0,0,1
"cg13294300",48,9,0,0,57
"cg13295486",1,1,0,0,2
"cg13295812",580,677,16,0,1273
"cg13296093",0,0,1,0,1
"cg13296214",1,0,0,0,1
"cg13296568",9,6,3,0,18
"cg13298061",1,0,0,0,1
"cg13298632",5,3,14,0,22
"cg13299942",121,428,102,0,651
"cg13300202",0,1,2,0,3
"cg13300623",0,0,1,0,1
"cg13301043",0,0,1,0,1
"cg13301423",0,0,2,0,2
"cg13301601",1,1,0,0,2
"cg13302197",0,1,2,0,3
"cg13302401",4,0,1,0,5
"cg13302869",0,1,0,0,1
"cg13303313",1,0,1,0,2
"cg13304664",18,8,0,0,26
"cg13304837",0,0,1,0,1
"cg13305473",3,11,0,0,14
"cg13305652",0,2,0,0,2
"cg13306942",1,3,1,0,5
"cg13307850",1,0,0,0,1
"cg13309655",0,1,2,0,3
"cg13311252",0,0,1,0,1
"cg13313030",0,1,0,0,1
"cg13313951",0,1,0,0,1
"cg13314297",10,8,0,0,18
"cg13315130",1,0,3,0,4
"cg13318121",1,1,3,0,5
"cg13318368",0,1,0,0,1
"cg13318656",1,0,0,0,1
"cg13318793",0,2,0,0,2
"cg13319225",0,0,1,0,1
"cg13320837",1,0,1,0,2
"cg13321114",2,2,0,0,4
"cg13322066",0,5,1,0,6
"cg13322722",1,0,0,0,1
"cg13322954",0,1,0,0,1
"cg13323339",1,0,0,0,1
"cg13323624",0,1,0,0,1
"cg13323717",0,0,2,0,2
"cg13323752",0,0,1,0,1
"cg13324539",9,3,1,0,13
"cg13324934",0,1,1,0,2
"cg13325233",0,0,1,0,1
"cg13325919",0,1,0,0,1
"cg13328064",68,8,2,0,78
"cg13330911",0,1,0,0,1
"cg13331741",402,26,1,0,429
"cg13331882",0,0,5,0,5
"cg13331937",19,16,0,0,35
"cg13332064",13,1,0,0,14
"cg13332350",10,1,0,0,11
"cg13332499",2,0,0,0,2
"cg13333322",0,0,2,0,2
"cg13333450",0,1,0,0,1
"cg13334169",2,0,0,0,2
"cg13334518",0,0,2,0,2
"cg13336860",0,2,1,0,3
"cg13337326",0,0,2,0,2
"cg13337507",0,0,1,0,1
"cg13337657",2,1,0,0,3
"cg13337852",0,1,0,0,1
"cg13338133",85,32,0,0,117
"cg13338223",0,3,0,0,3
"cg13338350",1,1,1,0,3
"cg13340899",1,0,1,0,2
"cg13341491",0,1,0,0,1
"cg13341633",0,0,1,0,1
"cg13342054",0,0,1,0,1
"cg13345375",0,1,0,0,1
"cg13345430",0,1,5,0,6
"cg13346967",2,0,0,0,2
"cg13347452",155,120,3,0,278
"cg13347741",3,0,0,0,3
"cg13348152",3,0,0,0,3
"cg13349462",8,1,2,0,11
"cg13351960",36,13,1,0,50
"cg13352563",1,0,0,0,1
"cg13352601",0,0,2,0,2
"cg13353315",82,160,2,0,244
"cg13353389",1,0,1,0,2
"cg13355613",131,8,0,0,139
"cg13356164",0,0,4,0,4
"cg13357330",1,0,0,0,1
"cg13357708",57,3,0,0,60
"cg13358321",0,0,1,0,1
"cg13358700",0,1,0,0,1
"cg13360950",1,0,2,0,3
"cg13362719",0,0,1,0,1
"cg13363530",7,1,0,0,8
"cg13363740",8,1,1,0,10
"cg13363823",1,0,0,0,1
"cg13364389",43,7,1,0,51
"cg13365279",1,0,0,0,1
"cg13365752",4,4,1,0,9
"cg13365874",0,0,1,0,1
"cg13366801",0,1,0,0,1
"cg13367272",3,0,0,0,3
"cg13367756",0,0,1,0,1
"cg13368274",1,0,0,0,1
"cg13368662",0,0,4,0,4
"cg13369073",0,0,1,0,1
"cg13369137",1,0,0,0,1
"cg13369138",141,176,2,0,319
"cg13369284",0,0,1,0,1
"cg13369554",0,0,1,0,1
"cg13370681",0,0,2,0,2
"cg13371465",3,6,4,0,13
"cg13371839",6,2,0,0,8
"cg13372571",1,0,0,0,1
"cg13372635",12,3,1,0,16
"cg13372905",0,0,1,0,1
"cg13373066",0,1,0,0,1
"cg13373935",0,1,0,0,1
"cg13374304",0,0,1,0,1
"cg13375110",0,1,0,0,1
"cg13375255",30,16,1,0,47
"cg13375764",10,2,0,0,12
"cg13375897",1,0,0,0,1
"cg13376096",23,4,0,0,27
"cg13376720",34,36,0,0,70
"cg13376960",1,0,0,0,1
"cg13377324",0,0,1,0,1
"cg13377750",1,0,0,0,1
"cg13379731",1,0,0,0,1
"cg13382661",1,0,0,0,1
"cg13382953",0,4,0,0,4
"cg13382985",1,0,1,0,2
"cg13383010",0,1,4,0,5
"cg13383425",0,0,1,0,1
"cg13383572",0,1,0,0,1
"cg13383734",0,0,1,0,1
"cg13383814",0,0,1,0,1
"cg13384498",0,0,1,0,1
"cg13384731",0,1,0,0,1
"cg13385521",0,0,1,0,1
"cg13385794",1,0,0,0,1
"cg13386084",264,232,10,0,506
"cg13386839",11,0,0,0,11
"cg13387071",282,13,0,0,295
"cg13388625",1,0,0,0,1
"cg13390231",4,0,0,0,4
"cg13391471",1,0,0,0,1
"cg13391512",0,0,1,0,1
"cg13391607",162,17,0,0,179
"cg13391740",24,23,0,0,47
"cg13392512",0,1,3,0,4
"cg13392745",0,1,0,0,1
"cg13392875",0,0,1,0,1
"cg13393851",1,1,0,0,2
"cg13394785",1270,453,8,0,1731
"cg13396436",0,0,1,0,1
"cg13397055",0,2,3,0,5
"cg13397166",0,2,4,0,6
"cg13397820",0,1,0,0,1
"cg13398314",0,1,0,0,1
"cg13398674",0,1,0,0,1
"cg13399709",1,0,0,0,1
"cg13399791",0,0,2,0,2
"cg13400206",0,1,1,0,2
"cg13400248",0,0,1,0,1
"cg13400332",2,0,0,0,2
"cg13400423",3,3,0,0,6
"cg13401212",24,4,0,0,28
"cg13401581",15,3,0,0,18
"cg13402083",2,0,0,0,2
"cg13402354",0,0,1,0,1
"cg13402656",7,7,0,0,14
"cg13403121",0,0,3,0,3
"cg13403405",1,0,1,0,2
"cg13403815",0,0,0,1,1
"cg13404137",4,2,2,0,8
"cg13404532",0,11,0,0,11
"cg13404670",298,203,6,0,507
"cg13405525",0,0,2,0,2
"cg13407149",0,1,6,0,7
"cg13407463",0,1,3,0,4
"cg13407658",5,2,2,0,9
"cg13407664",0,1,0,0,1
"cg13407883",1,0,0,0,1
"cg13408790",62,6,0,0,68
"cg13409090",3,3,0,0,6
"cg13409938",0,1,0,0,1
"cg13409950",2,2,0,0,4
"cg13411336",1,1,0,0,2
"cg13411658",5,0,0,0,5
"cg13411755",0,1,0,0,1
"cg13411879",0,1,0,0,1
"cg13412154",496,25,0,0,521
"cg13412452",80,43,2,0,125
"cg13415320",412,21,2,0,435
"cg13416109",0,0,3,0,3
"cg13417679",1,0,0,0,1
"cg13419214",0,0,1,0,1
"cg13419505",0,0,1,0,1
"cg13420196",0,0,1,0,1
"cg13420408",2,2,3,0,7
"cg13420581",27,8,2,0,37
"cg13420944",81,11,1,0,93
"cg13421194",2,0,0,0,2
"cg13421418",1,0,0,0,1
"cg13421489",676,93,3,0,772
"cg13421745",1,0,0,0,1
"cg13421753",4,3,1,0,8
"cg13422093",2,1,1,0,4
"cg13422164",0,0,1,0,1
"cg13422261",0,3,1,0,4
"cg13422555",0,0,1,0,1
"cg13422744",4,6,0,0,10
"cg13424296",5,3,0,0,8
"cg13424446",4,7,0,0,11
"cg13425342",0,0,0,1,1
"cg13425712",0,1,0,0,1
"cg13425888",0,1,0,0,1
"cg13425962",1,0,0,0,1
"cg13426340",5,1,0,0,6
"cg13426660",1,0,0,0,1
"cg13428620",0,0,1,0,1
"cg13428743",0,0,1,0,1
"cg13429435",0,1,0,0,1
"cg13429675",4,0,0,0,4
"cg13430145",0,0,1,0,1
"cg13430409",0,2,0,0,2
"cg13430768",3,1,0,0,4
"cg13430777",3,3,1,0,7
"cg13430851",1,0,0,0,1
"cg13431160",43,29,2,0,74
"cg13431406",1,0,0,0,1
"cg13431811",1,0,0,0,1
"cg13432194",2,1,0,0,3
"cg13432217",0,0,1,0,1
"cg13432228",25,1,0,0,26
"cg13432470",0,1,3,0,4
"cg13432558",1,0,0,0,1
"cg13434034",5,3,3,0,11
"cg13434308",1,0,1,0,2
"cg13435243",0,1,0,0,1
"cg13435758",7,1,1,0,9
"cg13435833",5,2,0,0,7
"cg13436192",1,0,0,0,1
"cg13436467",2,0,1,0,3
"cg13436679",1,0,0,0,1
"cg13436725",94,342,64,0,500
"cg13436996",0,1,0,0,1
"cg13437056",9,0,0,0,9
"cg13437084",0,2,0,0,2
"cg13437277",1,0,0,0,1
"cg13437870",1,0,0,0,1
"cg13437998",6,9,2,0,17
"cg13439030",5,6,2,0,13
"cg13439084",1,2,1,0,4
"cg13439902",0,0,2,0,2
"cg13441213",0,0,1,0,1
"cg13441524",0,1,0,0,1
"cg13442045",51,4,0,0,55
"cg13442241",0,1,0,0,1
"cg13443562",0,0,3,0,3
"cg13444289",0,0,1,0,1
"cg13445334",1,2,3,0,6
"cg13445593",1,0,1,0,2
"cg13445984",23,11,2,0,36
"cg13446859",1,1,0,0,2
"cg13449367",0,0,1,0,1
"cg13451431",6,7,0,0,13
"cg13451433",0,0,1,0,1
"cg13451556",3,0,0,0,3
"cg13451733",174,181,32,0,387
"cg13452044",0,4,3,0,7
"cg13452868",1,0,0,0,1
"cg13453711",20,9,0,0,29
"cg13458190",0,0,1,0,1
"cg13459209",0,2,0,0,2
"cg13459244",0,1,0,0,1
"cg13459393",1,0,0,0,1
"cg13460414",0,1,5,0,6
"cg13460906",0,1,4,0,5
"cg13461493",0,1,0,0,1
"cg13461762",4,2,1,0,7
"cg13461793",1,4,2,0,7
"cg13461950",2,0,0,0,2
"cg13462160",0,0,2,0,2
"cg13462173",0,1,0,0,1
"cg13462275",0,1,0,0,1
"cg13462829",2,1,0,0,3
"cg13462935",1,1,0,0,2
"cg13462967",0,0,1,0,1
"cg13463850",3,0,0,0,3
"cg13464260",3,1,0,0,4
"cg13464436",3,0,1,0,4
"cg13464439",18,14,4,0,36
"cg13465769",0,0,1,0,1
"cg13466069",1,0,0,0,1
"cg13467096",1,0,0,0,1
"cg13468249",0,1,0,0,1
"cg13469058",0,0,1,0,1
"cg13469403",1,0,0,0,1
"cg13469777",0,0,1,0,1
"cg13470112",4,0,0,0,4
"cg13470337",0,0,1,0,1
"cg13470338",0,1,0,0,1
"cg13471028",0,1,0,0,1
"cg13471424",0,3,0,0,3
"cg13472503",0,3,1,0,4
"cg13472645",0,0,3,0,3
"cg13472691",1,0,0,0,1
"cg13473078",0,0,1,0,1
"cg13473769",1,0,1,0,2
"cg13474244",0,0,0,2,2
"cg13474680",10,13,4,0,27
"cg13474920",3,0,0,0,3
"cg13475819",6,1,0,0,7
"cg13475862",11,11,3,0,25
"cg13475915",48,2,0,0,50
"cg13476263",3,3,0,0,6
"cg13476464",2,0,0,0,2
"cg13476743",1,0,0,0,1
"cg13476932",3,0,0,0,3
"cg13478010",1,0,0,0,1
"cg13480214",0,0,3,0,3
"cg13480614",1,0,0,0,1
"cg13480948",1,3,1,0,5
"cg13481239",1,0,0,0,1
"cg13481755",0,3,6,0,9
"cg13482378",3,0,0,0,3
"cg13482954",0,1,0,0,1
"cg13483099",198,423,44,0,665
"cg13483959",0,0,2,0,2
"cg13484042",1,0,1,0,2
"cg13486531",3,0,0,0,3
"cg13487037",102,47,0,0,149
"cg13487284",1,4,2,0,7
"cg13487422",155,44,29,0,228
"cg13488725",81,15,2,0,98
"cg13488930",0,1,1,0,2
"cg13490128",1,0,0,0,1
"cg13490578",1,0,0,0,1
"cg13491005",0,0,1,0,1
"cg13491304",5,0,0,0,5
"cg13491662",1,1,0,0,2
"cg13493048",1,0,0,0,1
"cg13493781",3,5,1,0,9
"cg13494037",1,0,1,0,2
"cg13494721",0,0,1,0,1
"cg13494827",3,0,0,0,3
"cg13494933",0,0,2,0,2
"cg13494942",1,1,0,0,2
"cg13495928",0,1,0,0,1
"cg13496251",0,0,1,0,1
"cg13496425",6,4,0,0,10
"cg13496662",0,1,0,0,1
"cg13496837",0,5,1,0,6
"cg13497366",4,0,1,0,5
"cg13497563",1,0,0,0,1
"cg13497696",0,1,0,0,1
"cg13498940",48,83,0,0,131
"cg13499161",0,0,1,0,1
"cg13499371",0,0,1,0,1
"cg13500013",0,1,5,0,6
"cg13500346",0,0,1,0,1
"cg13501185",0,0,1,0,1
"cg13501959",6,2,11,0,19
"cg13503477",0,0,1,0,1
"cg13504410",1,0,0,0,1
"cg13505245",1,0,0,0,1
"cg13505268",3,4,0,0,7
"cg13505736",3,3,6,0,12
"cg13506136",10,15,0,0,25
"cg13506547",1,0,0,0,1
"cg13507091",860,131,2,0,993
"cg13507224",1,0,0,0,1
"cg13507489",7,0,0,0,7
"cg13509135",0,0,1,0,1
"cg13509363",0,0,1,0,1
"cg13509423",0,0,1,0,1
"cg13510648",0,2,3,0,5
"cg13511293",0,1,0,0,1
"cg13511512",2,0,0,0,2
"cg13511569",0,1,3,0,4
"cg13511842",1,0,0,0,1
"cg13512069",0,0,1,0,1
"cg13512303",0,0,1,0,1
"cg13513229",1,0,0,0,1
"cg13514100",0,1,0,0,1
"cg13515856",4,0,0,0,4
"cg13515868",0,0,1,0,1
"cg13516414",5,7,0,0,12
"cg13517396",0,1,0,0,1
"cg13517747",17,3,0,0,20
"cg13517754",1,0,0,0,1
"cg13517886",1,1,0,0,2
"cg13518385",7,10,1,0,18
"cg13520101",1,0,0,0,1
"cg13520324",0,0,1,0,1
"cg13520342",0,1,0,0,1
"cg13520845",0,1,0,0,1
"cg13521677",0,0,1,0,1
"cg13521869",0,2,0,0,2
"cg13521889",0,1,0,0,1
"cg13522187",2,1,4,0,7
"cg13523038",0,0,1,0,1
"cg13523068",0,1,7,0,8
"cg13523312",0,2,1,0,3
"cg13524796",1,0,0,0,1
"cg13525316",1,0,0,0,1
"cg13525428",0,0,1,0,1
"cg13526492",0,1,0,0,1
"cg13527632",0,1,0,0,1
"cg13528338",1,0,0,0,1
"cg13529101",1,0,0,0,1
"cg13529245",3,0,0,0,3
"cg13530365",1,0,0,0,1
"cg13530485",1,0,0,0,1
"cg13531315",0,0,1,0,1
"cg13532174",1,0,0,0,1
"cg13532467",6,1,0,0,7
"cg13532753",1,0,0,0,1
"cg13532829",1,0,0,0,1
"cg13533403",0,0,2,0,2
"cg13534903",154,419,40,0,613
"cg13535531",0,0,1,0,1
"cg13536076",1,0,0,0,1
"cg13537471",0,0,3,0,3
"cg13537940",1,0,0,0,1
"cg13538431",0,1,0,0,1
"cg13538645",7,0,0,0,7
"cg13540126",0,0,1,0,1
"cg13540618",2,0,0,0,2
"cg13541257",1,4,0,0,5
"cg13541303",0,3,0,0,3
"cg13541457",157,13,0,0,170
"cg13542042",39,7,0,0,46
"cg13542090",0,1,0,0,1
"cg13543205",198,429,2,0,629
"cg13543216",0,0,4,0,4
"cg13543576",0,0,1,0,1
"cg13544455",1,0,0,0,1
"cg13545538",7,6,12,0,25
"cg13546538",3,0,0,0,3
"cg13547363",0,2,0,0,2
"cg13547394",18,1,0,0,19
"cg13547525",0,1,0,0,1
"cg13548164",2,0,0,0,2
"cg13550365",2,0,0,0,2
"cg13552272",0,0,2,0,2
"cg13552315",0,1,0,1,2
"cg13552431",0,0,5,0,5
"cg13552964",1,0,0,0,1
"cg13553548",9,0,0,0,9
"cg13553897",76,7,0,0,83
"cg13554030",3,0,0,0,3
"cg13555225",0,0,1,0,1
"cg13555884",0,0,8,0,8
"cg13556079",1082,146,0,0,1228
"cg13556949",1,1,0,0,2
"cg13557112",0,1,0,0,1
"cg13557160",7,0,0,0,7
"cg13558029",2,0,0,0,2
"cg13558199",0,0,0,2,2
"cg13559048",0,1,0,0,1
"cg13559579",0,0,1,0,1
"cg13560204",2,0,0,0,2
"cg13560328",1,0,0,0,1
"cg13561307",1,0,0,0,1
"cg13561339",1,6,5,0,12
"cg13561662",0,0,1,0,1
"cg13562151",6,0,0,0,6
"cg13562933",0,0,1,0,1
"cg13563395",44,9,2,0,55
"cg13564654",122,22,0,0,144
"cg13565252",6,0,0,0,6
"cg13565382",203,86,3,0,292
"cg13565468",2,0,0,0,2
"cg13567015",1,0,0,0,1
"cg13568946",6,1,0,0,7
"cg13569449",42,1,0,0,43
"cg13570912",3,0,0,0,3
"cg13571972",0,0,1,0,1
"cg13572146",0,1,0,0,1
"cg13573073",269,94,10,0,373
"cg13573295",0,1,1,0,2
"cg13573350",1,0,0,0,1
"cg13573587",1,0,0,0,1
"cg13574050",121,145,14,0,280
"cg13574499",46,13,0,0,59
"cg13576788",0,0,0,1,1
"cg13577194",0,1,0,0,1
"cg13578165",3,0,0,0,3
"cg13578306",0,2,0,0,2
"cg13579428",0,0,1,0,1
"cg13579574",0,0,1,0,1
"cg13579926",115,298,216,0,629
"cg13580046",0,2,0,0,2
"cg13580201",4,4,1,0,9
"cg13580232",2,1,0,0,3
"cg13580336",1,1,1,0,3
"cg13580836",1,4,0,0,5
"cg13582542",1,14,3,0,18
"cg13584034",10,12,2,0,24
"cg13584399",0,1,0,0,1
"cg13584678",0,0,1,0,1
"cg13585032",1,0,0,0,1
"cg13585175",1,0,0,0,1
"cg13587056",0,0,6,0,6
"cg13587077",1,0,0,0,1
"cg13587495",1,0,0,0,1
"cg13587997",7,4,1,0,12
"cg13588207",1,0,0,0,1
"cg13588224",2,1,0,0,3
"cg13589588",21,1,0,0,22
"cg13589972",1,0,1,0,2
"cg13590297",0,1,0,0,1
"cg13592925",28,6,0,0,34
"cg13594653",3,3,0,0,6
"cg13594837",61,30,0,0,91
"cg13595342",3,0,0,0,3
"cg13596136",2,0,0,0,2
"cg13596693",2,0,0,0,2
"cg13597244",0,2,1,0,3
"cg13597417",0,0,1,0,1
"cg13597865",67,720,11,0,798
"cg13598516",1,0,0,0,1
"cg13598589",3,0,1,0,4
"cg13599051",288,84,5,0,377
"cg13600420",0,1,0,0,1
"cg13601079",0,2,0,0,2
"cg13602201",2,0,0,0,2
"cg13602967",199,19,0,0,218
"cg13603142",4,21,1,0,26
"cg13604811",0,2,0,0,2
"cg13605670",2,0,0,0,2
"cg13606401",1,1,0,0,2
"cg13606691",7,1,0,0,8
"cg13606758",0,1,0,0,1
"cg13608282",0,1,2,0,3
"cg13610497",1,0,0,0,1
"cg13610573",0,0,2,0,2
"cg13611997",0,2,0,0,2
"cg13612949",1,0,0,0,1
"cg13613146",0,1,1,0,2
"cg13614469",2,0,0,0,2
"cg13614586",1,0,0,0,1
"cg13614812",0,0,1,0,1
"cg13614887",0,1,0,0,1
"cg13616628",0,2,0,0,2
"cg13617604",0,0,2,0,2
"cg13617824",515,45,1,0,561
"cg13618100",2,2,21,0,25
"cg13619349",6,0,0,0,6
"cg13619597",1,0,1,0,2
"cg13619877",0,0,3,0,3
"cg13621329",2,0,1,0,3
"cg13622028",0,0,1,0,1
"cg13622351",0,1,0,0,1
"cg13622401",2,0,0,0,2
"cg13622549",2,5,0,1,8
"cg13622993",70,0,0,0,70
"cg13624420",4,5,1,0,10
"cg13624860",0,1,0,0,1
"cg13625045",0,0,2,0,2
"cg13628100",10,1,4,0,15
"cg13628888",2,0,0,0,2
"cg13629132",1,1,0,0,2
"cg13630607",2,0,0,0,2
"cg13630855",0,0,1,0,1
"cg13630944",1,2,0,0,3
"cg13630980",0,0,2,0,2
"cg13631389",1,1,1,0,3
"cg13632087",1,2,2,0,5
"cg13632328",0,0,3,0,3
"cg13632790",25,19,0,0,44
"cg13633941",1,0,0,0,1
"cg13634122",10,8,0,0,18
"cg13635262",0,0,1,0,1
"cg13635298",0,1,0,0,1
"cg13635886",0,1,2,0,3
"cg13636337",1,0,0,0,1
"cg13636543",0,2,0,0,2
"cg13637352",422,628,25,0,1075
"cg13638153",1,0,0,0,1
"cg13638434",1,3,3,0,7
"cg13638980",2,0,0,0,2
"cg13639079",1,0,0,0,1
"cg13639093",7,15,11,0,33
"cg13639679",2,3,0,0,5
"cg13639922",1,0,0,0,1
"cg13640972",0,1,2,0,3
"cg13642754",1,0,1,0,2
"cg13642800",123,298,135,0,556
"cg13642881",13,6,0,0,19
"cg13643215",41,14,0,0,55
"cg13643774",1,0,0,0,1
"cg13644150",0,0,1,0,1
"cg13644543",0,0,1,0,1
"cg13644646",4,2,0,0,6
"cg13645106",14,1,0,0,15
"cg13645242",0,0,1,0,1
"cg13647446",1,0,1,0,2
"cg13647477",1,0,0,0,1
"cg13647758",1,0,0,0,1
"cg13648080",0,0,1,0,1
"cg13648157",186,35,0,0,221
"cg13648192",0,0,0,1,1
"cg13649060",0,0,1,0,1
"cg13649168",0,0,1,0,1
"cg13650221",0,0,1,0,1
"cg13650304",2,4,5,0,11
"cg13650422",6,0,0,0,6
"cg13650837",2,0,0,0,2
"cg13651685",0,0,2,0,2
"cg13651699",0,0,1,0,1
"cg13652609",180,62,3,0,245
"cg13653281",0,1,0,0,1
"cg13654021",1,2,0,0,3
"cg13654848",1,0,0,0,1
"cg13655396",0,1,0,0,1
"cg13657004",0,1,0,0,1
"cg13657276",0,2,1,0,3
"cg13657322",2,0,0,0,2
"cg13657404",0,0,11,0,11
"cg13657659",1,0,0,0,1
"cg13657664",990,112,0,0,1102
"cg13658436",0,0,1,0,1
"cg13659329",106,13,0,0,119
"cg13659970",0,0,1,0,1
"cg13660443",1,0,0,0,1
"cg13660622",4,2,3,0,9
"cg13660670",0,0,1,0,1
"cg13660998",10,0,0,0,10
"cg13661150",0,0,2,0,2
"cg13661793",0,0,1,0,1
"cg13661908",3,3,0,0,6
"cg13662724",185,26,0,0,211
"cg13662933",5,2,0,0,7
"cg13663292",0,0,1,0,1
"cg13663626",1,0,0,0,1
"cg13663649",35,1,0,0,36
"cg13664549",0,1,0,0,1
"cg13665068",2,0,0,0,2
"cg13665916",1,0,1,0,2
"cg13666716",0,0,1,0,1
"cg13666778",1,0,0,0,1
"cg13667633",1,0,0,0,1
"cg13668005",0,0,1,0,1
"cg13668025",18,1,0,0,19
"cg13668276",1,0,0,0,1
"cg13672050",78,4,0,0,82
"cg13672080",0,0,2,0,2
"cg13672348",0,1,0,0,1
"cg13672638",0,0,0,1,1
"cg13673126",0,1,0,0,1
"cg13674088",0,0,1,0,1
"cg13674372",14,2,0,0,16
"cg13674483",0,1,0,0,1
"cg13675133",56,38,2,0,96
"cg13675319",0,0,2,0,2
"cg13675379",9,1,0,0,10
"cg13675393",1,0,0,0,1
"cg13675738",3,0,0,0,3
"cg13676296",0,0,5,0,5
"cg13676665",1,0,0,0,1
"cg13677058",2,0,0,0,2
"cg13677087",0,0,1,0,1
"cg13677779",0,0,1,0,1
"cg13678232",1,3,0,0,4
"cg13678243",1,0,0,0,1
"cg13678470",3,0,0,0,3
"cg13678551",1,0,0,0,1
"cg13679311",0,0,1,0,1
"cg13680178",1,0,0,0,1
"cg13680266",0,1,0,0,1
"cg13681355",0,0,1,0,1
"cg13682040",0,0,1,0,1
"cg13684156",1,1,0,0,2
"cg13684240",0,0,1,0,1
"cg13684290",1,0,0,0,1
"cg13684625",0,1,2,0,3
"cg13686751",0,6,0,0,6
"cg13686799",2,0,0,0,2
"cg13686856",0,0,2,0,2
"cg13687331",1,3,5,0,9
"cg13687639",4,0,0,0,4
"cg13687837",0,3,0,0,3
"cg13688123",0,1,1,0,2
"cg13688162",0,0,1,0,1
"cg13688974",1,0,0,0,1
"cg13689808",0,0,2,0,2
"cg13690510",0,6,0,0,6
"cg13690691",0,0,1,0,1
"cg13690935",0,0,1,0,1
"cg13691259",35,67,66,0,168
"cg13691277",7,6,2,0,15
"cg13691697",0,1,0,0,1
"cg13692112",2,1,0,0,3
"cg13692121",11,1,0,0,12
"cg13695261",12,5,0,0,17
"cg13696074",0,0,1,0,1
"cg13696287",5,1,0,0,6
"cg13696466",0,1,0,0,1
"cg13697715",0,0,1,0,1
"cg13698362",0,4,5,0,9
"cg13698979",3,0,0,0,3
"cg13699139",4,2,1,0,7
"cg13699172",281,7,0,0,288
"cg13700148",1,0,1,0,2
"cg13700207",4,1,0,0,5
"cg13700552",0,0,1,0,1
"cg13700815",0,0,0,1,1
"cg13701221",6,3,0,0,9
"cg13701327",0,0,1,0,1
"cg13702996",1,0,0,0,1
"cg13703089",0,1,0,0,1
"cg13703095",495,52,1,0,548
"cg13703876",1,0,0,0,1
"cg13704117",1,0,0,0,1
"cg13704140",0,0,1,0,1
"cg13704461",0,0,1,0,1
"cg13704629",3,2,0,0,5
"cg13705047",0,0,1,0,1
"cg13705753",1,0,0,0,1
"cg13705828",45,25,0,0,70
"cg13706404",0,1,3,0,4
"cg13706438",171,400,45,0,616
"cg13706567",5,6,0,0,11
"cg13706899",0,2,1,0,3
"cg13707123",8,0,0,0,8
"cg13707371",173,257,2,0,432
"cg13707797",1,2,0,0,3
"cg13707898",708,724,11,0,1443
"cg13709720",0,1,0,0,1
"cg13710086",1,1,1,0,3
"cg13710925",3,0,0,0,3
"cg13711552",5,0,0,0,5
"cg13711717",5,3,3,0,11
"cg13712952",1,0,0,0,1
"cg13713010",0,0,5,0,5
"cg13713044",0,1,0,0,1
"cg13713718",2,0,0,0,2
"cg13713771",3,2,0,0,5
"cg13714086",44,1,0,0,45
"cg13714087",1,3,2,0,6
"cg13714160",0,1,0,0,1
"cg13714241",532,32,1,0,565
"cg13715752",1,3,2,0,6
"cg13715827",1,0,0,0,1
"cg13716167",3,0,0,0,3
"cg13717145",52,15,0,0,67
"cg13717247",3,5,1,0,9
"cg13717338",0,0,1,0,1
"cg13717555",253,194,6,0,453
"cg13718387",41,0,0,0,41
"cg13718462",6,1,0,0,7
"cg13718517",0,0,1,0,1
"cg13719246",0,2,1,0,3
"cg13720686",13,4,0,0,17
"cg13720705",0,1,0,0,1
"cg13721479",2,0,3,0,5
"cg13721688",4,6,17,0,27
"cg13722127",1,0,0,0,1
"cg13724976",2,0,3,0,5
"cg13725495",0,0,3,0,3
"cg13726491",0,0,2,0,2
"cg13726633",15,4,1,0,20
"cg13727710",0,0,1,0,1
"cg13728108",0,0,1,0,1
"cg13728441",1,0,0,0,1
"cg13730219",0,0,1,0,1
"cg13730886",1,0,1,0,2
"cg13731106",0,0,1,0,1
"cg13731525",0,0,1,0,1
"cg13731588",2,0,0,0,2
"cg13731936",0,1,0,0,1
"cg13733000",1,1,0,0,2
"cg13733010",2,0,0,0,2
"cg13734281",0,0,1,1,2
"cg13734314",1,1,1,0,3
"cg13736794",1,0,0,0,1
"cg13736811",1,0,0,0,1
"cg13738155",13,0,0,0,13
"cg13738382",1,0,0,0,1
"cg13738964",0,0,0,1,1
"cg13739345",0,1,0,0,1
"cg13740508",1,0,0,0,1
"cg13741263",2,0,0,0,2
"cg13742426",3,0,0,0,3
"cg13743149",62,32,4,0,98
"cg13743789",0,0,1,0,1
"cg13744452",0,0,1,0,1
"cg13745005",0,0,1,0,1
"cg13745210",1,0,0,0,1
"cg13745289",0,0,1,0,1
"cg13745513",6,1,0,0,7
"cg13746545",1,0,0,0,1
"cg13747872",0,1,1,0,2
"cg13748041",0,0,1,0,1
"cg13748734",1,0,0,0,1
"cg13748755",0,2,0,0,2
"cg13748813",1,0,1,0,2
"cg13749529",0,0,1,0,1
"cg13750180",1,0,0,0,1
"cg13750326",0,1,0,0,1
"cg13751364",1,0,0,0,1
"cg13751596",3,1,0,0,4
"cg13751645",0,1,1,0,2
"cg13751692",1,0,0,0,1
"cg13751923",1,0,0,0,1
"cg13752558",1,0,0,0,1
"cg13752981",0,0,1,0,1
"cg13753831",0,0,1,0,1
"cg13753962",0,0,1,0,1
"cg13754621",106,56,5,0,167
"cg13754687",159,21,1,0,181
"cg13755776",2,10,8,0,20
"cg13756898",1,0,0,0,1
"cg13757172",2,0,0,0,2
"cg13757822",0,2,0,0,2
"cg13758168",0,0,2,0,2
"cg13758860",1,0,0,0,1
"cg13761134",1,0,0,0,1
"cg13761436",4,0,0,0,4
"cg13761667",0,0,1,0,1
"cg13762704",0,1,0,0,1
"cg13763828",1,4,2,0,7
"cg13763872",0,0,2,0,2
"cg13765646",0,3,2,0,5
"cg13766520",0,0,1,0,1
"cg13766651",21,1,0,0,22
"cg13766910",1,0,0,0,1
"cg13767095",337,245,5,0,587
"cg13767948",0,0,1,0,1
"cg13768174",1,0,0,0,1
"cg13768269",0,0,1,0,1
"cg13768670",5,0,0,0,5
"cg13768872",196,241,5,0,442
"cg13769046",0,1,0,0,1
"cg13769609",1,3,0,0,4
"cg13770153",5,1,1,0,7
"cg13771214",0,0,3,0,3
"cg13771438",0,0,1,0,1
"cg13771517",2,0,1,0,3
"cg13772815",0,1,1,0,2
"cg13772903",0,1,0,0,1
"cg13774707",0,0,1,0,1
"cg13776134",0,0,1,0,1
"cg13776460",1,1,0,0,2
"cg13776542",0,0,1,0,1
"cg13777312",0,0,2,0,2
"cg13777488",959,38,0,0,997
"cg13778815",0,1,1,1,3
"cg13780046",2,0,0,0,2
"cg13780303",0,0,2,0,2
"cg13781120",8,9,3,0,20
"cg13781121",0,2,0,0,2
"cg13781938",43,18,0,0,61
"cg13782311",0,0,1,0,1
"cg13782443",1,0,0,0,1
"cg13785951",284,5,0,0,289
"cg13786424",9,3,1,0,13
"cg13787921",1,0,0,0,1
"cg13788959",3,0,0,0,3
"cg13789403",0,0,1,0,1
"cg13789443",4,0,0,0,4
"cg13790166",0,1,2,0,3
"cg13790427",0,3,0,0,3
"cg13790785",4,2,0,0,6
"cg13790906",0,1,0,0,1
"cg13791130",79,23,2,0,104
"cg13791183",0,0,1,0,1
"cg13791594",2,4,0,0,6
"cg13791713",1,1,0,0,2
"cg13791925",0,0,1,0,1
"cg13792415",0,0,1,0,1
"cg13792856",0,1,0,0,1
"cg13793064",0,1,0,0,1
"cg13793747",87,33,3,0,123
"cg13794372",0,0,3,0,3
"cg13794529",0,1,0,0,1
"cg13794641",0,0,2,0,2
"cg13794889",8,0,0,0,8
"cg13795652",1,0,0,0,1
"cg13795805",1,0,0,0,1
"cg13796246",507,43,0,0,550
"cg13796518",0,0,1,0,1
"cg13796559",19,0,0,0,19
"cg13797014",0,0,2,0,2
"cg13797019",2,0,0,0,2
"cg13797713",1,0,0,0,1
"cg13799082",22,2,1,0,25
"cg13799416",550,214,12,0,776
"cg13801307",0,3,5,0,8
"cg13801510",1,0,0,0,1
"cg13801831",0,1,0,0,1
"cg13802151",0,1,0,0,1
"cg13802742",1,0,0,0,1
"cg13802760",0,0,5,0,5
"cg13802966",1,0,1,0,2
"cg13803154",0,0,2,0,2
"cg13804450",14,8,0,0,22
"cg13805139",0,0,1,0,1
"cg13805262",0,1,1,0,2
"cg13805953",0,0,1,0,1
"cg13806031",0,0,1,0,1
"cg13806070",1,0,0,0,1
"cg13807077",0,0,1,0,1
"cg13808036",0,1,0,0,1
"cg13808923",1,1,0,0,2
"cg13809434",0,0,1,0,1
"cg13809490",0,2,3,0,5
"cg13809717",0,0,2,0,2
"cg13810835",0,0,1,0,1
"cg13810843",7,1,0,0,8
"cg13810964",105,6,0,0,111
"cg13812223",0,4,0,0,4
"cg13812570",0,1,0,0,1
"cg13812879",42,1,0,0,43
"cg13813388",0,1,0,0,1
"cg13814843",1,0,0,0,1
"cg13815495",174,195,3,0,372
"cg13815634",1,1,1,0,3
"cg13815864",0,2,0,0,2
"cg13815971",32,11,2,0,45
"cg13816282",0,0,1,0,1
"cg13817353",47,7,0,0,54
"cg13817410",0,0,1,0,1
"cg13818169",2,0,0,0,2
"cg13819659",4,0,0,0,4
"cg13820145",0,0,4,0,4
"cg13820534",1,0,0,0,1
"cg13821227",5,2,0,0,7
"cg13823245",0,0,1,0,1
"cg13823460",0,2,0,0,2
"cg13825112",0,1,0,0,1
"cg13825532",1,0,0,0,1
"cg13826264",0,0,2,0,2
"cg13826718",1,0,0,0,1
"cg13827173",196,1264,37,0,1497
"cg13827498",0,1,3,0,4
"cg13828097",1,1,0,0,2
"cg13828637",3,0,0,0,3
"cg13831141",42,0,0,0,42
"cg13832059",1,0,0,0,1
"cg13832301",18,8,0,0,26
"cg13833527",0,1,0,0,1
"cg13833886",0,0,1,0,1
"cg13835200",0,1,2,0,3
"cg13836687",0,1,0,0,1
"cg13836954",0,2,2,0,4
"cg13838634",0,0,1,0,1
"cg13838843",0,0,1,0,1
"cg13838861",0,1,1,0,2
"cg13839391",0,0,1,0,1
"cg13840590",707,33,1,0,741
"cg13841783",0,4,8,0,12
"cg13843261",0,0,1,0,1
"cg13844662",41,8,0,1,50
"cg13845483",0,0,1,0,1
"cg13845951",87,82,0,0,169
"cg13846682",0,1,0,0,1
"cg13848951",0,1,0,0,1
"cg13848981",11,0,1,0,12
"cg13849007",0,0,1,0,1
"cg13849142",245,32,0,0,277
"cg13849179",1,0,0,0,1
"cg13849727",2,0,0,0,2
"cg13849876",1,0,0,0,1
"cg13850344",4,1,0,0,5
"cg13852065",0,4,0,0,4
"cg13852466",7,2,0,0,9
"cg13854430",1,0,0,0,1
"cg13854651",9,3,0,0,12
"cg13855093",0,1,2,0,3
"cg13855255",0,0,7,0,7
"cg13855276",1,0,0,0,1
"cg13855500",2,0,0,0,2
"cg13855662",33,34,0,0,67
"cg13856086",0,0,1,0,1
"cg13857480",0,0,1,0,1
"cg13858019",4,0,1,0,5
"cg13858139",4,5,3,0,12
"cg13859833",1,0,0,0,1
"cg13860309",309,243,10,0,562
"cg13860493",0,1,0,0,1
"cg13861161",0,0,1,0,1
"cg13861458",0,2,10,0,12
"cg13862265",0,1,0,0,1
"cg13862477",1,0,0,0,1
"cg13862630",2,1,0,0,3
"cg13862633",0,0,1,0,1
"cg13863613",0,2,0,0,2
"cg13864319",0,1,0,0,1
"cg13864379",0,0,2,0,2
"cg13864455",17,30,22,0,69
"cg13865318",0,1,0,0,1
"cg13866156",1,0,0,0,1
"cg13866204",0,0,1,0,1
"cg13867274",16,4,2,0,22
"cg13869635",6,7,0,0,13
"cg13870107",8,0,1,0,9
"cg13870407",3,1,0,0,4
"cg13870510",1,0,3,0,4
"cg13871073",24,10,0,0,34
"cg13871190",0,0,1,0,1
"cg13871799",0,7,10,0,17
"cg13873337",0,1,2,0,3
"cg13873902",202,330,96,0,628
"cg13874379",0,0,1,0,1
"cg13874644",0,0,1,0,1
"cg13875986",116,447,35,0,598
"cg13876071",81,8,1,0,90
"cg13876470",0,0,1,0,1
"cg13876481",1,0,0,0,1
"cg13877005",0,2,5,0,7
"cg13877227",1,0,1,0,2
"cg13877944",146,103,6,0,255
"cg13878745",3,2,0,0,5
"cg13879373",1,1,0,0,2
"cg13879417",2,0,0,0,2
"cg13879996",0,2,0,0,2
"cg13880034",16,16,0,0,32
"cg13880254",21,3,0,0,24
"cg13880303",1,0,0,0,1
"cg13880351",16,0,0,0,16
"cg13880617",1,1,3,0,5
"cg13881006",0,0,1,0,1
"cg13881513",2,0,0,0,2
"cg13882046",2,0,0,0,2
"cg13882899",1,0,0,0,1
"cg13883186",1,0,0,0,1
"cg13883438",1,1,0,0,2
"cg13883743",0,0,3,0,3
"cg13884344",0,1,0,0,1
"cg13884518",0,0,1,0,1
"cg13884608",0,0,1,0,1
"cg13885504",0,2,1,0,3
"cg13885829",2,0,0,0,2
"cg13886600",0,1,0,0,1
"cg13887420",4,0,0,0,4
"cg13887666",0,5,7,0,12
"cg13890735",0,0,1,0,1
"cg13891671",3,2,0,0,5
"cg13891898",1,3,4,0,8
"cg13892659",0,5,6,0,11
"cg13893372",0,0,4,0,4
"cg13893907",0,0,2,0,2
"cg13894827",1,0,0,0,1
"cg13895409",4,0,0,0,4
"cg13896017",0,1,1,0,2
"cg13896113",0,0,1,0,1
"cg13896115",2,0,1,0,3
"cg13897429",0,0,2,0,2
"cg13898157",180,75,9,0,264
"cg13898294",0,0,1,0,1
"cg13899002",0,0,1,0,1
"cg13900008",0,0,1,0,1
"cg13901319",0,0,1,0,1
"cg13902210",0,1,1,0,2
"cg13904130",1,0,0,0,1
"cg13905333",1,0,0,0,1
"cg13906985",28,12,2,0,42
"cg13908244",0,0,1,0,1
"cg13908315",0,0,1,0,1
"cg13909916",0,0,1,0,1
"cg13910117",2,0,0,0,2
"cg13910454",1,0,0,0,1
"cg13910527",0,2,0,0,2
"cg13910830",0,1,0,0,1
"cg13910869",2,0,1,0,3
"cg13910907",7,0,0,0,7
"cg13911828",0,0,2,0,2
"cg13912435",2,1,0,0,3
"cg13912721",4,5,2,0,11
"cg13913130",6,1,1,0,8
"cg13914600",0,1,5,0,6
"cg13915353",1,0,0,0,1
"cg13916500",82,549,61,0,692
"cg13916742",1,0,0,0,1
"cg13918058",0,1,0,0,1
"cg13918223",0,2,0,0,2
"cg13918328",0,2,0,0,2
"cg13918414",3,2,0,0,5
"cg13918472",1,0,1,0,2
"cg13918802",2,0,0,0,2
"cg13919724",0,1,0,0,1
"cg13920446",0,1,7,0,8
"cg13921738",0,0,1,0,1
"cg13922858",0,0,2,0,2
"cg13922921",1,1,0,0,2
"cg13922970",0,1,0,0,1
"cg13925035",0,0,6,1,7
"cg13925569",216,13,0,0,229
"cg13925718",1,1,0,0,2
"cg13926656",1,1,0,0,2
"cg13926788",0,0,1,0,1
"cg13927290",2,0,12,0,14
"cg13927401",2,14,0,0,16
"cg13927803",0,1,0,0,1
"cg13930656",162,213,67,0,442
"cg13930977",1,0,0,0,1
"cg13931323",3,0,0,0,3
"cg13932217",49,2,0,0,51
"cg13932286",40,0,0,0,40
"cg13933023",1,0,0,0,1
"cg13933122",2,0,0,0,2
"cg13934145",5,5,5,0,15
"cg13934941",1,0,0,0,1
"cg13935553",0,1,0,0,1
"cg13935781",0,0,2,0,2
"cg13935876",0,6,1,0,7
"cg13935907",1,0,0,0,1
"cg13936870",1,2,1,0,4
"cg13936968",60,1,0,0,61
"cg13937272",1,0,2,0,3
"cg13937446",0,0,1,0,1
"cg13938143",0,0,1,0,1
"cg13938218",0,0,2,0,2
"cg13939234",0,1,0,0,1
"cg13939291",1,0,1,0,2
"cg13940634",0,0,1,0,1
"cg13940834",0,0,1,0,1
"cg13941826",3,0,0,0,3
"cg13942242",2,1,0,0,3
"cg13942515",9,0,0,0,9
"cg13942590",0,1,0,0,1
"cg13942695",0,3,0,0,3
"cg13943141",0,0,1,0,1
"cg13944198",0,0,1,0,1
"cg13944278",0,0,1,0,1
"cg13944903",0,1,0,0,1
"cg13945383",3,0,0,0,3
"cg13945567",0,0,1,0,1
"cg13946829",1,1,1,0,3
"cg13946959",0,0,2,0,2
"cg13947385",1,0,0,0,1
"cg13947513",403,72,0,0,475
"cg13947675",2,0,0,0,2
"cg13948094",134,9,1,0,144
"cg13948146",0,0,1,0,1
"cg13948696",173,555,10,0,738
"cg13949093",1,0,0,0,1
"cg13949130",0,0,1,0,1
"cg13949132",1,0,4,0,5
"cg13950674",1,1,0,0,2
"cg13951190",78,4,0,0,82
"cg13951490",2,0,1,0,3
"cg13951936",3,0,0,0,3
"cg13953157",757,107,1,0,865
"cg13953403",1,0,0,0,1
"cg13953579",0,0,1,0,1
"cg13953955",1,0,0,0,1
"cg13954435",0,1,0,0,1
"cg13955196",2,1,0,0,3
"cg13955550",0,0,1,0,1
"cg13955647",1,5,2,0,8
"cg13956086",0,0,1,0,1
"cg13957321",0,0,1,0,1
"cg13957681",0,1,0,0,1
"cg13957812",1,1,0,0,2
"cg13959149",0,0,1,0,1
"cg13959393",0,0,0,1,1
"cg13960334",0,1,0,0,1
"cg13960942",1,1,0,0,2
"cg13961165",0,4,0,0,4
"cg13961770",2,3,0,0,5
"cg13962321",0,0,2,0,2
"cg13963221",41,4,0,0,45
"cg13964648",0,1,0,0,1
"cg13965133",2,3,2,0,7
"cg13965201",61,1,0,0,62
"cg13966357",1,0,0,0,1
"cg13966438",1,0,0,0,1
"cg13966710",0,0,1,0,1
"cg13967137",1,0,0,0,1
"cg13967448",3,0,0,0,3
"cg13969146",8,0,0,0,8
"cg13969643",0,1,0,0,1
"cg13970253",2,0,0,0,2
"cg13971096",14,17,0,0,31
"cg13971355",0,0,1,0,1
"cg13971965",0,0,1,0,1
"cg13972720",7,1,0,0,8
"cg13972906",0,1,0,0,1
"cg13973674",38,1,0,0,39
"cg13973861",1,0,0,0,1
"cg13973864",0,1,0,0,1
"cg13973939",73,58,21,0,152
"cg13974317",0,0,2,0,2
"cg13974505",1,0,0,0,1
"cg13974601",2,1,0,0,3
"cg13974790",1,0,0,0,1
"cg13975641",0,0,2,0,2
"cg13975804",0,1,2,1,4
"cg13975827",1,0,0,0,1
"cg13975989",102,4,0,0,106
"cg13976703",1,0,0,0,1
"cg13976948",0,1,0,0,1
"cg13977169",0,0,1,0,1
"cg13977632",0,1,20,0,21
"cg13977790",1,0,0,0,1
"cg13978929",1,1,0,0,2
"cg13978991",371,11,1,0,383
"cg13979194",167,16,0,0,183
"cg13979266",0,1,1,0,2
"cg13980238",28,8,0,0,36
"cg13980759",1,0,0,0,1
"cg13981287",4,4,0,0,8
"cg13982436",0,0,1,0,1
"cg13982546",0,0,1,0,1
"cg13982739",0,0,1,0,1
"cg13983122",1,3,1,0,5
"cg13983551",1,0,0,0,1
"cg13983595",0,1,0,0,1
"cg13983776",2,3,2,0,7
"cg13983815",0,1,1,0,2
"cg13983912",8,7,4,1,20
"cg13983922",8,10,3,0,21
"cg13984074",10,0,0,0,10
"cg13984200",2,1,1,0,4
"cg13984330",2,0,0,0,2
"cg13984810",0,0,2,0,2
"cg13984931",0,1,0,0,1
"cg13984997",0,0,1,0,1
"cg13985271",147,5,0,0,152
"cg13986720",0,1,0,0,1
"cg13987062",23,8,0,0,31
"cg13987078",2,0,1,0,3
"cg13987334",362,245,3,0,610
"cg13987686",2,0,0,0,2
"cg13987825",4,3,1,0,8
"cg13989981",168,76,9,0,253
"cg13990806",3,0,0,0,3
"cg13992756",1,0,0,0,1
"cg13993023",2,0,0,0,2
"cg13994730",0,1,0,0,1
"cg13996144",0,0,1,0,1
"cg13996786",101,12,0,0,113
"cg13997013",0,1,0,0,1
"cg13997150",29,19,3,0,51
"cg13997268",51,5,0,0,56
"cg13998252",0,0,1,0,1
"cg13999664",0,2,1,0,3
"cg13999774",1,0,0,0,1
"cg14000226",0,1,0,0,1
"cg14001664",0,0,1,0,1
"cg14001748",1,1,0,0,2
"cg14003328",1,5,0,0,6
"cg14003780",0,1,0,0,1
"cg14004983",39,0,0,0,39
"cg14007077",1,0,0,0,1
"cg14007638",8,0,0,0,8
"cg14008030",0,3,5,0,8
"cg14008106",0,1,0,0,1
"cg14008164",1,1,1,0,3
"cg14008346",3,2,1,0,6
"cg14008524",0,1,0,0,1
"cg14008862",0,0,1,0,1
"cg14009640",0,0,2,0,2
"cg14009759",6,2,0,0,8
"cg14011387",2,1,0,0,3
"cg14011987",8,2,1,0,11
"cg14012014",1,0,1,0,2
"cg14012082",1,0,0,0,1
"cg14012564",10,13,0,0,23
"cg14012940",0,1,0,0,1
"cg14013161",160,53,0,0,213
"cg14013955",1,0,0,0,1
"cg14015226",2,0,0,0,2
"cg14017036",10,0,0,0,10
"cg14018263",6,0,0,0,6
"cg14018412",1,4,0,0,5
"cg14018420",3,2,0,0,5
"cg14018698",0,0,1,0,1
"cg14019525",0,1,0,0,1
"cg14019607",0,0,1,0,1
"cg14021554",2,1,0,0,3
"cg14021929",0,0,1,0,1
"cg14022873",123,14,0,0,137
"cg14023357",0,0,1,0,1
"cg14024286",0,0,1,0,1
"cg14024461",5,1,0,0,6
"cg14026101",0,0,0,1,1
"cg14027685",543,204,2,0,749
"cg14027907",1,0,0,0,1
"cg14028515",0,1,0,0,1
"cg14029077",1,7,4,0,12
"cg14030025",0,0,1,0,1
"cg14031265",2,0,0,0,2
"cg14032742",29,1,0,0,30
"cg14033253",0,0,1,0,1
"cg14033385",0,0,0,1,1
"cg14033737",215,15,0,0,230
"cg14033946",6,1,0,0,7
"cg14033993",2,1,0,0,3
"cg14035019",0,0,1,0,1
"cg14035455",1,0,0,0,1
"cg14035787",1,0,1,0,2
"cg14036097",0,1,3,1,5
"cg14036144",2,2,0,0,4
"cg14036420",1,0,0,0,1
"cg14038878",1,0,0,0,1
"cg14039479",0,1,0,0,1
"cg14041391",1,0,0,0,1
"cg14041686",0,0,3,0,3
"cg14041793",5,7,1,30,43
"cg14042230",0,0,1,0,1
"cg14042241",1,0,0,0,1
"cg14042936",0,0,1,0,1
"cg14043737",0,0,1,0,1
"cg14044110",0,0,1,0,1
"cg14044844",0,0,1,0,1
"cg14044987",0,0,1,0,1
"cg14045450",7,3,6,0,16
"cg14045509",2,0,0,0,2
"cg14046098",805,372,8,0,1185
"cg14046892",8,7,2,0,17
"cg14047321",0,1,0,0,1
"cg14048599",130,48,1,0,179
"cg14048785",21,0,0,0,21
"cg14049008",1,1,0,1,3
"cg14050152",2,1,0,0,3
"cg14050456",2,1,0,0,3
"cg14050972",0,1,0,0,1
"cg14051202",314,176,29,0,519
"cg14052593",0,2,0,0,2
"cg14052945",0,0,1,0,1
"cg14053639",0,1,3,0,4
"cg14053701",7,1,0,0,8
"cg14053842",2,0,0,0,2
"cg14054208",0,1,0,0,1
"cg14054292",2,0,0,0,2
"cg14054509",31,2,0,0,33
"cg14054990",0,1,0,0,1
"cg14057273",0,1,0,0,1
"cg14057352",221,108,7,0,336
"cg14057946",1,1,2,0,4
"cg14058584",0,0,1,0,1
"cg14058869",1,0,0,0,1
"cg14059163",0,0,1,0,1
"cg14059735",75,5,0,0,80
"cg14059817",0,0,1,0,1
"cg14060132",0,0,1,0,1
"cg14060471",0,0,1,0,1
"cg14061793",0,0,1,0,1
"cg14061886",0,0,1,0,1
"cg14063945",0,1,0,0,1
"cg14065784",1,1,0,0,2
"cg14066935",0,1,0,0,1
"cg14067716",0,1,0,0,1
"cg14068657",1,0,0,0,1
"cg14068872",0,0,1,0,1
"cg14069736",1,0,0,0,1
"cg14069835",2,0,0,0,2
"cg14069921",0,1,0,0,1
"cg14070039",0,0,1,0,1
"cg14071171",0,2,0,0,2
"cg14071186",15,1,0,0,16
"cg14071799",16,3,0,0,19
"cg14072046",0,0,1,0,1
"cg14072410",3,0,0,0,3
"cg14073033",0,0,1,0,1
"cg14074432",0,1,0,0,1
"cg14075214",0,1,0,0,1
"cg14075454",0,0,1,0,1
"cg14076024",3,0,0,0,3
"cg14076161",0,1,0,0,1
"cg14076963",2,0,0,0,2
"cg14077990",43,92,51,0,186
"cg14078377",2,0,0,0,2
"cg14078613",21,2,0,0,23
"cg14078678",1,0,0,0,1
"cg14079473",3,1,0,0,4
"cg14079705",24,35,3,0,62
"cg14080093",14,34,0,0,48
"cg14080696",0,0,1,0,1
"cg14080881",344,8,0,0,352
"cg14081974",0,0,8,0,8
"cg14082694",0,1,0,0,1
"cg14082931",1,0,0,0,1
"cg14082938",543,50,0,0,593
"cg14083525",0,0,1,0,1
"cg14083593",0,1,0,0,1
"cg14084211",28,28,2,0,58
"cg14085247",7,0,0,0,7
"cg14085757",0,0,1,0,1
"cg14085866",1,0,2,0,3
"cg14086753",667,339,13,0,1019
"cg14087061",0,0,1,0,1
"cg14087181",1,0,0,0,1
"cg14087457",0,0,1,0,1
"cg14088669",1,0,0,0,1
"cg14089007",26,1,0,0,27
"cg14089287",0,1,0,0,1
"cg14089603",28,2,1,0,31
"cg14089945",199,34,1,0,234
"cg14090142",0,0,1,0,1
"cg14090510",1,0,1,0,2
"cg14090926",1,0,1,0,2
"cg14092853",13,14,16,1,44
"cg14093141",0,0,1,0,1
"cg14093970",0,0,12,0,12
"cg14094460",0,1,0,0,1
"cg14094693",0,0,1,0,1
"cg14095100",0,0,1,0,1
"cg14097111",21,3,1,0,25
"cg14097499",0,0,1,0,1
"cg14097619",3,0,0,0,3
"cg14099772",2,1,0,0,3
"cg14100214",1,0,0,0,1
"cg14100357",0,0,1,0,1
"cg14100977",0,1,0,0,1
"cg14101299",1,0,2,0,3
"cg14102005",3,0,0,0,3
"cg14102569",298,111,1,0,410
"cg14102731",0,2,0,0,2
"cg14102753",0,1,0,0,1
"cg14103670",0,2,0,0,2
"cg14104088",3,0,0,0,3
"cg14105224",12,8,0,0,20
"cg14105943",0,1,0,0,1
"cg14106584",0,0,5,0,5
"cg14107456",1,0,0,0,1
"cg14108532",0,3,0,0,3
"cg14108711",0,1,0,0,1
"cg14108922",0,2,1,0,3
"cg14109777",0,1,0,0,1
"cg14110030",22,23,7,0,52
"cg14110168",110,4,0,0,114
"cg14111522",3,0,0,0,3
"cg14112449",1,5,3,0,9
"cg14113203",1,0,0,0,1
"cg14113486",0,1,4,0,5
"cg14113960",0,0,2,0,2
"cg14114962",0,3,2,0,5
"cg14115249",45,4,0,0,49
"cg14115431",1,0,0,0,1
"cg14115740",0,1,0,0,1
"cg14115771",1,3,0,0,4
"cg14116056",0,1,0,0,1
"cg14116725",1,0,1,0,2
"cg14118539",1,0,0,0,1
"cg14118679",7,5,0,0,12
"cg14120325",1,0,0,0,1
"cg14121344",1,0,0,0,1
"cg14121835",1,3,4,0,8
"cg14123135",1,0,0,0,1
"cg14124481",1,0,1,0,2
"cg14125403",2,3,1,0,6
"cg14127641",15,3,0,0,18
"cg14128369",2,0,3,0,5
"cg14128415",1,0,0,0,1
"cg14128419",0,1,0,0,1
"cg14128773",3,0,0,0,3
"cg14128805",1,3,4,0,8
"cg14129714",673,118,6,0,797
"cg14130141",1,2,1,0,4
"cg14131834",1,1,1,0,3
"cg14133108",0,2,0,0,2
"cg14133320",68,38,8,0,114
"cg14133541",3,1,0,0,4
"cg14133619",0,2,1,0,3
"cg14133643",0,1,0,0,1
"cg14134757",0,1,0,0,1
"cg14135084",0,1,0,0,1
"cg14135146",1,0,0,0,1
"cg14136374",0,0,2,0,2
"cg14138115",1,0,0,0,1
"cg14138238",0,0,1,0,1
"cg14138610",100,43,2,0,145
"cg14139008",7,0,0,0,7
"cg14139905",0,0,1,0,1
"cg14140403",1,0,0,0,1
"cg14140483",6,1,0,0,7
"cg14141068",3,5,8,0,16
"cg14141877",0,6,1,0,7
"cg14142186",0,0,1,0,1
"cg14142256",147,68,90,0,305
"cg14142520",1,0,0,0,1
"cg14143323",19,3,0,0,22
"cg14144294",0,1,1,0,2
"cg14144564",1,0,0,0,1
"cg14145016",2,1,0,0,3
"cg14145334",0,1,0,0,1
"cg14145991",3,5,0,0,8
"cg14146711",0,1,0,0,1
"cg14147903",12,9,1,0,22
"cg14149107",1,0,0,0,1
"cg14149337",15,1,0,0,16
"cg14149685",0,0,1,0,1
"cg14150543",3,3,0,0,6
"cg14150708",5,4,0,0,9
"cg14150743",0,0,1,0,1
"cg14151995",0,0,1,0,1
"cg14152798",0,1,0,0,1
"cg14152806",1,0,0,0,1
"cg14153557",0,1,0,0,1
"cg14153625",217,98,5,0,320
"cg14153650",54,0,0,0,54
"cg14154330",1,1,0,0,2
"cg14155976",0,1,0,0,1
"cg14156148",2,0,3,0,5
"cg14156314",0,1,0,0,1
"cg14156905",0,1,2,0,3
"cg14157066",9,2,1,0,12
"cg14157348",3,0,0,0,3
"cg14157917",1,0,0,0,1
"cg14159849",419,117,1,0,537
"cg14160317",1,0,0,0,1
"cg14160518",1,0,0,0,1
"cg14161094",1,0,0,0,1
"cg14161885",0,0,1,0,1
"cg14162457",0,1,0,0,1
"cg14163083",1,0,4,0,5
"cg14163462",726,25,0,0,751
"cg14164244",0,1,0,0,1
"cg14164956",0,0,1,0,1
"cg14165168",0,0,1,0,1
"cg14165692",0,2,0,0,2
"cg14165841",0,0,1,0,1
"cg14166209",0,0,1,0,1
"cg14166735",1,0,0,0,1
"cg14168573",0,0,1,0,1
"cg14168996",20,0,0,0,20
"cg14170437",0,0,1,0,1
"cg14170609",16,25,6,0,47
"cg14171109",0,1,0,0,1
"cg14172283",0,0,1,0,1
"cg14172454",0,0,1,0,1
"cg14173330",2,1,0,0,3
"cg14174335",1,0,1,0,2
"cg14174526",0,1,2,0,3
"cg14175897",0,0,8,0,8
"cg14175987",1,0,0,0,1
"cg14176261",0,0,1,0,1
"cg14177917",0,0,1,0,1
"cg14178343",1,0,0,0,1
"cg14178937",79,445,21,0,545
"cg14179220",0,1,0,0,1
"cg14180039",21,4,0,0,25
"cg14180138",0,1,3,0,4
"cg14180343",1,0,0,0,1
"cg14180681",1,0,0,0,1
"cg14181116",0,1,0,0,1
"cg14182819",0,1,0,0,1
"cg14183012",7,0,0,0,7
"cg14183176",106,534,54,0,694
"cg14183206",3,2,0,0,5
"cg14184693",0,1,0,0,1
"cg14185323",82,33,1,0,116
"cg14185341",0,0,1,0,1
"cg14185463",0,0,1,0,1
"cg14185604",1,6,1,0,8
"cg14186481",0,0,3,0,3
"cg14186697",0,0,1,0,1
"cg14187219",0,1,0,0,1
"cg14188831",1,0,0,0,1
"cg14189411",1,0,0,0,1
"cg14189430",0,1,0,0,1
"cg14189605",0,1,0,0,1
"cg14190159",6,0,0,0,6
"cg14190817",0,0,1,0,1
"cg14190889",0,1,0,0,1
"cg14191953",3,0,2,0,5
"cg14192099",0,2,0,0,2
"cg14192430",0,1,0,0,1
"cg14192782",0,2,0,2,4
"cg14192858",1,0,0,0,1
"cg14193561",0,1,0,0,1
"cg14193806",0,0,1,0,1
"cg14195016",2,3,2,0,7
"cg14195606",334,68,4,0,406
"cg14196676",2,0,1,0,3
"cg14197788",2,3,1,0,6
"cg14198018",13,22,0,0,35
"cg14198291",0,0,1,0,1
"cg14199837",6,2,0,0,8
"cg14199961",2,1,3,0,6
"cg14200178",0,2,2,0,4
"cg14200357",2,0,0,0,2
"cg14201303",0,0,2,0,2
"cg14202034",1,2,0,0,3
"cg14204395",0,2,1,0,3
"cg14206365",0,0,4,0,4
"cg14206479",0,0,1,0,1
"cg14207199",6,0,0,0,6
"cg14207222",357,11,0,0,368
"cg14207799",0,3,0,0,3
"cg14208052",1,0,0,0,1
"cg14208150",0,0,1,0,1
"cg14209133",2,4,3,0,9
"cg14209317",11,1,0,0,12
"cg14209372",0,1,0,0,1
"cg14209957",0,0,3,0,3
"cg14209988",2,5,0,0,7
"cg14210236",0,0,1,0,1
"cg14210337",1,0,0,0,1
"cg14211015",0,0,2,0,2
"cg14211410",2,1,8,0,11
"cg14211983",112,5,0,0,117
"cg14212801",10,2,0,0,12
"cg14212852",49,43,19,0,111
"cg14213253",0,0,0,1,1
"cg14213424",0,2,0,0,2
"cg14214384",1,3,1,0,5
"cg14214739",0,1,0,0,1
"cg14215153",69,37,1,0,107
"cg14215369",2,0,0,0,2
"cg14217211",8,2,1,0,11
"cg14217261",0,0,2,0,2
"cg14218089",396,93,12,0,501
"cg14219019",0,0,2,0,2
"cg14220138",5,3,0,0,8
"cg14220427",8,0,0,0,8
"cg14220537",0,0,1,0,1
"cg14221404",0,0,1,0,1
"cg14221770",0,0,2,0,2
"cg14221970",17,8,4,0,29
"cg14222797",0,0,1,0,1
"cg14222964",22,5,0,0,27
"cg14223017",1,0,0,0,1
"cg14223395",0,2,0,0,2
"cg14223585",1,1,0,0,2
"cg14223618",0,0,2,0,2
"cg14223909",1,1,1,0,3
"cg14226655",3,3,0,0,6
"cg14227125",3,0,0,0,3
"cg14227566",9,0,0,0,9
"cg14227762",0,1,0,0,1
"cg14227999",7,1,0,0,8
"cg14229256",0,0,1,0,1
"cg14230071",1,0,0,0,1
"cg14230186",2,0,1,0,3
"cg14230810",0,0,1,0,1
"cg14230992",180,152,53,0,385
"cg14234848",374,96,10,0,480
"cg14235030",0,1,0,0,1
"cg14235129",0,0,1,0,1
"cg14235568",0,1,0,0,1
"cg14236079",0,0,1,0,1
"cg14237550",0,0,1,0,1
"cg14238019",2,1,0,0,3
"cg14238120",1,0,0,0,1
"cg14238625",1,0,0,0,1
"cg14238789",2,0,0,0,2
"cg14239169",10,0,0,0,10
"cg14239732",0,1,0,0,1
"cg14240569",1,0,0,0,1
"cg14240735",0,1,1,0,2
"cg14242777",1,4,0,0,5
"cg14244242",3,1,0,0,4
"cg14244963",1,0,0,0,1
"cg14245347",0,0,1,0,1
"cg14245613",2,0,0,0,2
"cg14245791",0,0,1,0,1
"cg14246539",1,1,0,0,2
"cg14248084",0,1,0,0,1
"cg14248553",1,0,0,0,1
"cg14248690",0,0,1,0,1
"cg14250891",0,0,1,0,1
"cg14251327",0,0,1,0,1
"cg14251405",0,0,5,0,5
"cg14251512",46,13,0,0,59
"cg14252602",1,2,0,0,3
"cg14253896",54,43,0,0,97
"cg14255448",1,0,1,0,2
"cg14255700",0,0,1,0,1
"cg14256068",133,213,5,0,351
"cg14256094",2,0,0,0,2
"cg14256840",0,1,0,0,1
"cg14257383",0,0,1,0,1
"cg14257543",1,0,1,0,2
"cg14258312",1,0,0,0,1
"cg14258645",1,0,0,0,1
"cg14258917",5,0,0,0,5
"cg14258980",4,2,0,0,6
"cg14260377",0,0,4,0,4
"cg14260458",0,1,0,0,1
"cg14261401",0,1,0,0,1
"cg14261542",0,0,1,0,1
"cg14261785",0,1,0,0,1
"cg14262056",1,1,0,0,2
"cg14262374",1,0,0,0,1
"cg14263171",3,0,0,0,3
"cg14264159",0,1,0,0,1
"cg14264641",1,0,0,0,1
"cg14264793",2,0,0,0,2
"cg14265180",135,17,1,0,153
"cg14265604",0,1,0,0,1
"cg14265936",0,6,2,0,8
"cg14266452",0,11,10,0,21
"cg14266586",233,85,8,0,326
"cg14266837",0,0,2,0,2
"cg14267020",1,0,0,0,1
"cg14267551",2,4,2,0,8
"cg14268019",0,1,3,0,4
"cg14268143",21,13,0,0,34
"cg14268223",1,0,0,0,1
"cg14268436",24,38,8,0,70
"cg14268873",1,0,0,0,1
"cg14270331",5,8,3,0,16
"cg14272009",1,0,0,0,1
"cg14272381",1,1,0,0,2
"cg14272794",8,5,0,0,13
"cg14273883",0,0,5,0,5
"cg14274005",0,0,1,0,1
"cg14274798",1,0,0,0,1
"cg14276083",0,0,1,0,1
"cg14276258",3,0,0,0,3
"cg14277543",33,5,0,0,38
"cg14277764",0,0,2,0,2
"cg14279186",0,1,2,2,5
"cg14279591",0,1,0,0,1
"cg14279792",9,4,0,0,13
"cg14279898",0,1,2,0,3
"cg14280098",0,0,1,0,1
"cg14280569",0,5,0,0,5
"cg14281376",1,0,0,0,1
"cg14281915",0,0,2,0,2
"cg14282170",0,0,2,0,2
"cg14283306",1,0,1,0,2
"cg14283475",12,4,0,0,16
"cg14283756",2,0,0,0,2
"cg14284805",0,1,0,0,1
"cg14287890",3,4,2,0,9
"cg14287951",396,8,0,0,404
"cg14289467",2,0,0,0,2
"cg14289621",8,10,1,0,19
"cg14289956",1,0,0,0,1
"cg14290291",1,0,0,0,1
"cg14290363",10,1,3,0,14
"cg14290590",2,0,0,0,2
"cg14291222",1,0,0,0,1
"cg14291278",16,2,3,0,21
"cg14291677",0,0,1,0,1
"cg14293633",0,1,0,0,1
"cg14293776",0,0,1,0,1
"cg14293898",0,0,1,0,1
"cg14294115",3,1,0,0,4
"cg14294671",0,1,0,0,1
"cg14295151",0,1,0,0,1
"cg14296767",1,0,0,0,1
"cg14297066",5,0,0,0,5
"cg14297546",3,0,0,0,3
"cg14298792",0,0,3,0,3
"cg14298830",1,0,0,0,1
"cg14299369",1,0,0,0,1
"cg14299539",3,1,0,0,4
"cg14299696",3,0,0,0,3
"cg14300418",0,0,1,0,1
"cg14301118",0,0,1,0,1
"cg14302969",6,12,1,0,19
"cg14304738",0,0,15,0,15
"cg14305657",221,139,23,0,383
"cg14307134",0,0,1,0,1
"cg14307895",2,0,0,0,2
"cg14308265",0,2,0,0,2
"cg14308624",23,8,0,0,31
"cg14308831",1,0,0,0,1
"cg14309691",2,0,0,0,2
"cg14311116",0,0,3,0,3
"cg14311187",8,0,0,0,8
"cg14311225",881,179,6,0,1066
"cg14312893",5,2,4,0,11
"cg14313275",0,1,0,0,1
"cg14313350",1,0,0,0,1
"cg14313398",17,12,3,0,32
"cg14313789",1,0,0,0,1
"cg14313916",2,1,0,0,3
"cg14314026",0,1,0,0,1
"cg14314324",3,3,1,0,7
"cg14315332",2,0,2,0,4
"cg14316117",20,12,0,0,32
"cg14316583",0,1,0,0,1
"cg14316660",0,1,3,0,4
"cg14316668",2,0,0,0,2
"cg14317457",12,10,4,0,26
"cg14319700",52,20,2,0,74
"cg14319849",2,0,0,0,2
"cg14319934",39,4,0,0,43
"cg14321038",2,2,0,0,4
"cg14322233",23,36,0,0,59
"cg14322746",9,0,0,0,9
"cg14324749",1,0,0,0,1
"cg14325184",1,0,5,0,6
"cg14327068",1,0,0,0,1
"cg14327235",0,1,0,0,1
"cg14328093",0,0,8,0,8
"cg14328497",4,1,3,0,8
"cg14328920",1,0,0,0,1
"cg14330022",0,0,6,0,6
"cg14330675",1,0,0,0,1
"cg14331875",0,3,2,0,5
"cg14332376",1,0,0,0,1
"cg14332824",3,2,7,0,12
"cg14333403",13,0,0,0,13
"cg14333483",10,0,0,0,10
"cg14334109",2,0,0,0,2
"cg14334147",16,1,0,0,17
"cg14334810",0,1,0,0,1
"cg14334878",1,0,0,0,1
"cg14336033",1,2,4,0,7
"cg14336674",4,1,0,0,5
"cg14337036",1,0,0,0,1
"cg14338160",0,0,1,0,1
"cg14338551",19,26,0,0,45
"cg14339048",0,6,19,0,25
"cg14340840",2,0,0,0,2
"cg14341057",2,1,1,0,4
"cg14343924",0,1,0,0,1
"cg14344864",0,0,1,0,1
"cg14345215",168,68,0,0,236
"cg14346048",0,0,1,0,1
"cg14346555",5,2,0,0,7
"cg14347328",110,14,0,0,124
"cg14347516",32,0,0,0,32
"cg14347999",1,0,0,0,1
"cg14348252",0,0,1,0,1
"cg14348441",91,3,0,0,94
"cg14348849",0,0,1,0,1
"cg14349378",0,2,0,0,2
"cg14349843",0,1,0,0,1
"cg14349871",11,3,0,0,14
"cg14350294",1,0,0,0,1
"cg14351451",0,3,1,0,4
"cg14352009",5,1,0,0,6
"cg14352021",2,0,0,0,2
"cg14352208",0,0,1,0,1
"cg14352508",24,7,0,0,31
"cg14353001",2,0,0,0,2
"cg14353853",3,1,0,0,4
"cg14355069",5,0,0,0,5
"cg14356187",3,14,3,0,20
"cg14356272",0,1,0,0,1
"cg14356870",1,0,0,0,1
"cg14357455",0,0,1,0,1
"cg14357676",1,1,1,0,3
"cg14358474",13,8,2,0,23
"cg14359591",0,0,1,0,1
"cg14359800",1,0,0,0,1
"cg14359804",6,14,1,0,21
"cg14360421",13,1,0,0,14
"cg14361883",0,1,0,0,1
"cg14362416",215,162,1,0,378
"cg14362697",1,0,0,0,1
"cg14362791",0,0,1,0,1
"cg14363174",0,0,1,0,1
"cg14364255",0,0,1,0,1
"cg14365153",3,0,0,0,3
"cg14366983",0,0,1,0,1
"cg14367829",0,2,0,0,2
"cg14368656",1,2,1,0,4
"cg14368691",1,0,0,0,1
"cg14369648",1,0,0,0,1
"cg14370072",0,9,11,0,20
"cg14372177",12,1,2,0,15
"cg14372255",0,1,0,0,1
"cg14372265",0,0,1,0,1
"cg14373718",198,300,44,0,542
"cg14375543",1,0,0,0,1
"cg14375944",16,0,0,0,16
"cg14377342",5,2,0,0,7
"cg14377568",0,3,1,0,4
"cg14377693",17,23,1,0,41
"cg14378364",4,0,0,0,4
"cg14378743",0,0,1,0,1
"cg14378860",0,1,0,0,1
"cg14379865",0,1,0,0,1
"cg14380045",3,0,0,0,3
"cg14380061",4,26,4,0,34
"cg14381313",0,0,1,0,1
"cg14381371",1,0,0,0,1
"cg14381540",1,0,0,0,1
"cg14381568",0,1,0,0,1
"cg14382564",17,5,0,0,22
"cg14382923",1,0,0,0,1
"cg14383710",0,0,1,0,1
"cg14384823",6,5,0,0,11
"cg14384940",1,1,1,0,3
"cg14385804",1,0,0,0,1
"cg14386548",96,2,0,0,98
"cg14386806",0,5,1,0,6
"cg14387005",1,0,0,0,1
"cg14387414",0,0,1,0,1
"cg14387634",0,0,5,0,5
"cg14388629",0,0,1,0,1
"cg14388724",1,0,1,0,2
"cg14390143",3,0,1,0,4
"cg14390764",1,0,0,0,1
"cg14390884",29,2,0,0,31
"cg14391023",192,373,29,0,594
"cg14392163",4,1,0,0,5
"cg14392755",0,0,1,0,1
"cg14393609",0,0,1,0,1
"cg14393649",0,0,14,0,14
"cg14394011",45,5,0,0,50
"cg14394692",0,0,1,0,1
"cg14395520",0,2,0,0,2
"cg14397205",16,0,0,0,16
"cg14397416",0,4,0,0,4
"cg14397901",0,1,0,0,1
"cg14398295",0,1,0,0,1
"cg14398449",0,0,2,0,2
"cg14399784",3,0,0,0,3
"cg14400090",1,1,0,0,2
"cg14400179",691,42,1,0,734
"cg14400763",0,0,1,0,1
"cg14400821",6,0,1,0,7
"cg14403099",0,0,2,0,2
"cg14403516",2,0,0,0,2
"cg14403583",2,10,2,0,14
"cg14404146",403,172,11,0,586
"cg14405343",0,1,0,0,1
"cg14405553",0,0,1,0,1
"cg14405773",0,0,1,0,1
"cg14406224",0,0,4,0,4
"cg14406256",0,0,1,0,1
"cg14407179",0,0,1,0,1
"cg14407184",820,114,0,0,934
"cg14407666",0,1,0,0,1
"cg14407883",1,0,0,0,1
"cg14408679",3,3,1,0,7
"cg14409823",0,1,0,0,1
"cg14410148",3,1,0,0,4
"cg14410306",3,0,1,0,4
"cg14411046",2,1,1,0,4
"cg14411347",0,0,2,0,2
"cg14411612",1,0,0,0,1
"cg14412369",1,0,0,0,1
"cg14412831",7,1,0,0,8
"cg14413526",0,1,0,0,1
"cg14415800",0,2,3,0,5
"cg14415959",0,1,0,0,1
"cg14416014",0,0,1,0,1
"cg14416547",0,0,0,1,1
"cg14417458",334,203,27,0,564
"cg14417662",1,0,0,0,1
"cg14418808",0,0,0,1,1
"cg14419051",2,0,0,0,2
"cg14419674",1,1,3,0,5
"cg14419869",1,0,0,0,1
"cg14422322",67,36,3,0,106
"cg14422496",1,0,0,0,1
"cg14424582",0,1,1,0,2
"cg14424737",1,0,0,0,1
"cg14427437",0,1,0,0,1
"cg14427809",1,0,0,0,1
"cg14429426",0,1,0,0,1
"cg14430410",202,314,31,0,547
"cg14431791",0,0,2,0,2
"cg14432454",1,0,1,0,2
"cg14432665",0,1,0,0,1
"cg14432716",1,0,0,0,1
"cg14433248",247,308,8,0,563
"cg14433251",1,0,0,0,1
"cg14434632",0,1,1,0,2
"cg14435059",0,1,1,0,2
"cg14435275",1,0,0,0,1
"cg14435659",13,1,0,0,14
"cg14436491",0,1,3,0,4
"cg14436792",0,1,2,0,3
"cg14437002",0,0,4,0,4
"cg14437448",6,0,0,0,6
"cg14437797",0,1,0,0,1
"cg14438695",0,0,1,0,1
"cg14439119",1,1,0,0,2
"cg14442015",0,2,1,0,3
"cg14442769",4,0,0,0,4
"cg14443230",1,0,0,0,1
"cg14443396",1,0,1,0,2
"cg14443467",3,1,0,0,4
"cg14443664",20,4,0,0,24
"cg14444562",0,0,1,0,1
"cg14445229",0,0,1,0,1
"cg14445341",0,1,0,0,1
"cg14445851",0,0,2,0,2
"cg14447733",12,16,0,0,28
"cg14448091",0,2,0,0,2
"cg14448248",2,5,0,0,7
"cg14448451",7,7,6,0,20
"cg14449317",9,0,0,0,9
"cg14449633",3,1,0,0,4
"cg14450620",1,0,0,0,1
"cg14450725",0,1,0,0,1
"cg14452204",2,0,0,0,2
"cg14452549",1,0,0,0,1
"cg14453012",0,1,0,0,1
"cg14453751",0,0,1,0,1
"cg14455170",1,0,0,0,1
"cg14455613",0,4,7,0,11
"cg14456396",207,196,43,0,446
"cg14457499",0,2,0,0,2
"cg14457725",7,58,2,0,67
"cg14457998",10,2,0,0,12
"cg14458654",0,1,0,0,1
"cg14460663",1,0,0,0,1
"cg14460758",0,0,1,0,1
"cg14460847",0,0,2,0,2
"cg14461571",1,6,1,0,8
"cg14463346",0,1,2,0,3
"cg14464802",1,0,0,0,1
"cg14464893",3,0,0,0,3
"cg14465410",7,0,0,0,7
"cg14465801",2,0,0,0,2
"cg14467015",7,1,0,0,8
"cg14467354",0,0,2,0,2
"cg14467738",0,0,0,1,1
"cg14468646",0,1,0,0,1
"cg14469008",0,0,1,0,1
"cg14469191",0,3,0,0,3
"cg14469280",0,0,1,0,1
"cg14469422",0,0,1,0,1
"cg14469728",0,1,0,0,1
"cg14470104",0,0,1,0,1
"cg14470762",13,0,0,0,13
"cg14471054",7,2,0,0,9
"cg14471124",0,9,1,0,10
"cg14471455",0,0,1,0,1
"cg14471799",4,0,0,0,4
"cg14472328",1,1,2,0,4
"cg14472680",0,1,0,0,1
"cg14474302",0,2,0,0,2
"cg14474387",0,0,1,0,1
"cg14475036",1,0,0,0,1
"cg14475947",1,2,1,0,4
"cg14476300",0,1,0,0,1
"cg14476948",0,1,0,0,1
"cg14477673",0,0,1,0,1
"cg14478194",115,14,0,0,129
"cg14478316",0,1,0,0,1
"cg14479329",0,1,0,0,1
"cg14480943",134,374,5,0,513
"cg14481079",2,1,2,0,5
"cg14481384",11,6,0,0,17
"cg14482455",0,0,6,0,6
"cg14482952",22,4,0,0,26
"cg14483033",0,1,0,0,1
"cg14486291",18,3,0,0,21
"cg14486794",0,0,1,0,1
"cg14487798",102,112,2,0,216
"cg14487855",2,3,5,0,10
"cg14488913",0,0,1,0,1
"cg14488974",0,0,1,0,1
"cg14490735",0,0,4,0,4
"cg14491776",0,0,1,0,1
"cg14492530",1,2,13,0,16
"cg14493055",3,2,1,0,6
"cg14493440",4,2,0,0,6
"cg14495458",1,0,0,0,1
"cg14495732",1,0,0,0,1
"cg14496048",0,0,1,0,1
"cg14496423",1,0,0,0,1
"cg14497172",0,0,2,0,2
"cg14498455",0,0,1,0,1
"cg14499426",1,1,0,0,2
"cg14500050",3,13,2,0,18
"cg14500258",0,0,1,0,1
"cg14500389",16,0,0,0,16
"cg14502651",0,1,0,0,1
"cg14502726",443,55,2,0,500
"cg14502901",0,2,0,0,2
"cg14503024",0,0,1,0,1
"cg14503272",0,1,0,0,1
"cg14503521",2,2,3,0,7
"cg14503844",1,0,0,0,1
"cg14503987",0,0,3,0,3
"cg14504298",1,0,0,0,1
"cg14505256",1,1,0,0,2
"cg14505434",0,0,2,0,2
"cg14505585",0,0,1,0,1
"cg14505667",15,0,0,0,15
"cg14506646",0,1,0,0,1
"cg14506722",1,0,0,0,1
"cg14506888",5,0,0,0,5
"cg14508306",0,1,0,0,1
"cg14508911",0,1,0,0,1
"cg14510638",8,12,1,0,21
"cg14511068",1,0,0,0,1
"cg14511089",611,43,0,0,654
"cg14511322",0,1,0,0,1
"cg14511665",0,0,1,0,1
"cg14512217",0,0,1,0,1
"cg14512309",0,0,1,0,1
"cg14513059",2,0,0,0,2
"cg14513298",19,1,0,0,20
"cg14514393",2,0,1,0,3
"cg14514703",36,1,0,0,37
"cg14514813",2,6,1,0,9
"cg14515078",1,0,4,0,5
"cg14515254",0,0,4,0,4
"cg14516156",0,2,0,0,2
"cg14516632",4,1,0,0,5
"cg14516690",7,1,0,0,8
"cg14516793",0,0,1,0,1
"cg14517073",0,2,1,0,3
"cg14517323",1,1,0,0,2
"cg14517340",0,2,0,0,2
"cg14517756",0,1,0,0,1
"cg14517863",0,1,1,0,2
"cg14517917",1,0,0,0,1
"cg14518803",0,1,0,0,1
"cg14519534",1,0,0,0,1
"cg14519695",0,2,0,0,2
"cg14519880",6,0,0,0,6
"cg14519963",14,0,0,0,14
"cg14520014",1,0,0,0,1
"cg14520079",0,1,0,0,1
"cg14520135",0,1,0,0,1
"cg14520573",0,0,1,0,1
"cg14520944",1,1,1,0,3
"cg14522441",3,0,0,0,3
"cg14523405",2,1,4,0,7
"cg14523476",29,3,2,0,34
"cg14523706",0,0,1,0,1
"cg14524476",0,0,1,0,1
"cg14526688",1,0,0,0,1
"cg14527145",0,1,0,0,1
"cg14528034",0,1,0,0,1
"cg14528339",0,2,2,0,4
"cg14529610",305,39,0,0,344
"cg14529754",330,36,0,0,366
"cg14530338",2,0,0,0,2
"cg14530513",0,1,0,0,1
"cg14530541",1,0,0,0,1
"cg14530679",4,2,0,0,6
"cg14530833",0,1,0,0,1
"cg14530856",5,1,0,0,6
"cg14530937",0,1,1,0,2
"cg14531840",0,0,1,0,1
"cg14533605",1,0,0,0,1
"cg14533609",1,0,0,0,1
"cg14534021",0,1,1,0,2
"cg14535019",12,3,0,0,15
"cg14535167",15,16,3,0,34
"cg14536746",0,1,0,0,1
"cg14537194",1,18,4,0,23
"cg14538532",0,0,1,0,1
"cg14539130",1,0,0,0,1
"cg14539480",0,9,1,0,10
"cg14540397",39,6,0,0,45
"cg14541460",0,1,0,0,1
"cg14541930",0,1,0,0,1
"cg14542004",0,3,1,0,4
"cg14542156",0,0,2,0,2
"cg14543404",2,2,0,0,4
"cg14544505",0,0,5,0,5
"cg14544620",2,0,0,0,2
"cg14544632",17,24,36,0,77
"cg14544999",0,1,0,0,1
"cg14545354",2,0,0,0,2
"cg14545834",1,1,5,0,7
"cg14546076",2,0,0,0,2
"cg14546455",1,1,2,0,4
"cg14546574",17,1,0,0,18
"cg14549176",0,1,0,0,1
"cg14549295",106,39,1,0,146
"cg14549425",0,0,1,0,1
"cg14550212",3,0,0,0,3
"cg14550611",0,0,1,0,1
"cg14550828",1,0,0,0,1
"cg14551186",2,6,1,0,9
"cg14552179",1,0,0,0,1
"cg14552354",0,1,0,0,1
"cg14554488",0,0,9,0,9
"cg14554813",0,1,0,0,1
"cg14555253",3,1,1,0,5
"cg14555733",0,0,2,0,2
"cg14556349",1,0,14,0,15
"cg14556450",0,0,2,0,2
"cg14558153",10,0,0,0,10
"cg14558204",1,1,0,0,2
"cg14558728",261,114,11,0,386
"cg14559160",328,21,0,0,349
"cg14559234",0,2,1,0,3
"cg14559409",0,1,0,0,1
"cg14559733",535,15,0,0,550
"cg14560131",3,2,0,0,5
"cg14561079",0,0,2,0,2
"cg14561880",0,1,1,0,2
"cg14562211",3,10,13,0,26
"cg14562786",0,0,5,0,5
"cg14565164",0,0,1,0,1
"cg14565279",338,20,1,0,359
"cg14565714",3,0,0,0,3
"cg14565914",0,2,0,0,2
"cg14566437",1,0,1,0,2
"cg14567203",0,1,0,0,1
"cg14567424",0,1,0,0,1
"cg14567758",0,1,0,0,1
"cg14568552",4,0,0,0,4
"cg14569263",0,0,2,0,2
"cg14569722",0,2,0,0,2
"cg14569778",0,0,1,0,1
"cg14570440",0,0,1,0,1
"cg14571574",0,1,1,0,2
"cg14573270",12,1,1,0,14
"cg14573767",5,1,0,0,6
"cg14573897",1,0,0,0,1
"cg14574118",3,2,0,0,5
"cg14574508",25,17,8,0,50
"cg14574871",0,0,2,0,2
"cg14576802",0,0,6,0,6
"cg14577676",0,0,1,0,1
"cg14577974",1,0,0,0,1
"cg14579678",0,0,1,0,1
"cg14580349",0,0,1,0,1
"cg14581717",0,1,0,0,1
"cg14581928",1,0,2,0,3
"cg14582025",110,20,0,0,130
"cg14582108",0,1,0,0,1
"cg14583152",0,0,1,0,1
"cg14583369",2,0,0,0,2
"cg14583721",5,0,0,0,5
"cg14585288",0,2,0,0,2
"cg14586576",2,0,0,0,2
"cg14587210",0,1,0,0,1
"cg14588087",2,2,0,0,4
"cg14589911",2,0,0,0,2
"cg14590237",0,0,1,0,1
"cg14591531",1,0,0,0,1
"cg14591564",0,0,9,0,9
"cg14592064",1,0,0,0,1
"cg14592586",6,0,0,0,6
"cg14592768",1,0,0,0,1
"cg14592805",1,0,0,0,1
"cg14592989",0,5,0,0,5
"cg14593183",0,1,0,0,1
"cg14593273",3,5,7,0,15
"cg14595013",4,3,16,0,23
"cg14595915",52,5,0,0,57
"cg14596086",0,1,0,0,1
"cg14596140",3,0,0,0,3
"cg14596450",1,0,0,0,1
"cg14596593",0,0,1,0,1
"cg14597066",0,1,0,0,1
"cg14597280",0,2,3,0,5
"cg14597726",10,0,0,0,10
"cg14597791",0,0,2,0,2
"cg14598211",0,1,0,0,1
"cg14599127",0,0,1,0,1
"cg14599315",1,0,0,0,1
"cg14599714",0,1,1,0,2
"cg14599871",1,0,0,0,1
"cg14600090",1,0,0,0,1
"cg14600384",0,0,1,0,1
"cg14600420",0,0,1,0,1
"cg14600600",3,1,0,0,4
"cg14602341",0,1,2,0,3
"cg14602512",6,0,0,0,6
"cg14603040",0,0,5,0,5
"cg14604260",1,0,0,0,1
"cg14605812",0,1,0,0,1
"cg14606290",0,0,1,0,1
"cg14606856",0,1,0,0,1
"cg14607208",1,3,1,0,5
"cg14608394",2,0,0,0,2
"cg14608722",0,1,2,0,3
"cg14610121",0,3,3,0,6
"cg14611398",2,1,0,0,3
"cg14611628",0,0,1,0,1
"cg14614166",0,0,1,0,1
"cg14614975",3,0,0,0,3
"cg14615268",12,13,0,0,25
"cg14615609",419,140,0,0,559
"cg14616667",1,0,0,0,1
"cg14616761",9,0,0,0,9
"cg14616819",218,90,13,0,321
"cg14618186",0,1,0,0,1
"cg14618516",0,0,1,0,1
"cg14618664",1,0,0,0,1
"cg14618737",10,0,1,0,11
"cg14619201",123,159,68,0,350
"cg14619203",19,7,1,0,27
"cg14619432",2,0,0,0,2
"cg14621843",0,1,0,0,1
"cg14621868",1,0,0,0,1
"cg14622069",0,0,7,0,7
"cg14622152",15,42,2,0,59
"cg14623630",122,69,11,0,202
"cg14625172",1,1,0,0,2
"cg14628070",919,484,5,0,1408
"cg14628604",1,0,0,0,1
"cg14628803",6,1,2,0,9
"cg14630369",0,1,1,0,2
"cg14633078",4,0,0,0,4
"cg14633297",0,0,1,0,1
"cg14634156",1,0,0,0,1
"cg14634585",0,0,6,0,6
"cg14635199",0,2,1,0,3
"cg14635635",0,0,1,0,1
"cg14636433",14,0,0,0,14
"cg14637660",1,0,0,0,1
"cg14638044",1,0,3,0,4
"cg14639753",1,0,0,0,1
"cg14639859",0,1,1,0,2
"cg14640310",1,0,2,0,3
"cg14641231",0,0,4,0,4
"cg14641909",0,0,0,1,1
"cg14642327",0,0,1,0,1
"cg14642381",3,0,0,0,3
"cg14642878",0,0,1,0,1
"cg14643686",1,4,5,0,10
"cg14644008",382,9,1,0,392
"cg14644219",85,64,3,0,152
"cg14644886",355,27,0,0,382
"cg14645605",1,0,0,0,1
"cg14645856",1,0,0,0,1
"cg14646194",0,2,0,0,2
"cg14646548",0,1,0,0,1
"cg14646780",3,2,1,0,6
"cg14646974",0,0,1,0,1
"cg14647125",1,0,0,0,1
"cg14647494",0,1,1,0,2
"cg14647866",2,1,0,0,3
"cg14647877",0,1,0,0,1
"cg14649241",2,0,0,0,2
"cg14649652",2,0,0,0,2
"cg14649997",0,0,1,0,1
"cg14650244",12,3,1,0,16
"cg14650677",5,4,5,0,14
"cg14651305",0,1,0,0,1
"cg14651778",4,5,3,0,12
"cg14652434",1,1,9,0,11
"cg14655345",8,23,0,0,31
"cg14655485",0,0,1,0,1
"cg14656533",19,3,2,0,24
"cg14657341",0,0,2,0,2
"cg14658607",0,1,0,0,1
"cg14660024",0,1,0,0,1
"cg14661028",3,0,0,0,3
"cg14661056",23,12,27,0,62
"cg14661210",319,559,594,3,1475
"cg14661431",1,0,0,0,1
"cg14663533",0,1,0,0,1
"cg14664030",2,1,2,0,5
"cg14664302",3,1,0,0,4
"cg14665022",1,0,0,0,1
"cg14666457",0,1,0,0,1
"cg14668026",2,0,2,0,4
"cg14668513",0,0,1,0,1
"cg14669139",0,1,0,0,1
"cg14669939",38,4,0,0,42
"cg14670842",14,5,0,0,19
"cg14675109",1,1,0,0,2
"cg14675427",268,11,0,0,279
"cg14675896",5,2,0,0,7
"cg14677013",371,190,5,0,566
"cg14677510",0,0,1,0,1
"cg14678021",0,1,0,0,1
"cg14679497",1,0,0,0,1
"cg14680067",1,0,0,0,1
"cg14680303",0,0,1,0,1
"cg14683055",213,410,62,0,685
"cg14683317",195,156,7,0,358
"cg14683916",0,1,1,1,3
"cg14686191",29,8,6,0,43
"cg14686207",3,0,0,0,3
"cg14688078",1,2,0,0,3
"cg14688113",150,208,8,0,366
"cg14688418",0,0,1,0,1
"cg14689365",0,2,1,0,3
"cg14689542",1,0,0,0,1
"cg14690181",1,1,0,0,2
"cg14690458",0,0,1,0,1
"cg14690580",0,0,2,0,2
"cg14691167",0,2,2,0,4
"cg14691356",3,0,1,0,4
"cg14691596",1,0,0,0,1
"cg14691729",1,8,2,0,11
"cg14695054",4,0,0,0,4
"cg14695316",4,2,3,0,9
"cg14696445",0,1,0,0,1
"cg14696820",0,1,2,0,3
"cg14697577",0,2,0,0,2
"cg14698257",1,0,0,0,1
"cg14698794",0,0,1,0,1
"cg14698917",0,2,1,0,3
"cg14699782",1,0,0,0,1
"cg14700647",4,0,0,0,4
"cg14701008",0,0,2,0,2
"cg14701212",1,0,0,0,1
"cg14701978",1,0,0,0,1
"cg14702372",119,280,6,0,405
"cg14703102",0,0,1,0,1
"cg14704483",0,2,1,0,3
"cg14704564",1,1,0,0,2
"cg14705883",0,0,1,0,1
"cg14706107",1,0,0,0,1
"cg14706153",4,0,0,0,4
"cg14706226",8,2,0,0,10
"cg14706807",2,0,0,0,2
"cg14707878",0,1,2,0,3
"cg14708045",0,1,0,0,1
"cg14708603",1,0,0,0,1
"cg14708663",2,5,2,0,9
"cg14710025",0,1,0,0,1
"cg14711302",8,8,0,0,16
"cg14711745",0,1,0,0,1
"cg14715030",1,0,3,0,4
"cg14715098",275,563,2,0,840
"cg14715136",0,0,1,0,1
"cg14715667",1,0,0,0,1
"cg14716020",7,0,6,0,13
"cg14716966",3,1,0,0,4
"cg14717759",2,0,0,0,2
"cg14718065",0,1,0,0,1
"cg14720354",158,317,42,0,517
"cg14722037",1,0,0,0,1
"cg14722273",0,0,1,0,1
"cg14722975",2,4,2,0,8
"cg14723373",11,5,0,0,16
"cg14723800",1,1,0,0,2
"cg14724469",0,0,1,0,1
"cg14724590",3,0,0,0,3
"cg14724699",1,0,0,0,1
"cg14724719",0,1,0,0,1
"cg14724791",11,33,0,0,44
"cg14724809",2,0,0,0,2
"cg14725804",142,26,1,0,169
"cg14726249",0,1,0,0,1
"cg14726755",1,0,0,0,1
"cg14727106",126,12,0,0,138
"cg14727178",1,0,0,0,1
"cg14727192",514,14,0,0,528
"cg14727650",8,0,0,0,8
"cg14728017",1,0,1,0,2
"cg14728864",0,1,0,0,1
"cg14730676",3,2,0,0,5
"cg14732376",23,8,1,0,32
"cg14732729",1,0,0,0,1
"cg14732789",0,0,7,0,7
"cg14733834",9,0,0,0,9
"cg14734916",0,1,0,0,1
"cg14737263",1,0,0,0,1
"cg14737659",0,0,1,0,1
"cg14738290",3,0,0,0,3
"cg14740814",15,0,0,0,15
"cg14741626",0,1,0,0,1
"cg14741653",0,0,1,0,1
"cg14741792",4,0,1,0,5
"cg14741795",0,1,0,0,1
"cg14742198",0,0,0,1,1
"cg14742523",1,0,0,0,1
"cg14742524",1,0,1,0,2
"cg14742715",0,1,0,0,1
"cg14742851",5,0,0,0,5
"cg14743087",2,0,0,0,2
"cg14743520",2,0,0,0,2
"cg14746207",0,0,1,0,1
"cg14747273",2,1,0,0,3
"cg14747518",0,1,0,0,1
"cg14748636",4,5,0,0,9
"cg14749368",185,174,25,0,384
"cg14751087",1,0,0,0,1
"cg14752069",0,1,0,0,1
"cg14752990",0,6,10,0,16
"cg14754827",0,4,4,0,8
"cg14755417",1,1,0,0,2
"cg14755992",1,1,0,0,2
"cg14756307",0,0,1,0,1
"cg14756640",9,111,497,0,617
"cg14756932",2,0,0,0,2
"cg14757545",1,0,0,0,1
"cg14757759",22,5,3,0,30
"cg14760221",0,0,3,0,3
"cg14761772",1,2,1,0,4
"cg14762316",2,1,1,0,4
"cg14763422",0,2,0,0,2
"cg14764876",0,1,0,0,1
"cg14765183",1,0,0,0,1
"cg14766219",1,0,0,0,1
"cg14766646",6,0,0,0,6
"cg14766654",383,31,3,0,417
"cg14768386",11,2,0,0,13
"cg14768747",36,5,0,0,41
"cg14768765",3,4,0,0,7
"cg14768848",0,0,1,0,1
"cg14768866",26,1,0,0,27
"cg14769461",2,0,0,0,2
"cg14769475",1,0,0,0,1
"cg14770633",1,0,0,0,1
"cg14771233",0,3,2,0,5
"cg14771301",2,0,0,0,2
"cg14771714",8,0,0,0,8
"cg14772439",1,0,0,0,1
"cg14772760",0,1,0,0,1
"cg14773441",887,190,4,0,1081
"cg14773466",0,1,0,0,1
"cg14773480",62,185,253,0,500
"cg14774061",0,1,0,0,1
"cg14774371",0,0,0,1,1
"cg14774438",0,0,1,0,1
"cg14774895",0,0,2,0,2
"cg14775126",1,0,0,0,1
"cg14775487",79,9,0,0,88
"cg14775690",198,22,0,0,220
"cg14777161",30,3,0,0,33
"cg14778021",0,1,0,0,1
"cg14778437",12,0,0,0,12
"cg14778531",1,2,9,0,12
"cg14779106",0,1,1,0,2
"cg14779627",0,4,0,0,4
"cg14780572",5,0,0,0,5
"cg14780883",3,0,0,0,3
"cg14781967",0,0,1,0,1
"cg14782152",1,1,0,0,2
"cg14782883",0,1,0,0,1
"cg14783439",2,0,0,0,2
"cg14783943",0,0,1,0,1
"cg14784631",1,0,0,0,1
"cg14784823",0,0,1,0,1
"cg14785064",89,7,7,0,103
"cg14787112",5,1,0,0,6
"cg14789287",5,1,0,0,6
"cg14789960",401,308,9,0,718
"cg14791089",1,0,0,0,1
"cg14793286",97,49,14,0,160
"cg14795069",0,0,1,0,1
"cg14795253",1,0,0,0,1
"cg14795328",0,0,1,0,1
"cg14796474",1,9,3,0,13
"cg14796755",0,1,0,0,1
"cg14798158",0,1,0,0,1
"cg14798160",0,1,0,0,1
"cg14798566",3,0,1,0,4
"cg14798656",0,0,1,0,1
"cg14800026",0,0,1,0,1
"cg14800792",0,1,0,0,1
"cg14801012",0,1,0,0,1
"cg14801692",1,0,0,0,1
"cg14802000",1,0,0,0,1
"cg14805060",0,2,0,0,2
"cg14805451",1,0,0,0,1
"cg14805882",1,1,0,0,2
"cg14806418",4,0,0,0,4
"cg14809311",1,0,0,0,1
"cg14811551",4,3,2,0,9
"cg14812046",0,1,0,0,1
"cg14812330",0,1,0,0,1
"cg14813762",0,1,0,0,1
"cg14814488",0,0,3,0,3
"cg14814714",3,0,0,0,3
"cg14817997",0,5,0,0,5
"cg14819838",1,1,1,0,3
"cg14819942",0,4,0,0,4
"cg14820191",4,1,0,0,5
"cg14820441",1,0,0,0,1
"cg14821382",0,1,2,0,3
"cg14824978",2,2,0,0,4
"cg14826366",2,5,0,0,7
"cg14826394",1,0,0,0,1
"cg14827083",2,2,0,0,4
"cg14827198",0,1,0,0,1
"cg14827249",0,1,1,0,2
"cg14828206",2,0,0,0,2
"cg14829048",0,1,0,0,1
"cg14829155",0,0,1,0,1
"cg14829303",1,1,0,0,2
"cg14829740",21,5,0,0,26
"cg14830118",0,0,1,0,1
"cg14830644",2,2,0,0,4
"cg14830815",259,52,0,0,311
"cg14832183",0,0,1,0,1
"cg14833410",2,0,0,0,2
"cg14834721",111,5,0,0,116
"cg14834865",2,0,0,0,2
"cg14835575",0,1,0,0,1
"cg14835746",274,823,32,0,1129
"cg14836643",7,2,0,0,9
"cg14837792",4,0,0,0,4
"cg14838427",0,1,0,0,1
"cg14838782",2,0,0,0,2
"cg14839087",0,1,0,0,1
"cg14839256",0,1,0,0,1
"cg14840163",0,1,0,0,1
"cg14840792",1,0,0,0,1
"cg14840863",464,87,4,0,555
"cg14841222",448,23,1,0,472
"cg14842030",0,1,0,0,1
"cg14843402",0,1,0,0,1
"cg14843831",14,9,0,0,23
"cg14844812",0,1,0,0,1
"cg14846244",1,0,0,0,1
"cg14846372",0,0,2,0,2
"cg14846398",1,0,0,0,1
"cg14848124",1,0,0,0,1
"cg14848321",0,0,1,0,1
"cg14848469",0,1,0,0,1
"cg14848951",1,0,0,0,1
"cg14849412",0,0,1,0,1
"cg14849422",30,0,0,0,30
"cg14850342",134,28,7,0,169
"cg14851317",1,3,0,0,4
"cg14851325",0,0,1,0,1
"cg14851468",0,0,1,0,1
"cg14851578",0,0,1,0,1
"cg14853443",3,1,0,0,4
"cg14853981",150,73,6,0,229
"cg14854329",0,0,1,0,1
"cg14854474",1,14,1,0,16
"cg14854689",0,1,0,0,1
"cg14856052",0,0,3,0,3
"cg14856082",1,2,0,0,3
"cg14856803",1,0,0,0,1
"cg14857615",133,211,5,0,349
"cg14859090",0,0,1,0,1
"cg14859464",1,0,0,0,1
"cg14859691",4,3,2,0,9
"cg14860255",0,0,1,0,1
"cg14861298",0,2,7,1,10
"cg14861518",1,1,0,0,2
"cg14861803",0,1,0,0,1
"cg14862075",0,0,1,0,1
"cg14862612",376,60,8,0,444
"cg14863101",669,43,0,0,712
"cg14863940",1,0,0,0,1
"cg14866097",89,51,7,0,147
"cg14866174",0,0,1,0,1
"cg14867395",2,0,0,0,2
"cg14868641",23,7,2,0,32
"cg14871593",0,0,2,0,2
"cg14873300",0,1,0,0,1
"cg14873473",0,0,2,0,2
"cg14873885",0,1,0,0,1
"cg14875394",0,2,0,0,2
"cg14876115",0,0,0,1,1
"cg14876463",15,2,0,0,17
"cg14876603",0,1,0,0,1
"cg14878327",0,1,0,0,1
"cg14878969",5,2,0,0,7
"cg14879314",12,0,0,0,12
"cg14879843",0,1,0,0,1
"cg14880205",0,0,1,0,1
"cg14881054",0,2,0,0,2
"cg14882211",0,1,0,0,1
"cg14882700",0,1,0,0,1
"cg14882797",26,473,26,0,525
"cg14883930",6,1,0,0,7
"cg14884183",1,8,2,0,11
"cg14884984",0,0,2,0,2
"cg14885090",1,0,0,0,1
"cg14885105",2,0,0,0,2
"cg14885993",1,0,0,0,1
"cg14886300",0,0,1,0,1
"cg14886405",4,2,2,0,8
"cg14890161",0,0,1,0,1
"cg14891543",46,4,0,0,50
"cg14892067",4,0,0,0,4
"cg14892262",1,1,0,0,2
"cg14893980",0,6,0,0,6
"cg14894369",394,18,0,0,412
"cg14894801",2,0,0,0,2
"cg14895113",0,1,1,0,2
"cg14895302",1,1,0,0,2
"cg14895559",1,0,0,0,1
"cg14896087",0,0,1,0,1
"cg14896905",0,1,0,0,1
"cg14896990",5,0,0,0,5
"cg14897569",3,2,1,0,6
"cg14898114",0,0,1,0,1
"cg14898229",0,1,1,0,2
"cg14898433",0,0,1,0,1
"cg14898547",1,0,0,0,1
"cg14898822",2,0,0,0,2
"cg14899131",6,0,0,0,6
"cg14899563",1,0,0,0,1
"cg14899735",4,1,0,0,5
"cg14901121",0,0,1,0,1
"cg14903680",0,1,0,0,1
"cg14906734",2,0,1,0,3
"cg14907381",49,41,2,0,92
"cg14907489",0,0,1,0,1
"cg14908964",1,1,0,0,2
"cg14910038",1,1,1,0,3
"cg14910374",0,1,0,0,1
"cg14910790",0,0,1,0,1
"cg14911101",1,0,1,0,2
"cg14911314",24,0,0,0,24
"cg14912033",0,0,1,0,1
"cg14912488",0,0,1,0,1
"cg14913984",0,0,1,0,1
"cg14914254",2,2,2,0,6
"cg14915290",12,7,4,0,23
"cg14916192",7,0,0,0,7
"cg14916288",1,0,0,0,1
"cg14917512",0,0,1,0,1
"cg14917610",4,10,3,0,17
"cg14918358",0,7,8,0,15
"cg14918442",0,4,2,0,6
"cg14918782",14,19,4,0,37
"cg14918914",3,1,0,0,4
"cg14919252",0,0,1,0,1
"cg14920808",2,0,0,0,2
"cg14921533",0,1,0,0,1
"cg14923259",2,1,0,0,3
"cg14924510",0,0,1,0,1
"cg14926216",113,168,12,0,293
"cg14927405",27,3,0,0,30
"cg14927951",0,0,0,1,1
"cg14928320",1,0,1,0,2
"cg14929153",18,7,0,0,25
"cg14929421",7,3,15,0,25
"cg14930167",0,4,0,0,4
"cg14930907",2,0,0,0,2
"cg14931803",0,0,2,0,2
"cg14933365",1,0,0,0,1
"cg14933403",1,0,0,0,1
"cg14934400",6,1,2,0,9
"cg14934722",28,3,0,0,31
"cg14935932",0,0,1,0,1
"cg14936158",1,0,0,0,1
"cg14936601",0,1,0,0,1
"cg14936946",732,748,61,0,1541
"cg14937409",4,0,0,0,4
"cg14937607",2,0,0,0,2
"cg14938040",2,1,0,0,3
"cg14938452",0,0,1,0,1
"cg14938741",4,1,0,0,5
"cg14938772",0,0,0,1,1
"cg14941036",0,0,1,0,1
"cg14941073",0,1,0,0,1
"cg14941172",0,0,2,0,2
"cg14941559",164,152,117,0,433
"cg14941654",2,1,0,0,3
"cg14942464",0,0,1,0,1
"cg14944043",12,23,0,0,35
"cg14944171",1,2,0,0,3
"cg14945415",1,0,0,0,1
"cg14945433",3,0,0,0,3
"cg14945501",4,0,0,0,4
"cg14945850",2,0,0,0,2
"cg14946503",7,0,0,0,7
"cg14947133",3,0,0,0,3
"cg14947510",1,0,0,0,1
"cg14949102",0,0,1,0,1
"cg14949694",1,1,0,0,2
"cg14950303",0,1,0,0,1
"cg14950428",1,0,0,0,1
"cg14952077",1,0,2,0,3
"cg14952802",689,106,0,0,795
"cg14952920",4,0,0,0,4
"cg14954430",0,1,0,0,1
"cg14954944",0,0,1,0,1
"cg14956267",9,2,12,0,23
"cg14957685",0,0,2,0,2
"cg14958242",1,0,0,0,1
"cg14959695",220,467,62,0,749
"cg14959820",3,1,1,0,5
"cg14960489",52,0,0,0,52
"cg14960827",0,0,1,0,1
"cg14961511",0,1,1,0,2
"cg14962120",0,2,0,0,2
"cg14962197",1,0,0,0,1
"cg14962447",538,186,29,0,753
"cg14962548",0,1,0,0,1
"cg14962943",20,0,0,0,20
"cg14963217",0,0,1,0,1
"cg14963884",0,1,2,0,3
"cg14964217",20,0,0,0,20
"cg14964564",32,1,0,0,33
"cg14964771",12,11,6,0,29
"cg14965634",4,0,0,0,4
"cg14966402",1,0,0,0,1
"cg14966613",0,0,0,1,1
"cg14966661",3,0,0,0,3
"cg14966941",0,0,24,0,24
"cg14968719",0,0,1,0,1
"cg14968743",21,1,0,0,22
"cg14968758",1,7,4,0,12
"cg14969100",0,1,0,0,1
"cg14969194",0,2,1,0,3
"cg14969317",0,0,1,0,1
"cg14969811",0,0,2,0,2
"cg14972241",7,5,1,0,13
"cg14972875",0,1,0,0,1
"cg14973240",0,0,1,0,1
"cg14973798",1,0,0,0,1
"cg14974384",1,2,0,0,3
"cg14976969",4,2,0,0,6
"cg14977059",0,2,0,0,2
"cg14977726",0,1,0,0,1
"cg14977769",10,9,0,0,19
"cg14978131",0,0,1,0,1
"cg14978345",0,0,4,0,4
"cg14981055",1,0,0,0,1
"cg14983244",1,0,6,0,7
"cg14983306",1,0,0,0,1
"cg14983684",1,2,0,0,3
"cg14985107",5,0,0,0,5
"cg14985830",265,209,23,0,497
"cg14987283",0,3,10,0,13
"cg14987625",0,0,2,0,2
"cg14988092",46,14,0,0,60
"cg14990545",0,6,2,0,8
"cg14990681",31,3,1,0,35
"cg14990857",0,0,1,0,1
"cg14990970",0,0,1,0,1
"cg14992138",0,1,0,0,1
"cg14992964",1,0,0,1,2
"cg14992972",1,0,0,0,1
"cg14993502",0,1,0,0,1
"cg14993663",1,0,0,0,1
"cg14994327",1,0,0,0,1
"cg14994935",2,0,0,0,2
"cg14995492",4,5,0,0,9
"cg14995783",1,2,1,0,4
"cg14995803",1,0,0,0,1
"cg14996661",2,0,0,0,2
"cg14996918",0,1,0,0,1
"cg14997702",78,34,5,0,117
"cg14998329",0,1,1,0,2
"cg14998582",0,1,0,0,1
"cg14999036",0,0,5,0,5
"cg15000759",0,1,0,0,1
"cg15002172",0,1,0,0,1
"cg15002580",10,0,0,0,10
"cg15002810",1,0,0,0,1
"cg15003465",0,0,1,0,1
"cg15003468",2,2,0,0,4
"cg15005172",440,396,8,0,844
"cg15005248",1,0,0,0,1
"cg15006346",1,0,0,0,1
"cg15006748",0,0,3,0,3
"cg15007104",0,0,7,0,7
"cg15007120",6,0,0,0,6
"cg15007326",1,1,0,0,2
"cg15010243",5,11,0,0,16
"cg15011775",2,0,0,0,2
"cg15012740",1,3,1,0,5
"cg15013954",0,0,1,0,1
"cg15014811",37,0,2,0,39
"cg15014977",1,0,0,0,1
"cg15015380",1,0,0,0,1
"cg15015397",0,0,1,0,1
"cg15015416",0,0,2,0,2
"cg15017156",7,4,0,0,11
"cg15019005",0,1,0,0,1
"cg15020993",1105,130,2,0,1237
"cg15021707",7,0,1,0,8
"cg15021882",1,1,0,0,2
"cg15022308",0,0,1,0,1
"cg15022313",0,0,1,0,1
"cg15023313",0,1,0,0,1
"cg15024277",0,1,1,0,2
"cg15024841",0,0,2,0,2
"cg15027295",20,6,4,0,30
"cg15027358",1,0,0,0,1
"cg15028479",3,1,1,0,5
"cg15030397",6,0,1,0,7
"cg15030631",0,0,5,0,5
"cg15031013",0,1,0,0,1
"cg15031253",0,1,0,0,1
"cg15032025",2,1,0,0,3
"cg15032346",5,0,0,0,5
"cg15032844",0,1,0,0,1
"cg15033600",3,2,1,0,6
"cg15033695",0,1,0,0,1
"cg15034976",0,0,1,0,1
"cg15035709",269,66,9,0,344
"cg15036098",0,0,1,0,1
"cg15037358",14,4,1,0,19
"cg15037596",0,0,1,0,1
"cg15039355",16,1,0,0,17
"cg15039510",4,16,8,0,28
"cg15040188",0,0,1,0,1
"cg15040616",0,4,0,0,4
"cg15040835",0,0,1,0,1
"cg15041829",1,0,0,0,1
"cg15041949",1,1,4,0,6
"cg15042490",0,0,1,0,1
"cg15042801",0,0,1,0,1
"cg15042970",0,0,1,0,1
"cg15043638",0,2,0,0,2
"cg15044188",6,10,0,0,16
"cg15045174",0,0,1,0,1
"cg15046299",0,0,3,0,3
"cg15046304",1,0,0,0,1
"cg15047484",7,15,6,0,28
"cg15048461",0,0,2,0,2
"cg15049370",66,8,1,0,75
"cg15050398",3,0,0,0,3
"cg15050672",0,0,4,0,4
"cg15051148",4,0,0,0,4
"cg15051221",0,0,2,0,2
"cg15051795",0,1,0,0,1
"cg15052642",228,281,6,0,515
"cg15052802",5,2,5,0,12
"cg15053468",0,1,0,0,1
"cg15053575",0,0,1,0,1
"cg15054275",1,0,0,0,1
"cg15054288",8,0,0,0,8
"cg15055128",0,1,0,0,1
"cg15055582",0,0,1,0,1
"cg15056139",0,4,0,0,4
"cg15056727",73,5,0,0,78
"cg15057554",0,2,0,0,2
"cg15057581",0,0,1,0,1
"cg15057621",0,0,1,0,1
"cg15057818",0,0,1,0,1
"cg15057829",0,0,2,0,2
"cg15058253",0,0,1,0,1
"cg15059743",0,0,1,0,1
"cg15060081",1,1,0,0,2
"cg15060599",1,0,0,0,1
"cg15061647",0,0,1,0,1
"cg15061940",1,0,0,0,1
"cg15062749",9,3,0,0,12
"cg15063753",0,0,1,0,1
"cg15064466",471,155,1,0,627
"cg15064615",0,0,1,0,1
"cg15064691",0,0,1,0,1
"cg15064753",11,1,0,0,12
"cg15066179",1,0,0,0,1
"cg15066416",0,1,0,0,1
"cg15066656",3,0,0,0,3
"cg15066772",1,0,0,0,1
"cg15066820",0,1,0,0,1
"cg15066881",0,1,1,0,2
"cg15066992",708,23,0,0,731
"cg15067764",245,89,14,0,348
"cg15068357",0,0,1,0,1
"cg15068401",0,1,3,0,4
"cg15069291",0,0,1,0,1
"cg15069587",6,0,0,0,6
"cg15069929",0,1,0,0,1
"cg15070238",0,1,0,0,1
"cg15073142",1,0,0,0,1
"cg15074092",1,2,1,0,4
"cg15074217",0,2,7,0,9
"cg15074221",0,1,0,0,1
"cg15074424",19,4,0,0,23
"cg15075076",1,5,0,0,6
"cg15075293",4,0,0,0,4
"cg15076631",0,0,1,0,1
"cg15077416",412,70,7,0,489
"cg15078985",1,0,0,0,1
"cg15079108",15,1,0,0,16
"cg15080613",1,0,0,0,1
"cg15082040",5,3,0,0,8
"cg15082435",2,0,0,0,2
"cg15083166",1,0,0,0,1
"cg15083783",23,11,1,0,35
"cg15084766",1,1,0,0,2
"cg15085128",0,0,1,0,1
"cg15086499",0,2,0,0,2
"cg15086653",0,1,0,0,1
"cg15086851",0,0,1,0,1
"cg15087151",0,0,1,0,1
"cg15087369",1,0,0,0,1
"cg15088012",180,10,0,0,190
"cg15088325",0,1,0,0,1
"cg15088597",1,4,0,0,5
"cg15088880",0,0,3,0,3
"cg15089950",0,1,0,0,1
"cg15092368",4,0,0,0,4
"cg15092823",10,3,0,0,13
"cg15095335",11,11,2,0,24
"cg15095581",2,0,0,0,2
"cg15095771",0,0,1,0,1
"cg15096432",0,1,0,0,1
"cg15096958",0,0,1,0,1
"cg15097007",0,0,1,0,1
"cg15097774",0,0,1,0,1
"cg15099490",1,0,0,0,1
"cg15100535",152,74,15,0,241
"cg15100936",0,0,4,0,4
"cg15101089",1,2,0,0,3
"cg15101535",0,0,1,0,1
"cg15102473",0,0,1,0,1
"cg15102638",0,0,1,0,1
"cg15102655",1,0,0,0,1
"cg15103705",0,1,0,0,1
"cg15104592",0,1,0,0,1
"cg15105252",25,4,0,0,29
"cg15105932",2,0,0,0,2
"cg15106699",2,1,0,0,3
"cg15107350",3,1,0,0,4
"cg15108011",2,0,0,0,2
"cg15109950",1,0,0,0,1
"cg15112407",0,0,1,0,1
"cg15113140",9,0,0,0,9
"cg15113743",1,0,0,0,1
"cg15113922",0,1,0,0,1
"cg15115413",108,35,0,0,143
"cg15116120",0,0,1,0,1
"cg15117895",51,71,1,0,123
"cg15118105",0,2,3,0,5
"cg15118204",0,0,1,0,1
"cg15118514",1,0,0,0,1
"cg15118745",141,11,0,0,152
"cg15118835",0,0,1,0,1
"cg15118937",0,0,0,1,1
"cg15119076",1,0,0,0,1
"cg15120315",0,3,1,0,4
"cg15123180",0,0,0,1,1
"cg15123663",0,1,0,0,1
"cg15123819",1,1,2,0,4
"cg15123925",2,0,0,0,2
"cg15124629",0,1,0,0,1
"cg15124878",0,0,2,0,2
"cg15125549",5,12,3,0,20
"cg15125770",2,3,7,0,12
"cg15126211",0,1,0,0,1
"cg15127853",1,0,0,0,1
"cg15128208",0,2,0,0,2
"cg15128347",9,11,2,0,22
"cg15130204",0,2,0,0,2
"cg15131187",1,0,1,0,2
"cg15132372",2,3,2,0,7
"cg15132841",2,6,7,0,15
"cg15133265",68,9,0,0,77
"cg15133963",3,2,0,0,5
"cg15134409",260,17,0,0,277
"cg15134553",2,0,0,0,2
"cg15135264",258,102,2,0,362
"cg15135595",1,2,0,0,3
"cg15135617",2,0,0,0,2
"cg15138289",1,0,0,0,1
"cg15138702",1,0,0,0,1
"cg15141171",1,0,0,0,1
"cg15141863",6,1,0,0,7
"cg15141985",0,1,0,0,1
"cg15144517",20,13,22,1,56
"cg15144817",28,16,4,0,48
"cg15144928",1,0,0,0,1
"cg15145250",1,0,0,0,1
"cg15145775",0,1,0,0,1
"cg15146033",0,1,0,0,1
"cg15149275",5,5,0,0,10
"cg15150215",198,146,3,0,347
"cg15151052",2,0,0,0,2
"cg15151238",0,2,0,0,2
"cg15152789",53,5,0,0,58
"cg15153068",2,2,1,0,5
"cg15153347",1,1,0,0,2
"cg15153800",0,1,0,0,1
"cg15153928",0,1,0,0,1
"cg15154206",0,0,1,0,1
"cg15154635",0,0,3,0,3
"cg15155394",3,0,0,0,3
"cg15155568",23,1,0,0,24
"cg15155990",0,0,5,0,5
"cg15156610",2,0,0,0,2
"cg15157335",0,1,0,0,1
"cg15157455",2,0,4,0,6
"cg15157856",0,0,1,0,1
"cg15157978",0,1,0,0,1
"cg15158310",3,0,0,0,3
"cg15158977",0,0,1,0,1
"cg15159291",0,1,0,0,1
"cg15160081",0,1,0,0,1
"cg15162219",4,1,0,0,5
"cg15162320",52,0,0,0,52
"cg15164008",101,45,7,0,153
"cg15164048",643,49,0,0,692
"cg15165019",0,0,1,0,1
"cg15165114",1,0,0,0,1
"cg15165211",0,2,0,0,2
"cg15165720",4,4,3,0,11
"cg15166246",47,16,3,0,66
"cg15166504",0,0,2,0,2
"cg15168892",0,0,2,0,2
"cg15169469",0,0,1,0,1
"cg15169471",0,0,2,0,2
"cg15169745",0,0,1,0,1
"cg15170272",6,1,0,0,7
"cg15172011",95,337,209,0,641
"cg15172514",4,3,1,0,8
"cg15172814",3,1,0,0,4
"cg15174205",0,1,3,0,4
"cg15174294",6,2,0,0,8
"cg15174445",1,0,0,0,1
"cg15174812",1,1,0,1,3
"cg15174961",0,0,2,0,2
"cg15175091",158,67,2,0,227
"cg15175104",2,0,0,0,2
"cg15175351",0,0,1,0,1
"cg15175648",0,0,1,0,1
"cg15175954",1,0,0,0,1
"cg15176125",0,0,1,0,1
"cg15176311",0,0,1,0,1
"cg15176461",6,0,0,0,6
"cg15176874",5,1,0,0,6
"cg15176895",0,1,1,0,2
"cg15177055",0,0,1,0,1
"cg15177169",0,4,0,0,4
"cg15177410",11,1,0,0,12
"cg15177551",36,7,0,0,43
"cg15178040",0,2,0,0,2
"cg15178807",0,0,0,1,1
"cg15179872",321,67,6,0,394
"cg15181003",0,0,1,0,1
"cg15181153",11,2,0,0,13
"cg15181688",1,0,0,0,1
"cg15183654",0,0,1,0,1
"cg15183689",5,2,0,0,7
"cg15183843",0,0,1,0,1
"cg15183961",0,1,4,0,5
"cg15184797",1,0,0,0,1
"cg15185774",18,2,0,0,20
"cg15186488",1,1,0,0,2
"cg15187536",9,0,0,0,9
"cg15188084",1,0,0,0,1
"cg15188252",1,0,0,0,1
"cg15189170",0,1,0,0,1
"cg15189233",10,0,0,0,10
"cg15189797",309,138,5,0,452
"cg15191126",1,0,0,0,1
"cg15192120",0,0,2,0,2
"cg15192242",0,0,2,0,2
"cg15192750",0,0,2,0,2
"cg15192779",3,0,0,0,3
"cg15194130",2,0,0,0,2
"cg15194799",0,0,2,0,2
"cg15195367",0,0,2,0,2
"cg15195927",0,3,2,0,5
"cg15196058",75,6,1,0,82
"cg15196213",1,0,0,0,1
"cg15197881",0,0,1,0,1
"cg15199748",4,1,0,0,5
"cg15200796",0,0,2,0,2
"cg15201115",1,0,0,0,1
"cg15201911",0,0,2,0,2
"cg15201918",0,2,0,0,2
"cg15202397",1,0,0,0,1
"cg15202609",55,27,0,0,82
"cg15202876",0,3,1,0,4
"cg15203096",26,10,0,0,36
"cg15203333",0,0,2,0,2
"cg15205382",0,0,1,0,1
"cg15206500",286,95,32,0,413
"cg15208247",1,1,0,0,2
"cg15210234",0,1,0,0,1
"cg15210622",0,0,1,0,1
"cg15210787",0,0,1,0,1
"cg15210833",0,1,0,0,1
"cg15211033",0,1,0,0,1
"cg15211894",2,1,0,0,3
"cg15212137",8,1,0,0,9
"cg15212895",1,0,0,0,1
"cg15213026",0,1,0,0,1
"cg15213488",0,0,1,0,1
"cg15213782",0,0,1,0,1
"cg15214379",1,0,1,0,2
"cg15215200",1,0,0,0,1
"cg15215251",475,60,1,0,536
"cg15215369",0,1,0,0,1
"cg15216812",8,0,0,0,8
"cg15216960",4,2,12,0,18
"cg15218033",5,0,0,0,5
"cg15218509",0,0,2,0,2
"cg15219029",0,4,0,0,4
"cg15219167",14,0,0,0,14
"cg15219878",4,0,0,0,4
"cg15220486",0,0,1,0,1
"cg15221579",0,1,0,0,1
"cg15222421",1,0,0,0,1
"cg15222662",0,0,1,0,1
"cg15224304",6,2,1,0,9
"cg15224505",1,1,4,0,6
"cg15224955",0,0,1,0,1
"cg15225364",0,1,0,0,1
"cg15226464",0,1,0,0,1
"cg15227051",10,3,0,0,13
"cg15227633",1,0,0,0,1
"cg15227771",28,2,0,0,30
"cg15230074",0,0,1,0,1
"cg15230460",4,17,3,0,24
"cg15232319",0,0,1,0,1
"cg15233204",2,0,0,0,2
"cg15233514",0,1,0,0,1
"cg15234263",0,0,3,1,4
"cg15234609",0,3,0,0,3
"cg15234883",0,0,1,0,1
"cg15236063",1,0,0,0,1
"cg15236717",1,0,0,0,1
"cg15237945",2,0,0,0,2
"cg15238664",8,0,0,0,8
"cg15239694",0,1,0,0,1
"cg15240092",1,3,0,0,4
"cg15240651",0,0,1,0,1
"cg15241786",0,0,1,0,1
"cg15242048",4,0,0,0,4
"cg15242465",0,0,1,0,1
"cg15242910",0,0,1,0,1
"cg15243597",29,2,3,0,34
"cg15244360",3,2,20,0,25
"cg15247031",0,0,1,0,1
"cg15247093",0,2,1,0,3
"cg15247806",1,0,0,0,1
"cg15247974",1,0,0,0,1
"cg15248672",11,0,0,0,11
"cg15249911",0,0,1,0,1
"cg15249961",1,0,0,0,1
"cg15251140",46,11,0,0,57
"cg15251385",0,1,0,0,1
"cg15253738",1,0,0,0,1
"cg15253816",0,0,1,0,1
"cg15253913",1,3,0,0,4
"cg15253964",0,0,1,0,1
"cg15255291",4,0,0,0,4
"cg15255329",0,0,1,0,1
"cg15255537",0,0,2,0,2
"cg15256972",1,0,0,0,1
"cg15257539",0,0,3,0,3
"cg15257565",2,0,0,0,2
"cg15257783",0,1,1,0,2
"cg15260431",0,0,1,0,1
"cg15261069",5,16,1,0,22
"cg15261270",375,220,5,0,600
"cg15261750",0,1,1,0,2
"cg15262047",0,2,0,0,2
"cg15263024",8,0,0,0,8
"cg15263682",1,0,1,0,2
"cg15263875",292,239,2,0,533
"cg15266021",0,1,0,0,1
"cg15266610",1,0,0,0,1
"cg15267532",0,0,1,0,1
"cg15268238",1,0,0,0,1
"cg15268826",0,20,11,0,31
"cg15269721",21,4,0,0,25
"cg15271029",0,0,2,0,2
"cg15271132",0,0,1,0,1
"cg15271813",10,2,0,0,12
"cg15271926",0,1,2,0,3
"cg15272312",0,1,0,0,1
"cg15275309",5,12,0,0,17
"cg15275758",0,0,1,0,1
"cg15276196",1,1,0,0,2
"cg15276331",0,0,4,0,4
"cg15276956",0,4,4,0,8
"cg15277213",4,3,0,0,7
"cg15277535",1,0,0,0,1
"cg15278957",973,29,0,0,1002
"cg15279413",0,0,1,0,1
"cg15279766",0,0,1,0,1
"cg15280245",1,0,0,0,1
"cg15281020",1,0,0,0,1
"cg15281032",0,1,0,0,1
"cg15281145",2,0,0,0,2
"cg15281406",1,0,0,0,1
"cg15283287",3,0,0,0,3
"cg15284935",1,1,0,0,2
"cg15285112",1,0,0,0,1
"cg15285801",0,1,0,0,1
"cg15286601",1,0,0,0,1
"cg15286945",1,0,0,0,1
"cg15287641",0,0,1,0,1
"cg15289658",0,1,0,0,1
"cg15289833",5,0,0,0,5
"cg15290081",1,0,1,0,2
"cg15290857",4,2,0,0,6
"cg15291295",0,0,1,0,1
"cg15291591",0,2,2,0,4
"cg15292688",0,0,1,0,1
"cg15293759",60,8,0,0,68
"cg15295597",0,0,1,0,1
"cg15296154",0,1,0,0,1
"cg15296535",1,5,4,0,10
"cg15296538",0,1,0,0,1
"cg15296766",98,3,0,0,101
"cg15296941",0,0,1,0,1
"cg15297235",26,2,0,0,28
"cg15297727",0,0,1,0,1
"cg15297854",29,2,0,0,31
"cg15299366",23,6,1,0,30
"cg15299512",1,1,0,0,2
"cg15299947",3,0,0,0,3
"cg15302819",0,0,1,0,1
"cg15303841",1,0,1,0,2
"cg15305732",5,0,0,0,5
"cg15306140",0,0,2,0,2
"cg15306779",0,1,0,0,1
"cg15307830",0,0,1,0,1
"cg15309053",6,10,4,5,25
"cg15309232",17,14,2,0,33
"cg15310722",0,1,0,0,1
"cg15310797",0,1,1,0,2
"cg15311083",3,0,0,0,3
"cg15312496",1,0,0,0,1
"cg15312497",7,4,0,0,11
"cg15313325",0,0,1,0,1
"cg15313838",2,0,0,0,2
"cg15313859",5,0,0,0,5
"cg15316090",0,1,0,0,1
"cg15317356",27,17,1,0,45
"cg15319335",10,1,0,0,11
"cg15319412",14,4,0,0,18
"cg15320948",0,0,1,0,1
"cg15321244",0,0,1,0,1
"cg15322174",2,1,0,0,3
"cg15322605",7,0,0,0,7
"cg15323066",285,21,10,0,316
"cg15324580",97,2,0,0,99
"cg15327477",1,0,0,0,1
"cg15327726",16,18,6,0,40
"cg15328060",3,0,0,0,3
"cg15329163",6,0,0,0,6
"cg15329483",1,3,0,0,4
"cg15330178",0,0,1,0,1
"cg15330419",15,9,0,0,24
"cg15331301",0,1,1,0,2
"cg15332812",0,1,0,0,1
"cg15333058",1,0,0,0,1
"cg15333674",2,1,2,0,5
"cg15335046",1,0,0,0,1
"cg15335686",0,1,0,0,1
"cg15335860",0,4,4,0,8
"cg15337017",0,0,2,0,2
"cg15337281",3,2,1,0,6
"cg15337731",0,1,0,0,1
"cg15338041",1,0,0,0,1
"cg15338149",49,29,0,0,78
"cg15338917",0,0,2,0,2
"cg15339616",12,0,0,0,12
"cg15340334",0,1,0,0,1
"cg15340640",0,5,0,0,5
"cg15340709",1,3,0,0,4
"cg15341512",8,0,0,0,8
"cg15342711",0,0,1,0,1
"cg15343992",1,0,0,0,1
"cg15344180",6,0,0,0,6
"cg15345847",0,1,0,0,1
"cg15346242",66,3,0,0,69
"cg15347484",8,3,0,0,11
"cg15349304",0,0,1,0,1
"cg15350099",0,1,0,0,1
"cg15350618",1,1,9,0,11
"cg15351061",0,2,0,0,2
"cg15351697",5,5,0,0,10
"cg15352421",8,1,0,0,9
"cg15353418",2,0,0,0,2
"cg15354540",1086,98,0,0,1184
"cg15354697",3,0,0,0,3
"cg15355089",1,0,0,0,1
"cg15355680",0,1,0,0,1
"cg15356370",0,1,0,0,1
"cg15356647",2,0,0,0,2
"cg15357070",2,1,0,0,3
"cg15358035",3,5,1,0,9
"cg15358235",0,0,1,0,1
"cg15358350",0,0,1,0,1
"cg15358633",0,0,1,0,1
"cg15358846",1,0,0,0,1
"cg15359166",1,0,0,0,1
"cg15360378",0,0,2,0,2
"cg15361237",1,0,0,0,1
"cg15361626",172,31,0,0,203
"cg15363638",0,1,0,0,1
"cg15365536",2,0,0,0,2
"cg15367121",7,0,0,0,7
"cg15367253",3,0,0,0,3
"cg15368868",1,0,1,0,2
"cg15369419",0,1,0,0,1
"cg15371418",2,0,0,0,2
"cg15371497",6,1,0,0,7
"cg15371623",0,1,0,0,1
"cg15372009",32,1,0,0,33
"cg15372814",4,0,0,0,4
"cg15373403",21,52,170,0,243
"cg15373576",0,1,0,0,1
"cg15373590",47,105,740,0,892
"cg15374582",0,1,0,0,1
"cg15375704",0,3,1,0,4
"cg15376677",0,0,1,0,1
"cg15377733",7,0,0,0,7
"cg15378119",1,0,0,0,1
"cg15378445",2,0,0,0,2
"cg15378913",0,0,2,0,2
"cg15379458",0,0,1,0,1
"cg15379511",183,93,0,0,276
"cg15380178",1,0,0,0,1
"cg15380715",29,1,0,0,30
"cg15382095",1,0,0,0,1
"cg15383635",29,0,0,0,29
"cg15383739",0,3,13,0,16
"cg15383811",0,0,2,0,2
"cg15384301",0,0,1,0,1
"cg15385352",0,0,1,0,1
"cg15385397",29,7,0,0,36
"cg15385589",0,0,1,0,1
"cg15386372",0,0,1,0,1
"cg15386877",1,1,0,0,2
"cg15386899",1,1,0,0,2
"cg15387278",0,1,0,0,1
"cg15387567",3,0,0,0,3
"cg15387954",0,0,1,0,1
"cg15388264",0,0,1,0,1
"cg15388641",0,1,0,0,1
"cg15388900",0,0,2,0,2
"cg15389519",0,1,1,0,2
"cg15389629",0,0,1,0,1
"cg15389676",0,1,0,0,1
"cg15390650",0,0,0,1,1
"cg15391307",10,3,0,0,13
"cg15392147",14,4,0,0,18
"cg15392988",0,0,1,0,1
"cg15394130",0,0,1,0,1
"cg15394630",0,0,1,0,1
"cg15395345",1,1,0,0,2
"cg15396462",0,1,0,0,1
"cg15396686",1,0,1,0,2
"cg15396734",0,16,9,0,25
"cg15397231",3,5,1,0,9
"cg15397624",6,0,0,0,6
"cg15398260",3,10,0,0,13
"cg15398272",13,1,0,0,14
"cg15398512",0,1,0,0,1
"cg15399122",20,0,0,0,20
"cg15399720",1,0,0,0,1
"cg15400159",0,1,0,0,1
"cg15400282",9,0,0,0,9
"cg15400593",255,7,0,0,262
"cg15401523",0,2,0,0,2
"cg15401620",198,22,1,0,221
"cg15403616",0,0,4,0,4
"cg15404043",0,0,1,0,1
"cg15404276",0,0,0,1,1
"cg15405002",14,0,0,0,14
"cg15405153",0,0,2,0,2
"cg15405453",0,2,0,0,2
"cg15407528",0,0,1,0,1
"cg15408418",0,0,1,0,1
"cg15408512",0,0,4,0,4
"cg15408839",0,1,0,0,1
"cg15409616",0,0,1,0,1
"cg15411755",5,0,0,0,5
"cg15412228",0,7,0,0,7
"cg15412250",2,2,0,0,4
"cg15412393",0,2,0,0,2
"cg15413009",1,3,7,0,11
"cg15413034",1,0,0,0,1
"cg15413793",0,0,1,0,1
"cg15414657",1,0,0,0,1
"cg15414982",0,0,1,0,1
"cg15415545",0,0,1,0,1
"cg15417549",1,0,0,0,1
"cg15418297",1,7,1,0,9
"cg15419012",1,0,0,0,1
"cg15419054",1,0,0,0,1
"cg15419157",0,1,0,0,1
"cg15419863",1,1,0,0,2
"cg15420515",2,0,0,0,2
"cg15420615",0,0,1,0,1
"cg15421324",0,0,1,0,1
"cg15422439",6,3,0,0,9
"cg15422776",0,0,1,0,1
"cg15423092",0,1,0,0,1
"cg15423197",0,0,1,0,1
"cg15423688",0,1,0,0,1
"cg15424593",7,0,0,0,7
"cg15424856",0,1,0,0,1
"cg15426697",2,1,0,0,3
"cg15427793",0,2,0,0,2
"cg15427939",0,0,1,0,1
"cg15428154",40,38,1,0,79
"cg15428310",1,1,0,0,2
"cg15428436",0,2,1,0,3
"cg15431408",36,2,0,0,38
"cg15432135",2,1,4,0,7
"cg15434886",0,0,1,0,1
"cg15435391",52,3,0,0,55
"cg15435485",4,0,21,0,25
"cg15436451",0,1,0,0,1
"cg15437561",2,0,0,0,2
"cg15437676",0,0,1,0,1
"cg15437692",2,7,12,0,21
"cg15437748",0,0,0,1,1
"cg15438384",0,0,2,0,2
"cg15438774",1,2,0,0,3
"cg15438956",1,0,0,0,1
"cg15439033",1,0,0,0,1
"cg15439119",1,0,0,0,1
"cg15439326",1,0,0,0,1
"cg15441864",2,5,11,0,18
"cg15442155",2,2,2,0,6
"cg15442166",111,12,0,0,123
"cg15442259",0,2,0,1,3
"cg15442389",4,6,0,0,10
"cg15442567",1,0,0,0,1
"cg15444576",0,1,0,0,1
"cg15446613",0,0,1,0,1
"cg15447238",13,0,0,0,13
"cg15447360",172,4,0,0,176
"cg15448780",1,0,0,0,1
"cg15449035",2,0,0,0,2
"cg15449560",0,0,2,0,2
"cg15449914",0,0,1,0,1
"cg15451956",1,1,9,0,11
"cg15453204",1,2,0,0,3
"cg15453396",1,0,0,0,1
"cg15453725",0,0,1,0,1
"cg15455979",0,1,0,0,1
"cg15458055",160,191,4,0,355
"cg15458741",43,0,1,0,44
"cg15459605",3,4,0,0,7
"cg15459913",5,0,0,0,5
"cg15460135",1,0,0,0,1
"cg15460964",1,0,0,0,1
"cg15461550",0,1,0,0,1
"cg15461748",0,0,1,0,1
"cg15462221",0,1,0,0,1
"cg15462332",2,0,0,0,2
"cg15462530",1,0,0,0,1
"cg15462837",2,0,0,0,2
"cg15462844",0,1,0,0,1
"cg15463044",0,1,0,0,1
"cg15463628",5,10,0,0,15
"cg15463964",1,0,1,0,2
"cg15464273",0,2,1,0,3
"cg15464645",0,1,0,0,1
"cg15465107",0,2,2,0,4
"cg15465525",3,0,0,0,3
"cg15465535",1,0,0,0,1
"cg15465581",0,1,15,0,16
"cg15466030",0,1,1,0,2
"cg15466862",1,0,0,0,1
"cg15467307",1,2,0,0,3
"cg15468246",40,4,0,0,44
"cg15469184",0,1,0,0,1
"cg15469704",70,0,0,0,70
"cg15471661",0,0,1,0,1
"cg15472282",32,1,0,0,33
"cg15473066",1,0,0,0,1
"cg15473395",479,24,1,0,504
"cg15474372",1,0,1,0,2
"cg15474859",0,1,0,0,1
"cg15475132",20,3,0,0,23
"cg15475977",0,1,0,0,1
"cg15476267",4,0,0,0,4
"cg15477035",2,0,0,0,2
"cg15477097",0,0,1,0,1
"cg15477570",0,1,0,0,1
"cg15478157",2,6,0,0,8
"cg15478550",0,0,1,0,1
"cg15479572",0,0,1,0,1
"cg15480485",2,0,0,0,2
"cg15480737",19,2,0,0,21
"cg15480962",22,8,0,0,30
"cg15481189",0,0,2,0,2
"cg15481565",0,2,0,0,2
"cg15481819",0,0,14,0,14
"cg15481846",1,0,0,0,1
"cg15481850",0,0,1,0,1
"cg15482082",0,1,1,0,2
"cg15482213",4,0,0,0,4
"cg15482285",5,2,0,0,7
"cg15482861",0,0,1,0,1
"cg15483228",0,1,0,0,1
"cg15483273",1,0,0,0,1
"cg15484375",1,0,0,0,1
"cg15485056",1,1,1,0,3
"cg15485215",0,0,1,0,1
"cg15485820",0,0,0,1,1
"cg15486124",92,18,0,0,110
"cg15486184",0,0,1,0,1
"cg15486197",71,0,0,0,71
"cg15486285",0,0,1,0,1
"cg15486846",1,1,0,0,2
"cg15486854",9,0,0,0,9
"cg15486870",758,530,5,0,1293
"cg15487208",6,0,0,0,6
"cg15488636",6,3,0,0,9
"cg15488986",2,0,0,0,2
"cg15491047",0,1,0,0,1
"cg15491967",0,3,0,0,3
"cg15492306",0,0,2,0,2
"cg15493018",107,714,10,0,831
"cg15493803",0,0,1,0,1
"cg15494379",0,1,1,0,2
"cg15495240",13,3,0,0,16
"cg15495580",0,1,0,0,1
"cg15495901",1,0,0,0,1
"cg15497048",0,1,1,0,2
"cg15497527",26,2,0,0,28
"cg15498563",0,1,0,0,1
"cg15501219",1,1,0,0,2
"cg15502164",17,10,1,0,28
"cg15503766",0,0,2,0,2
"cg15503862",32,13,4,0,49
"cg15504104",3,31,12,0,46
"cg15506126",1,1,0,0,2
"cg15509149",6,2,0,0,8
"cg15510118",0,0,1,0,1
"cg15511232",0,1,0,0,1
"cg15511367",0,0,1,0,1
"cg15511893",18,2,0,0,20
"cg15512101",0,0,1,0,1
"cg15513156",0,0,1,0,1
"cg15513719",0,1,1,0,2
"cg15513957",1,3,1,0,5
"cg15514399",2,0,0,0,2
"cg15515224",1,0,0,0,1
"cg15516283",1,0,0,0,1
"cg15516537",0,0,6,0,6
"cg15517450",1,0,0,0,1
"cg15518979",0,0,1,0,1
"cg15520941",6,1,0,0,7
"cg15521911",0,0,0,1,1
"cg15524239",1,0,0,0,1
"cg15525002",0,1,0,0,1
"cg15526569",5,4,9,0,18
"cg15529290",0,0,1,0,1
"cg15529407",1,0,0,0,1
"cg15529766",278,174,5,0,457
"cg15530658",3,4,1,0,8
"cg15531099",0,1,0,0,1
"cg15531814",18,1,0,0,19
"cg15532522",2,0,0,0,2
"cg15532568",0,1,0,0,1
"cg15533214",0,0,3,0,3
"cg15533646",0,3,1,0,4
"cg15534507",5,1,0,0,6
"cg15535412",0,2,3,0,5
"cg15535638",0,0,3,0,3
"cg15535835",0,1,0,0,1
"cg15536034",0,0,3,0,3
"cg15537158",0,1,1,0,2
"cg15537305",0,0,1,0,1
"cg15537834",4,0,0,0,4
"cg15538177",0,1,0,0,1
"cg15538222",1,0,0,0,1
"cg15540558",1,0,2,0,3
"cg15541008",0,0,1,0,1
"cg15541890",17,1,0,0,18
"cg15542011",1,0,0,0,1
"cg15542144",2,0,0,0,2
"cg15543174",6,5,0,0,11
"cg15543237",0,0,1,0,1
"cg15544184",1,2,4,0,7
"cg15545293",0,1,0,0,1
"cg15545617",0,0,1,0,1
"cg15545685",10,16,0,0,26
"cg15545827",0,1,0,0,1
"cg15547241",2,1,1,0,4
"cg15547657",1,0,0,0,1
"cg15548006",0,1,0,0,1
"cg15548284",86,228,213,0,527
"cg15548446",3,0,0,0,3
"cg15548711",0,0,2,0,2
"cg15550136",0,3,2,0,5
"cg15550260",243,98,4,0,345
"cg15550654",0,1,6,0,7
"cg15551646",1,0,0,0,1
"cg15553474",0,6,3,0,9
"cg15553710",43,18,9,0,70
"cg15553761",5,0,0,0,5
"cg15554214",0,3,4,0,7
"cg15554631",1,0,0,0,1
"cg15555416",3,0,0,0,3
"cg15556090",0,1,0,0,1
"cg15556446",0,6,0,0,6
"cg15556518",62,30,6,0,98
"cg15556689",1,0,1,0,2
"cg15557557",2,0,0,0,2
"cg15558102",0,0,4,0,4
"cg15558527",0,1,0,0,1
"cg15559534",0,1,0,0,1
"cg15559560",0,0,1,0,1
"cg15562947",0,0,1,0,1
"cg15563854",0,0,1,0,1
"cg15564246",0,0,1,0,1
"cg15564405",3,0,0,0,3
"cg15565228",1,1,0,0,2
"cg15565897",3,4,2,0,9
"cg15566393",1,0,0,0,1
"cg15566570",0,0,1,0,1
"cg15566833",0,0,1,0,1
"cg15567045",0,0,0,1,1
"cg15567091",0,0,1,0,1
"cg15567717",197,118,13,0,328
"cg15567848",0,0,1,0,1
"cg15567929",3,3,0,0,6
"cg15568225",0,0,1,0,1
"cg15568701",11,1,0,0,12
"cg15570021",0,0,2,0,2
"cg15570966",0,1,2,0,3
"cg15571814",0,1,0,0,1
"cg15572094",0,1,0,0,1
"cg15572325",73,44,8,0,125
"cg15572557",0,1,0,0,1
"cg15572951",0,0,2,0,2
"cg15574089",0,0,1,0,1
"cg15574137",1,3,0,0,4
"cg15579058",0,0,1,0,1
"cg15581029",8,1,0,0,9
"cg15581032",0,0,1,0,1
"cg15581070",2,0,0,0,2
"cg15581360",0,0,2,0,2
"cg15581794",1,2,1,0,4
"cg15582315",17,35,18,0,70
"cg15582544",0,0,1,0,1
"cg15583564",0,1,0,0,1
"cg15584497",18,0,0,0,18
"cg15586314",0,0,1,0,1
"cg15586779",0,2,0,0,2
"cg15586842",1,0,4,0,5
"cg15587018",17,1,0,0,18
"cg15587683",5,0,0,0,5
"cg15588997",3,4,0,0,7
"cg15589620",0,0,1,0,1
"cg15590056",1,0,0,0,1
"cg15591426",1,0,0,0,1
"cg15591636",0,0,1,0,1
"cg15591699",2,5,0,0,7
"cg15592863",0,0,1,0,1
"cg15595522",1,0,1,0,2
"cg15595599",2,0,0,0,2
"cg15595701",1,12,9,1,23
"cg15595910",0,0,1,0,1
"cg15596301",8,0,0,0,8
"cg15596724",4,0,0,0,4
"cg15596816",0,1,0,0,1
"cg15597147",14,5,1,0,20
"cg15600751",1,0,0,0,1
"cg15601232",30,1,0,0,31
"cg15601719",22,1,0,0,23
"cg15601859",174,5,0,0,179
"cg15602182",9,0,0,0,9
"cg15602764",0,1,0,0,1
"cg15603614",378,481,15,0,874
"cg15603766",0,1,0,0,1
"cg15604170",1,1,5,0,7
"cg15604389",1,4,0,0,5
"cg15604530",1,0,0,0,1
"cg15604999",0,0,2,0,2
"cg15606473",0,0,5,0,5
"cg15607311",1,0,0,0,1
"cg15608151",1,0,0,0,1
"cg15608351",0,0,1,0,1
"cg15608820",1,0,0,0,1
"cg15609812",0,0,2,0,2
"cg15610374",8,1,0,0,9
"cg15611131",5,0,0,0,5
"cg15611243",0,0,1,0,1
"cg15611600",0,0,1,0,1
"cg15611832",0,0,1,0,1
"cg15611936",391,16,0,0,407
"cg15612739",0,0,2,0,2
"cg15613374",2,0,0,0,2
"cg15614438",0,1,0,0,1
"cg15615365",197,9,0,0,206
"cg15615443",1,0,0,0,1
"cg15615706",1,1,0,0,2
"cg15616524",0,1,0,0,1
"cg15616609",0,0,1,0,1
"cg15616641",13,0,0,0,13
"cg15617351",204,321,126,0,651
"cg15618450",28,11,2,0,41
"cg15618871",23,3,0,0,26
"cg15620404",0,1,5,0,6
"cg15620533",0,1,0,0,1
"cg15620694",4,2,0,0,6
"cg15620752",0,1,0,0,1
"cg15621393",0,0,1,0,1
"cg15622155",7,0,0,0,7
"cg15622800",0,0,1,0,1
"cg15623339",28,1,0,0,29
"cg15623444",1,2,2,0,5
"cg15624716",1,0,0,0,1
"cg15625393",0,1,3,0,4
"cg15625697",27,19,2,0,48
"cg15625791",5,1,0,0,6
"cg15627251",1,2,0,0,3
"cg15629893",0,0,1,0,1
"cg15630162",5,0,1,0,6
"cg15630633",3,1,0,0,4
"cg15630841",0,1,0,0,1
"cg15631964",4,3,2,0,9
"cg15632208",0,1,0,0,1
"cg15633052",0,1,0,0,1
"cg15633609",1,1,0,0,2
"cg15633618",33,42,4,0,79
"cg15633893",0,1,0,0,1
"cg15634744",3,0,0,0,3
"cg15635882",0,1,0,0,1
"cg15635890",6,11,12,0,29
"cg15636955",0,0,1,0,1
"cg15637420",0,1,0,0,1
"cg15638483",4,1,1,0,6
"cg15639838",0,0,15,0,15
"cg15641340",0,0,1,0,1
"cg15641789",3,5,0,0,8
"cg15642329",0,10,1,0,11
"cg15642840",4,1,0,0,5
"cg15644308",1,5,0,0,6
"cg15644764",0,0,2,0,2
"cg15644837",7,3,3,0,13
"cg15645254",163,49,4,0,216
"cg15645344",0,0,1,0,1
"cg15645524",2,0,0,0,2
"cg15646411",0,0,1,0,1
"cg15646544",1,0,0,0,1
"cg15646936",0,0,1,0,1
"cg15646967",4,0,0,0,4
"cg15647532",0,0,3,0,3
"cg15648444",80,8,0,0,88
"cg15649111",1,1,0,0,2
"cg15649194",0,0,1,0,1
"cg15649204",1,1,0,0,2
"cg15649208",3,6,1,0,10
"cg15649333",1,0,0,0,1
"cg15652381",0,1,0,0,1
"cg15653614",1,0,0,0,1
"cg15653715",0,0,1,0,1
"cg15653807",16,0,0,0,16
"cg15654027",0,0,1,0,1
"cg15654151",4,2,1,0,7
"cg15654251",0,0,1,0,1
"cg15655154",0,1,0,0,1
"cg15655431",2,0,0,0,2
"cg15655442",6,2,0,0,8
"cg15655885",2,0,0,0,2
"cg15656181",0,1,0,0,1
"cg15656347",0,0,2,0,2
"cg15656470",0,0,1,0,1
"cg15656782",0,3,2,0,5
"cg15657154",17,5,1,0,23
"cg15657330",0,0,1,0,1
"cg15657641",0,1,0,0,1
"cg15658028",3,1,0,0,4
"cg15659358",0,1,1,0,2
"cg15659599",0,0,1,0,1
"cg15660352",0,5,5,0,10
"cg15660431",0,1,0,0,1
"cg15660573",2,0,0,0,2
"cg15660981",0,3,1,0,4
"cg15662822",0,0,1,0,1
"cg15663265",1,0,0,0,1
"cg15665215",1,0,0,0,1
"cg15665326",2,0,0,0,2
"cg15665497",0,0,1,0,1
"cg15665970",1,0,0,0,1
"cg15666326",0,0,1,0,1
"cg15667081",1,0,0,0,1
"cg15667219",0,0,1,0,1
"cg15667735",0,0,1,0,1
"cg15667995",0,0,1,0,1
"cg15668074",0,2,2,0,4
"cg15670034",2,1,1,0,4
"cg15670221",3,6,0,0,9
"cg15672234",0,0,1,0,1
"cg15672543",0,0,1,0,1
"cg15675532",1,0,0,0,1
"cg15676466",1,0,0,0,1
"cg15677023",0,0,1,0,1
"cg15677271",58,12,1,0,71
"cg15677389",1,0,0,0,1
"cg15678169",1,0,1,0,2
"cg15678286",1,0,0,0,1
"cg15678678",0,0,2,0,2
"cg15678724",0,3,0,0,3
"cg15680717",0,1,0,0,1
"cg15681738",0,0,1,0,1
"cg15682099",47,24,1,0,72
"cg15682111",8,6,0,0,14
"cg15682760",6,0,0,0,6
"cg15682806",5,5,1,0,11
"cg15683107",0,0,0,1,1
"cg15683479",0,0,1,0,1
"cg15684015",0,2,0,0,2
"cg15685562",0,2,0,0,2
"cg15686402",1,0,0,0,1
"cg15686762",0,0,1,0,1
"cg15687746",6,4,1,0,11
"cg15689582",4,1,0,0,5
"cg15690511",1,0,0,0,1
"cg15690985",15,8,0,0,23
"cg15691596",3,0,0,0,3
"cg15691702",1,3,2,0,6
"cg15691976",8,13,0,0,21
"cg15692007",19,2,0,0,21
"cg15692837",0,0,0,1,1
"cg15693625",0,0,1,0,1
"cg15693898",1,0,0,0,1
"cg15693944",0,0,1,0,1
"cg15694580",0,1,1,0,2
"cg15695323",0,3,0,0,3
"cg15695371",1,1,0,0,2
"cg15695952",12,2,0,0,14
"cg15696905",5,2,0,0,7
"cg15697201",0,1,0,0,1
"cg15697453",1,3,1,0,5
"cg15697698",0,1,0,0,1
"cg15697793",2,1,0,0,3
"cg15699052",0,1,0,0,1
"cg15699347",0,0,2,0,2
"cg15699853",0,0,1,0,1
"cg15701122",0,0,1,0,1
"cg15701956",1,0,0,0,1
"cg15703165",127,198,0,0,325
"cg15704280",2,3,1,0,6
"cg15705732",0,0,2,0,2
"cg15705885",0,1,0,0,1
"cg15706994",1,0,0,0,1
"cg15707332",0,0,1,0,1
"cg15708011",1,0,0,0,1
"cg15708298",0,1,0,0,1
"cg15708382",226,53,5,0,284
"cg15708909",0,0,1,1,2
"cg15708997",1,1,3,0,5
"cg15709410",105,7,0,0,112
"cg15709503",0,0,1,0,1
"cg15711616",1,0,0,0,1
"cg15711772",187,78,10,0,275
"cg15711973",0,0,1,0,1
"cg15712192",0,1,0,0,1
"cg15712289",0,0,1,0,1
"cg15713058",0,3,0,0,3
"cg15713106",4,21,13,0,38
"cg15713719",2,0,0,0,2
"cg15713739",0,1,0,0,1
"cg15714611",0,0,1,0,1
"cg15714741",4,0,0,0,4
"cg15715505",2,1,0,0,3
"cg15716373",0,0,1,0,1
"cg15716479",4,16,0,0,20
"cg15717258",4,9,3,0,16
"cg15718106",276,240,35,0,551
"cg15718827",82,8,0,0,90
"cg15719326",12,6,1,0,19
"cg15720267",300,225,8,0,533
"cg15720491",0,0,2,0,2
"cg15720498",48,5,0,0,53
"cg15720516",1,0,0,0,1
"cg15721293",1,0,0,0,1
"cg15721439",0,0,1,0,1
"cg15722265",0,1,2,0,3
"cg15722395",2,0,0,0,2
"cg15722679",0,1,0,0,1
"cg15723066",1,0,0,0,1
"cg15723451",2,0,0,0,2
"cg15723951",0,1,0,0,1
"cg15724941",222,19,2,0,243
"cg15725883",0,0,1,1,2
"cg15726141",0,1,1,0,2
"cg15726387",476,37,0,0,513
"cg15727009",8,0,0,0,8
"cg15727157",0,1,0,0,1
"cg15727171",1,0,1,0,2
"cg15728549",1,0,0,0,1
"cg15729687",1,0,3,0,4
"cg15729977",107,55,4,0,166
"cg15730546",2,1,0,0,3
"cg15731494",0,2,0,0,2
"cg15731991",0,0,1,0,1
"cg15732221",1,7,6,0,14
"cg15732422",19,3,0,0,22
"cg15733611",1,0,0,0,1
"cg15733632",96,9,0,0,105
"cg15733658",4,1,0,0,5
"cg15734094",0,1,0,0,1
"cg15734825",1,1,0,0,2
"cg15736254",0,2,0,0,2
"cg15736306",31,3,0,0,34
"cg15736378",2,0,0,0,2
"cg15736767",0,0,1,0,1
"cg15737048",0,0,1,0,1
"cg15737324",5,1,0,0,6
"cg15737365",0,0,1,0,1
"cg15737458",0,0,1,0,1
"cg15739206",0,0,3,0,3
"cg15740548",0,1,0,0,1
"cg15740891",0,0,1,0,1
"cg15742622",5,2,3,0,10
"cg15742751",0,1,0,0,1
"cg15744026",7,7,1,0,15
"cg15744869",9,0,0,0,9
"cg15745329",8,2,3,0,13
"cg15745973",0,0,1,0,1
"cg15746003",7,0,0,0,7
"cg15747110",1,0,0,0,1
"cg15748407",1,5,2,0,8
"cg15749141",408,27,3,0,438
"cg15749260",0,0,1,0,1
"cg15753593",0,1,0,0,1
"cg15754558",1,0,0,0,1
"cg15754755",0,0,14,0,14
"cg15755092",2,1,0,0,3
"cg15755876",2,0,0,0,2
"cg15756407",0,0,1,0,1
"cg15756570",1,0,0,0,1
"cg15756630",5,0,0,0,5
"cg15756839",1,0,0,0,1
"cg15757342",12,1,0,0,13
"cg15757802",1,2,0,0,3
"cg15758255",5,3,0,0,8
"cg15758403",128,28,0,0,156
"cg15758480",5,0,0,0,5
"cg15759112",1,0,0,0,1
"cg15759937",1,0,0,0,1
"cg15760052",13,12,1,0,26
"cg15760952",1,0,0,0,1
"cg15761173",1,0,0,0,1
"cg15761251",2,2,15,0,19
"cg15763252",40,103,3,0,146
"cg15763627",0,1,0,0,1
"cg15765160",4,1,1,0,6
"cg15765345",0,1,0,0,1
"cg15765459",1,0,0,0,1
"cg15765885",0,0,4,0,4
"cg15766011",9,3,0,0,12
"cg15766041",1,0,0,0,1
"cg15766324",39,3,0,0,42
"cg15766897",0,2,0,0,2
"cg15767947",0,5,7,0,12
"cg15768526",0,1,0,0,1
"cg15768650",5,1,0,0,6
"cg15769069",0,1,0,0,1
"cg15770687",0,0,1,0,1
"cg15770862",13,27,1,0,41
"cg15771511",16,5,3,0,24
"cg15771579",18,3,0,0,21
"cg15771659",5,0,0,0,5
"cg15772361",0,0,1,0,1
"cg15773148",1,0,2,0,3
"cg15773338",0,0,2,0,2
"cg15774040",3,0,2,0,5
"cg15774124",9,7,4,0,20
"cg15774437",361,147,3,0,511
"cg15774489",0,1,0,0,1
"cg15776028",0,0,4,0,4
"cg15776915",54,1,0,0,55
"cg15778059",0,0,1,0,1
"cg15779295",2,0,0,0,2
"cg15779702",0,0,2,0,2
"cg15779865",2,1,4,0,7
"cg15780140",0,0,1,0,1
"cg15781156",0,0,1,0,1
"cg15781794",1,0,0,0,1
"cg15781823",0,0,1,0,1
"cg15782267",0,1,0,0,1
"cg15782561",1,0,0,0,1
"cg15783441",1,0,0,0,1
"cg15784166",0,0,1,0,1
"cg15784521",1,4,0,0,5
"cg15786022",400,34,12,0,446
"cg15786439",563,1050,45,0,1658
"cg15786732",111,269,9,0,389
"cg15787090",0,0,1,0,1
"cg15788580",0,1,0,0,1
"cg15788639",1,1,0,0,2
"cg15790214",1,0,0,0,1
"cg15790457",1,0,0,0,1
"cg15790692",102,7,1,0,110
"cg15791349",0,0,1,0,1
"cg15792688",1,0,1,0,2
"cg15793774",3,0,0,0,3
"cg15794453",0,1,0,0,1
"cg15795819",1,0,0,0,1
"cg15796926",0,1,0,0,1
"cg15797011",0,0,1,1,2
"cg15797175",140,8,0,0,148
"cg15797180",183,164,13,0,360
"cg15797683",0,1,0,0,1
"cg15798221",0,0,1,0,1
"cg15798321",0,1,1,0,2
"cg15798516",0,5,1,0,6
"cg15798862",0,1,0,0,1
"cg15799813",0,0,1,0,1
"cg15800528",0,0,3,0,3
"cg15802091",1,0,0,0,1
"cg15802569",4,0,0,0,4
"cg15805933",0,0,1,0,1
"cg15806271",0,2,1,0,3
"cg15807288",0,1,0,0,1
"cg15808082",7,8,2,0,17
"cg15810027",1,0,0,0,1
"cg15810474",0,0,8,0,8
"cg15810754",1,0,0,0,1
"cg15812046",1,0,0,0,1
"cg15812177",0,0,3,0,3
"cg15812494",2,1,10,0,13
"cg15812873",0,0,1,0,1
"cg15814092",202,394,59,0,655
"cg15815117",6,2,0,0,8
"cg15815206",1,0,0,0,1
"cg15815767",0,0,1,0,1
"cg15816012",0,0,1,0,1
"cg15817406",3,1,1,0,5
"cg15818208",7,4,0,0,11
"cg15818604",0,0,1,0,1
"cg15818905",1,0,0,0,1
"cg15819955",0,0,1,0,1
"cg15820138",0,1,0,0,1
"cg15820610",5,4,0,0,9
"cg15820868",1,0,0,0,1
"cg15821230",120,5,0,0,125
"cg15821620",1,0,0,0,1
"cg15821730",65,5,0,0,70
"cg15822010",1,2,0,0,3
"cg15822015",0,0,0,16,16
"cg15822117",0,0,1,0,1
"cg15822157",18,8,0,0,26
"cg15822259",0,0,1,0,1
"cg15822321",2,0,0,0,2
"cg15822622",0,0,3,0,3
"cg15823729",2,0,0,0,2
"cg15823956",0,1,0,0,1
"cg15824080",0,1,0,0,1
"cg15824108",50,1,0,0,51
"cg15824696",2,1,0,0,3
"cg15824707",0,0,1,0,1
"cg15824873",0,0,2,0,2
"cg15825417",0,0,2,0,2
"cg15825617",1,0,0,0,1
"cg15825928",1,0,1,0,2
"cg15827606",0,0,1,0,1
"cg15827622",0,0,1,0,1
"cg15828044",1,0,0,0,1
"cg15829073",1,0,0,0,1
"cg15830449",19,7,0,0,26
"cg15830572",0,0,1,0,1
"cg15830792",1,0,0,0,1
"cg15831722",1,0,0,0,1
"cg15831820",0,1,2,0,3
"cg15832180",0,2,1,0,3
"cg15832905",0,0,1,0,1
"cg15834952",1,0,0,0,1
"cg15835091",2,8,19,0,29
"cg15835988",0,2,0,0,2
"cg15836505",1,0,0,0,1
"cg15836599",0,1,1,0,2
"cg15837508",1,0,1,0,2
"cg15838332",8,1,0,0,9
"cg15838555",5,1,0,0,6
"cg15839376",0,0,1,0,1
"cg15839482",4,8,10,0,22
"cg15840018",0,0,1,0,1
"cg15840758",0,1,0,0,1
"cg15841511",6,0,0,0,6
"cg15841606",1,0,0,0,1
"cg15842359",2,0,0,0,2
"cg15842431",23,1,0,0,24
"cg15842559",82,0,0,0,82
"cg15843278",0,1,0,0,1
"cg15843496",0,0,4,0,4
"cg15843977",439,74,0,0,513
"cg15844647",0,1,0,0,1
"cg15845214",0,3,0,0,3
"cg15845998",0,0,1,0,1
"cg15846440",2,0,0,0,2
"cg15846771",1,0,0,0,1
"cg15847431",7,0,0,0,7
"cg15847525",0,3,0,0,3
"cg15847775",396,50,0,0,446
"cg15847936",2,0,1,0,3
"cg15848236",1,0,0,0,1
"cg15849038",1,0,1,0,2
"cg15849943",1,0,0,0,1
"cg15850023",1,0,0,0,1
"cg15850557",1,0,0,0,1
"cg15850684",0,0,4,0,4
"cg15850739",0,5,3,0,8
"cg15851531",0,1,0,0,1
"cg15852028",0,0,1,0,1
"cg15852312",0,0,1,0,1
"cg15853023",1,1,0,0,2
"cg15853350",0,0,6,0,6
"cg15853942",5,0,1,0,6
"cg15854242",2,0,0,0,2
"cg15854662",8,1,0,0,9
"cg15855401",26,9,0,0,35
"cg15856195",125,349,8,0,482
"cg15858440",0,0,1,0,1
"cg15859320",16,3,2,0,21
"cg15859350",0,0,1,0,1
"cg15859995",0,0,1,0,1
"cg15861357",0,0,2,0,2
"cg15861885",1,0,1,0,2
"cg15863751",7,1,0,0,8
"cg15864074",0,0,1,0,1
"cg15864317",0,1,0,0,1
"cg15866416",0,2,0,0,2
"cg15866584",202,44,0,0,246
"cg15868426",0,0,0,1,1
"cg15869396",174,7,0,0,181
"cg15870739",3,0,0,0,3
"cg15870894",0,1,0,0,1
"cg15871156",1,0,0,0,1
"cg15871531",0,1,0,0,1
"cg15871544",0,0,1,0,1
"cg15874144",252,161,6,0,419
"cg15874657",10,5,0,0,15
"cg15875806",1,0,0,0,1
"cg15875875",539,991,18,0,1548
"cg15876735",0,0,1,0,1
"cg15877124",0,1,2,0,3
"cg15877140",0,0,0,1,1
"cg15877431",1,0,0,0,1
"cg15880498",124,8,0,0,132
"cg15880501",0,1,0,0,1
"cg15880945",0,0,1,0,1
"cg15881503",1,0,0,0,1
"cg15881848",1,1,0,0,2
"cg15882280",2,0,0,0,2
"cg15882418",1,0,0,0,1
"cg15882762",1,0,0,0,1
"cg15883249",4,0,0,0,4
"cg15883417",2,1,0,0,3
"cg15884139",0,1,0,0,1
"cg15884874",0,0,1,0,1
"cg15885337",0,0,1,0,1
"cg15885495",1,0,0,0,1
"cg15885775",1,1,3,0,5
"cg15886060",0,0,1,0,1
"cg15886294",0,1,0,0,1
"cg15886896",1,1,1,0,3
"cg15886919",0,1,0,0,1
"cg15888496",0,1,0,0,1
"cg15888849",1,2,1,0,4
"cg15888936",4,1,0,0,5
"cg15889156",0,3,3,0,6
"cg15889649",0,3,0,0,3
"cg15889771",2,0,0,0,2
"cg15890734",0,2,0,0,2
"cg15891076",0,0,1,0,1
"cg15893396",515,34,0,0,549
"cg15894707",0,0,1,0,1
"cg15895124",1,0,0,0,1
"cg15895329",0,1,0,0,1
"cg15896056",1,0,0,0,1
"cg15896182",0,0,1,0,1
"cg15897435",0,1,0,0,1
"cg15897600",13,1,0,0,14
"cg15898026",0,0,1,0,1
"cg15898604",8,4,1,0,13
"cg15898904",1,0,0,0,1
"cg15899043",0,0,1,0,1
"cg15900868",6,3,1,0,10
"cg15901261",2,0,0,0,2
"cg15901455",1,0,0,0,1
"cg15902089",1,0,0,0,1
"cg15902329",3,1,1,0,5
"cg15903280",0,0,1,0,1
"cg15903595",9,1,0,0,10
"cg15903767",0,0,1,0,1
"cg15903953",1,1,2,1,5
"cg15903974",3,3,0,0,6
"cg15904396",2,0,2,0,4
"cg15905820",0,0,1,0,1
"cg15906515",1,0,0,0,1
"cg15907146",0,0,2,0,2
"cg15907867",1,0,0,0,1
"cg15908093",0,1,0,0,1
"cg15908853",250,37,0,0,287
"cg15908909",1,12,17,0,30
"cg15909393",0,0,1,0,1
"cg15910614",0,1,0,0,1
"cg15912014",1,3,0,0,4
"cg15912113",3,0,0,0,3
"cg15914485",2,0,6,0,8
"cg15915427",0,1,0,0,1
"cg15916107",1,0,0,0,1
"cg15917722",0,1,0,0,1
"cg15918701",1,0,0,0,1
"cg15920202",0,0,1,0,1
"cg15921012",5,0,0,0,5
"cg15921076",0,3,3,0,6
"cg15921436",0,0,1,0,1
"cg15922080",1,0,0,0,1
"cg15922368",0,0,1,0,1
"cg15923484",0,0,1,0,1
"cg15924397",1,1,0,0,2
"cg15924457",0,0,1,0,1
"cg15925143",1,3,1,0,5
"cg15926221",5,3,1,0,9
"cg15928086",1,0,0,0,1
"cg15928459",1,0,0,0,1
"cg15928956",0,0,1,0,1
"cg15929241",1,2,0,0,3
"cg15929556",7,2,1,0,10
"cg15931564",3,0,0,0,3
"cg15932122",0,0,1,0,1
"cg15933514",0,0,6,0,6
"cg15933869",0,1,0,0,1
"cg15934100",26,4,0,0,30
"cg15935736",0,0,1,0,1
"cg15935877",0,7,1,0,8
"cg15936544",0,0,3,0,3
"cg15936731",2,0,0,0,2
"cg15939182",400,415,11,0,826
"cg15939255",1,1,0,0,2
"cg15939408",6,0,0,0,6
"cg15941164",1,0,0,0,1
"cg15941465",91,722,7,0,820
"cg15941800",55,15,0,0,70
"cg15941945",0,1,0,0,1
"cg15942579",0,0,1,0,1
"cg15943093",0,0,1,0,1
"cg15943645",15,2,0,0,17
"cg15943866",8,0,6,0,14
"cg15944727",13,0,0,0,13
"cg15944785",0,0,1,0,1
"cg15945209",2,0,0,0,2
"cg15945262",0,1,0,0,1
"cg15947007",0,1,0,0,1
"cg15947283",0,0,2,0,2
"cg15947367",43,1,0,0,44
"cg15947466",7,1,0,0,8
"cg15947658",8,0,0,0,8
"cg15947866",0,0,1,0,1
"cg15947977",4,15,6,0,25
"cg15948012",0,0,1,0,1
"cg15948245",1,0,0,0,1
"cg15948567",0,1,0,0,1
"cg15948859",0,0,2,0,2
"cg15948916",1,0,0,0,1
"cg15949910",0,1,0,0,1
"cg15950487",1,0,0,0,1
"cg15950861",0,1,1,0,2
"cg15950936",1,1,1,0,3
"cg15951041",7,0,0,0,7
"cg15951280",0,1,3,0,4
"cg15951798",0,0,15,0,15
"cg15952933",1,0,0,0,1
"cg15953393",1,0,0,0,1
"cg15953616",0,1,0,0,1
"cg15954245",21,2,0,0,23
"cg15954333",2,4,12,3,21
"cg15956162",0,0,1,0,1
"cg15956716",0,0,1,0,1
"cg15956890",1,0,0,0,1
"cg15957461",0,2,0,0,2
"cg15959642",1,2,0,0,3
"cg15960535",1,0,1,0,2
"cg15960967",3,1,0,0,4
"cg15961473",0,2,0,0,2
"cg15962031",1,1,0,0,2
"cg15962715",3,0,0,0,3
"cg15963237",0,0,1,0,1
"cg15963484",2,0,0,0,2
"cg15964159",0,1,0,0,1
"cg15965155",746,48,0,0,794
"cg15965241",0,1,0,0,1
"cg15965422",13,7,0,0,20
"cg15965675",25,12,4,0,41
"cg15966701",38,27,6,0,71
"cg15967111",0,1,2,0,3
"cg15967326",7,0,0,0,7
"cg15967592",0,1,0,0,1
"cg15969606",0,0,1,0,1
"cg15969890",0,0,1,0,1
"cg15969902",0,0,1,0,1
"cg15970415",0,0,1,0,1
"cg15970593",0,1,0,0,1
"cg15970860",407,218,1,0,626
"cg15971335",0,0,1,0,1
"cg15971499",8,12,5,0,25
"cg15971800",0,1,0,0,1
"cg15972822",0,1,0,0,1
"cg15973171",1,0,0,0,1
"cg15974579",0,0,0,1,1
"cg15975122",0,0,3,0,3
"cg15976589",1,0,0,0,1
"cg15977280",0,0,1,0,1
"cg15977424",2,0,0,0,2
"cg15977813",0,3,0,0,3
"cg15978191",21,1,0,0,22
"cg15978461",1,0,0,0,1
"cg15978815",0,1,0,0,1
"cg15978928",0,0,1,0,1
"cg15979097",7,0,0,0,7
"cg15979146",351,46,0,0,397
"cg15980277",0,0,2,0,2
"cg15980334",0,1,0,0,1
"cg15980363",0,0,1,0,1
"cg15981052",2,0,0,0,2
"cg15981554",0,0,2,0,2
"cg15981671",0,1,0,0,1
"cg15982613",0,1,0,0,1
"cg15983005",0,2,0,0,2
"cg15985253",0,0,1,0,1
"cg15985284",2,2,4,0,8
"cg15985338",1,4,0,0,5
"cg15986429",0,1,0,0,1
"cg15986787",0,0,1,0,1
"cg15988605",4,8,2,0,14
"cg15988795",18,3,0,0,21
"cg15988897",1,0,0,0,1
"cg15988917",1,0,0,0,1
"cg15989267",0,0,1,0,1
"cg15989433",0,1,2,0,3
"cg15990008",0,0,1,0,1
"cg15990456",1,0,0,0,1
"cg15990679",258,157,5,0,420
"cg15991174",0,1,0,0,1
"cg15991478",6,1,0,0,7
"cg15992710",8,2,0,0,10
"cg15992711",57,3,0,0,60
"cg15992843",820,33,0,0,853
"cg15992975",1,0,0,0,1
"cg15993871",137,27,6,0,170
"cg15994267",0,3,0,0,3
"cg15996051",0,2,0,0,2
"cg15996647",9,8,1,0,18
"cg15997204",0,1,0,0,1
"cg15997770",0,0,1,0,1
"cg15997880",1,1,0,0,2
"cg15998547",4,0,0,0,4
"cg15999609",0,0,1,0,1
"cg15999899",0,0,1,0,1
"cg16000253",0,1,0,0,1
"cg16000406",0,2,0,0,2
"cg16000666",0,2,18,0,20
"cg16000682",66,29,0,0,95
"cg16000749",1,1,0,0,2
"cg16000954",1,0,0,0,1
"cg16001236",3,0,0,0,3
"cg16002248",0,0,1,0,1
"cg16002523",0,0,3,0,3
"cg16003712",1,0,0,0,1
"cg16003857",2,1,0,0,3
"cg16004059",15,4,0,0,19
"cg16006296",15,18,5,0,38
"cg16006396",2,2,0,0,4
"cg16007189",102,193,5,0,300
"cg16007669",0,0,7,0,7
"cg16008273",0,3,1,1,5
"cg16008457",0,0,1,0,1
"cg16008512",0,0,1,0,1
"cg16009677",72,37,3,0,112
"cg16010111",0,0,1,0,1
"cg16010427",0,1,0,0,1
"cg16011594",424,324,15,0,763
"cg16011904",1,0,0,0,1
"cg16012489",1,0,0,0,1
"cg16012528",0,1,0,0,1
"cg16013142",5,0,0,0,5
"cg16013630",5,9,0,0,14
"cg16014492",1,0,0,0,1
"cg16014551",2,0,0,0,2
"cg16014901",0,0,1,0,1
"cg16015139",0,1,0,0,1
"cg16016710",0,0,1,0,1
"cg16016766",1,0,1,0,2
"cg16017492",4,0,0,0,4
"cg16017681",0,1,0,0,1
"cg16018455",0,0,1,0,1
"cg16018664",5,1,1,0,7
"cg16019005",0,1,0,0,1
"cg16019477",1,0,1,0,2
"cg16019652",1,2,0,0,3
"cg16019856",1,0,0,0,1
"cg16021165",0,0,2,0,2
"cg16021498",0,3,1,0,4
"cg16021903",1,0,0,0,1
"cg16022266",0,0,1,0,1
"cg16023106",0,1,0,0,1
"cg16023107",1,1,0,0,2
"cg16023244",0,2,0,0,2
"cg16023283",1,0,0,0,1
"cg16023355",1,0,0,0,1
"cg16023400",2,0,0,0,2
"cg16023693",0,1,0,0,1
"cg16024981",0,0,1,0,1
"cg16025149",4,0,0,0,4
"cg16026005",0,0,1,0,1
"cg16026035",0,1,0,0,1
"cg16026647",1,0,0,0,1
"cg16026862",1,0,0,0,1
"cg16027728",6,2,0,0,8
"cg16027949",0,1,2,1,4
"cg16030694",2,0,0,0,2
"cg16030999",2,0,0,0,2
"cg16031136",784,67,2,0,853
"cg16031973",1,0,0,0,1
"cg16033274",5,0,0,0,5
"cg16033857",0,1,0,0,1
"cg16034336",1,0,0,0,1
"cg16035002",401,274,4,0,679
"cg16035024",178,102,6,0,286
"cg16036450",5,0,0,0,5
"cg16038219",46,47,2,0,95
"cg16038590",8,3,5,0,16
"cg16039113",1,0,0,0,1
"cg16039374",2,2,6,0,10
"cg16039724",0,0,1,0,1
"cg16040094",11,14,2,0,27
"cg16040385",337,969,87,0,1393
"cg16041511",0,0,1,0,1
"cg16041602",6,1,14,0,21
"cg16042178",1,0,0,0,1
"cg16043230",1,0,0,0,1
"cg16043879",1,0,1,0,2
"cg16045340",5,0,0,0,5
"cg16045911",0,0,1,0,1
"cg16047405",0,1,0,0,1
"cg16047670",0,1,0,0,1
"cg16048001",0,0,0,1,1
"cg16048251",0,1,0,0,1
"cg16051154",0,2,0,0,2
"cg16051363",2,0,0,0,2
"cg16051742",5,5,0,0,10
"cg16052068",3,0,0,0,3
"cg16053224",0,0,1,0,1
"cg16053674",0,0,1,0,1
"cg16054253",4,0,0,0,4
"cg16055719",0,0,1,0,1
"cg16056753",0,1,1,0,2
"cg16056849",0,2,0,0,2
"cg16056900",3,0,0,0,3
"cg16058452",4,0,0,0,4
"cg16059092",105,44,1,0,150
"cg16059755",0,1,0,0,1
"cg16060557",0,2,2,0,4
"cg16060593",14,0,0,0,14
"cg16060721",3,2,0,0,5
"cg16061177",24,0,0,0,24
"cg16061777",1,0,0,0,1
"cg16061953",1,1,0,0,2
"cg16062733",1,1,0,0,2
"cg16064586",0,0,2,0,2
"cg16064679",0,2,0,0,2
"cg16066221",0,1,0,0,1
"cg16066505",50,7,0,0,57
"cg16066661",0,0,11,0,11
"cg16067453",133,76,19,0,228
"cg16067536",9,2,0,0,11
"cg16067752",0,1,2,0,3
"cg16067879",0,0,1,0,1
"cg16068096",0,0,2,0,2
"cg16068199",11,0,0,0,11
"cg16068514",0,0,1,0,1
"cg16069936",1,0,0,0,1
"cg16070110",2,0,0,0,2
"cg16071319",0,1,1,0,2
"cg16072374",301,179,19,0,499
"cg16072655",0,0,1,0,1
"cg16072780",7,0,0,0,7
"cg16073309",1,0,0,0,1
"cg16073549",2,0,0,0,2
"cg16076569",0,1,0,0,1
"cg16077042",2,0,0,0,2
"cg16078685",0,0,1,0,1
"cg16078938",0,1,1,0,2
"cg16079268",0,0,2,0,2
"cg16079698",1,0,0,0,1
"cg16080015",0,2,1,0,3
"cg16080333",0,0,2,0,2
"cg16081737",0,0,1,0,1
"cg16082566",1,1,0,0,2
"cg16083082",0,1,0,0,1
"cg16083149",0,1,0,0,1
"cg16083334",1,0,0,0,1
"cg16084090",1,0,0,0,1
"cg16085667",0,1,0,0,1
"cg16086098",13,4,1,0,18
"cg16086286",0,1,0,0,1
"cg16087328",4,4,1,0,9
"cg16087684",2,1,0,0,3
"cg16087947",0,1,0,0,1
"cg16089242",3,3,16,0,22
"cg16090541",0,0,1,0,1
"cg16091055",1,0,0,0,1
"cg16091652",8,0,0,0,8
"cg16092135",4,5,1,0,10
"cg16092285",1,1,0,0,2
"cg16093951",0,0,1,0,1
"cg16094155",40,4,0,0,44
"cg16094815",44,32,5,0,81
"cg16095922",1,0,0,0,1
"cg16096569",5,3,0,0,8
"cg16096836",1,0,0,0,1
"cg16097355",0,0,1,0,1
"cg16097834",1,0,0,0,1
"cg16097850",0,1,1,0,2
"cg16098227",0,1,0,0,1
"cg16098344",0,0,1,0,1
"cg16098874",0,0,1,0,1
"cg16098957",266,271,12,0,549
"cg16099023",0,3,0,0,3
"cg16101742",18,5,0,0,23
"cg16103941",1,0,0,0,1
"cg16103996",203,72,2,0,277
"cg16105080",172,34,0,0,206
"cg16105258",1,1,0,0,2
"cg16105309",0,2,0,0,2
"cg16105754",0,1,0,0,1
"cg16105870",0,2,0,0,2
"cg16107025",0,0,1,0,1
"cg16108090",1,1,0,0,2
"cg16108237",0,0,7,0,7
"cg16109297",0,0,1,0,1
"cg16109647",0,1,2,0,3
"cg16109682",3,0,1,0,4
"cg16109994",0,0,1,0,1
"cg16110087",1,0,0,0,1
"cg16110821",2,0,0,0,2
"cg16110924",0,0,2,0,2
"cg16111247",0,1,0,0,1
"cg16112904",47,1,0,0,48
"cg16113483",1,0,0,0,1
"cg16115015",499,19,0,0,518
"cg16115249",0,1,0,0,1
"cg16115418",0,4,0,0,4
"cg16116239",1,0,0,0,1
"cg16116663",10,1,0,0,11
"cg16117938",359,65,4,0,428
"cg16118817",0,0,3,0,3
"cg16119448",563,102,3,0,668
"cg16122106",3,0,1,0,4
"cg16122682",0,0,1,0,1
"cg16123195",0,0,4,0,4
"cg16123319",1,0,0,0,1
"cg16123503",506,240,5,0,751
"cg16123876",0,1,0,0,1
"cg16124981",0,1,0,0,1
"cg16125889",0,1,0,0,1
"cg16126058",0,0,1,0,1
"cg16126312",0,1,13,0,14
"cg16127868",0,1,0,0,1
"cg16129977",9,1,0,0,10
"cg16130508",0,1,0,0,1
"cg16131044",1,0,0,0,1
"cg16131578",46,6,0,0,52
"cg16131866",2,0,0,0,2
"cg16132580",16,2,1,0,19
"cg16133033",0,0,1,0,1
"cg16133341",2,1,0,0,3
"cg16134183",1,0,0,0,1
"cg16134501",198,565,18,0,781
"cg16134678",0,0,1,0,1
"cg16135093",3,6,10,3,22
"cg16136096",3,0,0,0,3
"cg16136467",0,1,0,0,1
"cg16136800",1,0,0,0,1
"cg16137792",0,0,4,0,4
"cg16138163",0,0,1,0,1
"cg16138787",2,1,0,0,3
"cg16139002",4,0,0,0,4
"cg16139006",0,0,1,0,1
"cg16140528",1,0,0,0,1
"cg16141378",1,6,1,0,8
"cg16141740",1,0,0,0,1
"cg16142484",3,2,0,0,5
"cg16142761",0,1,0,0,1
"cg16143559",1,0,1,0,2
"cg16143654",4,2,0,0,6
"cg16144334",0,0,10,0,10
"cg16145235",2,8,0,0,10
"cg16145294",0,0,3,0,3
"cg16145428",28,3,0,0,31
"cg16146186",0,1,0,0,1
"cg16147305",0,0,2,0,2
"cg16147544",1,1,0,0,2
"cg16147838",3,11,2,0,16
"cg16148532",2,0,0,0,2
"cg16149129",0,0,1,0,1
"cg16149247",30,3,0,0,33
"cg16149574",0,1,0,0,1
"cg16149827",135,7,0,0,142
"cg16150713",0,0,1,0,1
"cg16151671",0,0,3,0,3
"cg16151733",0,0,4,0,4
"cg16153232",98,1,0,0,99
"cg16153267",1,3,1,0,5
"cg16153388",0,2,0,0,2
"cg16154511",0,0,1,0,1
"cg16155807",1,9,3,0,13
"cg16156238",1,0,0,0,1
"cg16156283",0,0,2,0,2
"cg16157055",9,5,0,0,14
"cg16158045",0,1,0,0,1
"cg16159481",0,1,0,0,1
"cg16161715",0,0,3,0,3
"cg16161956",0,0,1,0,1
"cg16162018",0,1,0,0,1
"cg16162883",1,2,0,0,3
"cg16162899",0,4,1,0,5
"cg16164594",1,0,0,0,1
"cg16165170",0,1,0,0,1
"cg16165967",0,0,1,0,1
"cg16166262",694,315,5,0,1014
"cg16166745",0,1,0,0,1
"cg16167088",0,1,0,0,1
"cg16169544",0,0,1,0,1
"cg16170270",1,0,0,0,1
"cg16170561",24,13,10,0,47
"cg16171213",3,1,0,0,4
"cg16172031",8,4,0,0,12
"cg16172249",1,0,0,0,1
"cg16173517",1,0,0,0,1
"cg16174071",1,0,4,0,5
"cg16174601",0,0,1,0,1
"cg16175577",0,1,0,0,1
"cg16175737",156,105,51,0,312
"cg16176120",0,0,1,0,1
"cg16176437",0,0,1,0,1
"cg16177314",1,0,1,0,2
"cg16177714",0,3,1,0,4
"cg16177738",3,0,0,0,3
"cg16179740",9,6,1,0,16
"cg16180663",1,0,0,0,1
"cg16180848",0,11,5,0,16
"cg16181043",0,2,2,0,4
"cg16181447",1,0,0,0,1
"cg16183081",1,0,0,0,1
"cg16183495",0,0,2,0,2
"cg16183572",0,0,1,0,1
"cg16184346",4,1,0,0,5
"cg16184750",1,2,0,0,3
"cg16184818",0,0,2,0,2
"cg16185344",2,2,0,0,4
"cg16186135",1,0,1,0,2
"cg16189537",42,2,0,0,44
"cg16191050",2,4,0,0,6
"cg16191477",23,10,0,0,33
"cg16192575",0,2,0,0,2
"cg16193066",0,1,0,0,1
"cg16194563",0,1,0,0,1
"cg16195157",0,0,1,0,1
"cg16196559",8,2,0,0,10
"cg16196850",1,0,0,0,1
"cg16197202",0,1,0,0,1
"cg16197388",0,2,1,0,3
"cg16197772",0,0,1,0,1
"cg16197948",0,1,0,0,1
"cg16198129",188,135,15,0,338
"cg16198417",90,15,0,0,105
"cg16199850",1,0,1,0,2
"cg16199859",2,2,1,0,5
"cg16200068",270,236,37,0,543
"cg16201044",0,0,2,0,2
"cg16201095",1,8,1,0,10
"cg16201596",1,1,0,0,2
"cg16201634",1,0,0,0,1
"cg16201899",0,0,1,0,1
"cg16202017",0,0,1,0,1
"cg16202774",8,18,7,0,33
"cg16202996",0,1,0,0,1
"cg16203210",0,0,1,0,1
"cg16203549",0,1,0,0,1
"cg16204151",1,0,0,0,1
"cg16204476",0,0,6,0,6
"cg16205163",165,3,0,0,168
"cg16205214",0,0,1,0,1
"cg16205225",4,0,0,0,4
"cg16205367",3,3,0,0,6
"cg16207305",6,1,0,0,7
"cg16207408",90,1,0,0,91
"cg16207593",0,0,1,0,1
"cg16210621",0,0,1,0,1
"cg16210706",5,0,0,0,5
"cg16210833",1,0,0,0,1
"cg16210953",0,0,2,0,2
"cg16211873",15,2,0,0,17
"cg16211959",0,0,12,0,12
"cg16214245",0,0,1,0,1
"cg16215770",3,0,0,0,3
"cg16215983",0,0,2,0,2
"cg16215995",0,1,0,0,1
"cg16216570",0,0,2,0,2
"cg16218221",0,0,1,0,1
"cg16218302",219,72,3,0,294
"cg16218337",5,0,0,0,5
"cg16219122",7,3,0,0,10
"cg16219815",3,1,1,0,5
"cg16219879",0,0,1,0,1
"cg16220844",1,0,0,0,1
"cg16221240",0,1,1,0,2
"cg16221704",0,1,0,0,1
"cg16223220",1,0,0,0,1
"cg16224337",1,0,0,0,1
"cg16224796",0,0,1,0,1
"cg16225917",0,0,1,0,1
"cg16226300",2,1,4,0,7
"cg16226310",0,0,1,0,1
"cg16226546",1,0,0,0,1
"cg16228554",1,0,0,0,1
"cg16228858",0,0,1,0,1
"cg16229626",4,0,1,0,5
"cg16230384",5,15,5,0,25
"cg16230787",0,1,2,0,3
"cg16231670",1,0,0,0,1
"cg16233450",0,0,1,0,1
"cg16234298",0,0,1,0,1
"cg16234890",0,1,0,0,1
"cg16235057",0,1,0,0,1
"cg16236328",1,0,0,0,1
"cg16237207",2,3,3,0,8
"cg16237409",0,0,1,0,1
"cg16237635",0,1,2,0,3
"cg16240319",0,0,2,0,2
"cg16240550",252,44,4,0,300
"cg16241684",1,0,1,0,2
"cg16242238",1,1,2,0,4
"cg16242530",0,1,0,0,1
"cg16242629",0,1,0,0,1
"cg16243240",65,6,0,0,71
"cg16243652",0,0,1,1,2
"cg16244944",1,0,1,0,2
"cg16245553",3,2,0,0,5
"cg16246422",12,3,0,0,15
"cg16246836",1,0,0,0,1
"cg16247017",1,0,0,0,1
"cg16247391",0,1,0,0,1
"cg16247555",0,0,1,0,1
"cg16247957",0,2,0,0,2
"cg16248045",1,0,0,0,1
"cg16248182",0,2,1,0,3
"cg16248785",0,1,0,0,1
"cg16249801",2,1,0,0,3
"cg16250200",0,1,0,0,1
"cg16250425",12,8,0,0,20
"cg16250856",0,0,0,1,1
"cg16251107",0,1,0,0,1
"cg16251128",2,0,0,0,2
"cg16251255",1,0,0,0,1
"cg16251342",3,0,0,0,3
"cg16251369",4,2,1,0,7
"cg16251399",0,1,0,0,1
"cg16252726",1,0,0,0,1
"cg16253840",0,1,1,0,2
"cg16254033",0,0,2,0,2
"cg16254069",0,0,2,0,2
"cg16254330",2,1,0,0,3
"cg16254477",0,2,0,0,2
"cg16254662",1,0,0,0,1
"cg16255438",2,0,0,0,2
"cg16256592",0,0,1,0,1
"cg16256933",1,0,0,0,1
"cg16256955",0,1,2,0,3
"cg16257860",1,0,0,0,1
"cg16258209",0,0,1,0,1
"cg16260301",0,1,2,0,3
"cg16260727",16,2,0,0,18
"cg16262365",0,0,2,0,2
"cg16262553",3,2,5,0,10
"cg16263182",0,0,1,0,1
"cg16263367",2,3,3,0,8
"cg16263627",9,1,1,0,11
"cg16263775",1,0,0,0,1
"cg16263863",17,18,14,0,49
"cg16263887",0,0,0,1,1
"cg16264466",69,4,0,0,73
"cg16264520",1,0,0,0,1
"cg16264886",42,19,2,0,63
"cg16264980",3,0,0,0,3
"cg16265610",0,0,2,0,2
"cg16266453",1,0,0,0,1
"cg16267012",2,3,1,0,6
"cg16267121",2,3,4,0,9
"cg16267304",3,3,9,0,15
"cg16267327",0,0,1,0,1
"cg16267374",1,0,1,0,2
"cg16268133",0,1,0,0,1
"cg16268157",0,1,1,0,2
"cg16269447",0,2,0,0,2
"cg16269488",1,0,0,0,1
"cg16270493",118,39,8,0,165
"cg16270500",2,0,0,0,2
"cg16270571",0,1,0,0,1
"cg16271221",14,3,1,0,18
"cg16271359",2,0,1,0,3
"cg16272639",1,0,0,0,1
"cg16273724",0,0,1,0,1
"cg16274115",12,7,0,0,19
"cg16275722",4,10,11,0,25
"cg16275734",1,0,0,0,1
"cg16275825",1,0,0,0,1
"cg16275894",0,1,0,0,1
"cg16276999",7,16,10,0,33
"cg16278956",23,1,0,0,24
"cg16279237",0,0,1,0,1
"cg16279576",3,0,0,0,3
"cg16279691",1,0,0,0,1
"cg16279748",0,0,1,0,1
"cg16280098",1,0,0,0,1
"cg16280499",0,0,1,0,1
"cg16280946",2,10,6,0,18
"cg16281322",0,1,0,0,1
"cg16282102",4,3,0,0,7
"cg16282910",3,1,0,0,4
"cg16282982",0,0,1,0,1
"cg16284396",1,0,0,0,1
"cg16286157",23,44,0,0,67
"cg16288220",17,0,0,0,17
"cg16288845",0,1,1,0,2
"cg16291580",1,0,0,0,1
"cg16292276",0,0,2,0,2
"cg16292912",26,0,0,0,26
"cg16292933",1,0,0,0,1
"cg16293332",0,12,15,0,27
"cg16293758",323,7,0,0,330
"cg16293817",0,0,1,0,1
"cg16294031",2,1,0,0,3
"cg16294038",0,0,1,0,1
"cg16295302",1,2,0,0,3
"cg16296017",0,0,1,0,1
"cg16296061",0,0,2,0,2
"cg16297530",137,37,4,0,178
"cg16298011",235,9,0,0,244
"cg16298797",0,1,0,0,1
"cg16299063",5,0,0,0,5
"cg16299131",206,15,1,0,222
"cg16300329",0,1,1,0,2
"cg16300707",1,0,0,0,1
"cg16300745",11,3,0,0,14
"cg16301989",2,2,1,0,5
"cg16302021",0,1,2,0,3
"cg16302982",1,0,0,0,1
"cg16303082",3,0,0,0,3
"cg16303478",4,2,0,0,6
"cg16305303",641,745,22,0,1408
"cg16306253",4,0,0,0,4
"cg16306500",2,0,1,0,3
"cg16308101",0,1,1,0,2
"cg16308778",1,1,0,0,2
"cg16308857",4,7,0,0,11
"cg16309127",1,0,0,0,1
"cg16309424",5,0,0,0,5
"cg16310215",0,2,1,0,3
"cg16310755",0,1,1,0,2
"cg16311072",0,0,3,0,3
"cg16311364",0,0,2,0,2
"cg16311803",0,2,0,0,2
"cg16311808",2,1,0,0,3
"cg16314283",0,1,1,0,2
"cg16315155",1,4,0,0,5
"cg16315980",210,9,2,0,221
"cg16316271",1,0,10,0,11
"cg16316519",1,1,0,0,2
"cg16316944",1,0,0,0,1
"cg16316996",0,1,1,0,2
"cg16317295",2,0,0,0,2
"cg16318235",4,0,0,0,4
"cg16318405",97,59,9,0,165
"cg16318479",1,0,0,0,1
"cg16318728",1,0,0,0,1
"cg16319080",221,129,8,0,358
"cg16319310",0,1,0,0,1
"cg16319859",0,2,2,0,4
"cg16320398",115,231,159,0,505
"cg16320888",17,6,0,0,23
"cg16321540",19,1,0,0,20
"cg16321608",1,0,0,0,1
"cg16322304",0,1,0,0,1
"cg16322747",0,0,0,1,1
"cg16322794",0,0,1,0,1
"cg16323250",2,3,0,0,5
"cg16324343",0,0,1,0,1
"cg16325382",0,1,0,0,1
"cg16325421",0,1,0,0,1
"cg16326358",1,0,0,0,1
"cg16326814",17,0,0,0,17
"cg16327041",0,2,0,0,2
"cg16327140",106,415,64,0,585
"cg16327974",0,1,2,0,3
"cg16328462",6,4,0,0,10
"cg16329085",1,0,0,0,1
"cg16329424",19,2,0,0,21
"cg16331117",0,2,0,0,2
"cg16331147",0,1,0,0,1
"cg16332256",2,3,7,0,12
"cg16335442",112,5,0,0,117
"cg16335482",1,0,0,0,1
"cg16335566",116,8,0,0,124
"cg16335841",0,0,1,0,1
"cg16338278",0,0,1,0,1
"cg16338877",0,0,1,0,1
"cg16340208",0,1,0,0,1
"cg16341939",0,4,3,0,7
"cg16343374",0,1,0,0,1
"cg16344195",0,0,1,0,1
"cg16345272",19,0,0,0,19
"cg16345653",39,1,0,0,40
"cg16345899",1,0,0,0,1
"cg16347798",0,1,0,0,1
"cg16348947",1,1,0,0,2
"cg16349138",0,0,1,0,1
"cg16349834",0,0,1,0,1
"cg16350652",32,7,0,0,39
"cg16351010",0,3,0,0,3
"cg16351335",1,0,0,0,1
"cg16351957",0,1,0,0,1
"cg16352220",0,0,1,0,1
"cg16352384",1,0,0,0,1
"cg16353022",15,0,0,0,15
"cg16353738",0,1,0,0,1
"cg16354004",99,3,0,0,102
"cg16354522",0,1,0,0,1
"cg16354677",4,2,0,0,6
"cg16354756",1,0,0,0,1
"cg16355191",1,0,0,0,1
"cg16355654",5,1,0,0,6
"cg16355771",1,0,0,0,1
"cg16356630",172,193,48,0,413
"cg16357344",0,1,0,0,1
"cg16357703",0,1,0,0,1
"cg16357719",0,0,1,0,1
"cg16358154",1,0,0,0,1
"cg16359169",0,1,2,0,3
"cg16359316",0,3,1,0,4
"cg16359517",241,47,1,0,289
"cg16360003",0,1,0,0,1
"cg16360322",43,12,0,0,55
"cg16360717",1,2,0,0,3
"cg16360831",11,3,0,0,14
"cg16361876",0,0,2,0,2
"cg16361977",1,0,1,0,2
"cg16362055",9,4,0,0,13
"cg16362458",1,0,0,0,1
"cg16362574",1,0,0,0,1
"cg16362899",283,324,21,0,628
"cg16363074",0,1,1,0,2
"cg16363415",3,0,0,0,3
"cg16363673",1,0,0,0,1
"cg16363738",11,0,0,0,11
"cg16363807",86,120,3,0,209
"cg16363970",0,0,1,0,1
"cg16364132",3,0,1,0,4
"cg16364564",223,19,2,0,244
"cg16364803",0,2,0,0,2
"cg16365077",0,0,1,0,1
"cg16365157",0,0,1,0,1
"cg16365973",0,0,1,0,1
"cg16366238",0,1,0,0,1
"cg16366945",10,3,0,0,13
"cg16367394",0,0,2,0,2
"cg16367522",0,0,1,0,1
"cg16367685",0,0,2,0,2
"cg16368004",1,0,0,0,1
"cg16368054",861,62,3,0,926
"cg16368579",0,1,11,0,12
"cg16369705",0,0,1,0,1
"cg16370863",47,2,0,0,49
"cg16372751",0,0,1,0,1
"cg16373765",1,0,1,0,2
"cg16374647",0,0,1,0,1
"cg16376048",60,107,23,0,190
"cg16376229",0,1,0,0,1
"cg16376447",0,1,0,0,1
"cg16377819",3,0,0,0,3
"cg16378003",0,0,1,0,1
"cg16378133",0,0,1,0,1
"cg16380389",0,2,4,0,6
"cg16380414",0,0,1,0,1
"cg16381253",0,0,3,0,3
"cg16382250",9,0,7,0,16
"cg16382482",0,0,1,0,1
"cg16382495",1,0,0,0,1
"cg16383898",2,0,0,0,2
"cg16383910",0,0,1,0,1
"cg16383987",0,0,1,0,1
"cg16384170",0,1,0,0,1
"cg16384373",1,0,0,0,1
"cg16384552",0,1,7,0,8
"cg16384642",0,0,1,0,1
"cg16384723",0,0,2,0,2
"cg16384797",0,0,1,0,1
"cg16385728",5,1,0,0,6
"cg16385939",0,1,3,0,4
"cg16386641",1,1,1,0,3
"cg16387021",105,13,1,0,119
"cg16387380",1,0,0,0,1
"cg16387401",25,19,2,0,46
"cg16387759",20,8,0,0,28
"cg16388896",2,0,0,0,2
"cg16389560",42,19,1,0,62
"cg16390715",0,1,0,0,1
"cg16390778",0,0,1,0,1
"cg16392193",0,1,0,0,1
"cg16393125",159,379,187,0,725
"cg16393156",0,1,1,0,2
"cg16393713",0,0,1,0,1
"cg16393727",0,0,1,0,1
"cg16393749",0,1,0,0,1
"cg16393880",38,7,1,0,46
"cg16395120",0,3,2,0,5
"cg16395183",5,0,0,0,5
"cg16395336",0,0,2,0,2
"cg16395679",1,0,0,0,1
"cg16396153",4,1,0,0,5
"cg16396414",0,1,1,0,2
"cg16396561",0,0,1,0,1
"cg16398832",0,0,1,0,1
"cg16398965",0,0,1,0,1
"cg16399360",2,0,0,0,2
"cg16399922",0,1,1,0,2
"cg16400226",1,0,0,0,1
"cg16400843",0,1,0,0,1
"cg16401578",123,1,0,0,124
"cg16401915",0,0,1,0,1
"cg16402142",1,0,0,0,1
"cg16402443",13,0,0,0,13
"cg16403567",0,1,0,0,1
"cg16404371",1,0,0,0,1
"cg16404754",168,492,21,0,681
"cg16405663",1,5,0,0,6
"cg16406316",0,1,0,0,1
"cg16406836",3,0,0,0,3
"cg16407017",0,0,1,0,1
"cg16407044",1,0,0,0,1
"cg16408232",0,1,1,0,2
"cg16408735",0,1,0,0,1
"cg16408815",0,1,0,0,1
"cg16409109",2,5,0,0,7
"cg16409323",0,0,1,0,1
"cg16409456",219,49,0,0,268
"cg16410579",0,0,2,0,2
"cg16411111",1,0,0,0,1
"cg16411244",0,0,1,0,1
"cg16411730",0,1,0,0,1
"cg16412995",1,0,0,0,1
"cg16413193",0,1,0,0,1
"cg16413752",1,0,0,0,1
"cg16414143",0,0,1,0,1
"cg16414659",2,0,0,0,2
"cg16415336",195,4,0,0,199
"cg16415411",5,11,5,0,21
"cg16415489",0,0,1,0,1
"cg16415748",2,0,0,0,2
"cg16416548",9,4,0,0,13
"cg16416939",2,0,1,0,3
"cg16417206",1,0,0,0,1
"cg16417436",0,1,1,0,2
"cg16417588",0,0,11,0,11
"cg16418793",234,46,1,0,281
"cg16418971",0,1,0,0,1
"cg16419034",0,0,1,0,1
"cg16420200",0,0,1,0,1
"cg16423285",13,2,0,0,15
"cg16424519",0,0,2,0,2
"cg16425574",0,1,0,0,1
"cg16426482",0,0,2,0,2
"cg16428365",2,0,0,0,2
"cg16429105",1,0,0,0,1
"cg16429305",0,0,1,0,1
"cg16429819",0,0,1,0,1
"cg16431154",0,1,0,0,1
"cg16434764",307,75,12,0,394
"cg16435005",0,2,0,0,2
"cg16435373",67,5,1,0,73
"cg16435601",1,0,2,0,3
"cg16435686",0,1,0,0,1
"cg16435923",1,0,0,0,1
"cg16436004",5,0,0,0,5
"cg16436232",6,4,1,0,11
"cg16436235",0,3,4,0,7
"cg16436421",1,0,0,0,1
"cg16436473",0,1,1,0,2
"cg16437629",0,0,2,0,2
"cg16437896",602,52,4,0,658
"cg16438066",80,3,0,0,83
"cg16438674",0,1,0,0,1
"cg16439298",11,23,0,0,34
"cg16439324",0,0,1,0,1
"cg16440283",0,0,1,0,1
"cg16440806",1,0,0,0,1
"cg16441248",0,0,1,0,1
"cg16444015",25,4,0,0,29
"cg16444115",0,0,1,0,1
"cg16444464",0,0,3,0,3
"cg16445317",0,1,0,0,1
"cg16446484",1,0,0,0,1
"cg16447312",3,0,0,0,3
"cg16447950",0,1,2,0,3
"cg16448062",0,0,1,0,1
"cg16448982",1,0,0,0,1
"cg16451323",0,1,0,0,1
"cg16451391",0,0,1,0,1
"cg16451475",0,0,2,0,2
"cg16451625",1,0,0,0,1
"cg16452272",28,72,1,0,101
"cg16452817",1,1,0,0,2
"cg16453343",7,3,0,0,10
"cg16453630",3,0,0,0,3
"cg16453930",2,1,1,0,4
"cg16455024",2,0,1,0,3
"cg16457837",2,1,0,0,3
"cg16458868",0,0,1,0,1
"cg16459346",0,3,6,0,9
"cg16459646",0,0,1,0,1
"cg16460164",8,9,1,0,18
"cg16460670",1,0,0,0,1
"cg16460994",1,1,2,0,4
"cg16461549",18,0,0,0,18
"cg16462291",0,0,1,0,1
"cg16463150",1,0,1,0,2
"cg16463564",0,1,0,0,1
"cg16463880",0,0,1,0,1
"cg16465369",1,0,0,0,1
"cg16467162",1,0,0,0,1
"cg16467625",0,0,1,0,1
"cg16467854",0,1,0,0,1
"cg16468183",81,191,258,0,530
"cg16468444",1,0,0,0,1
"cg16468754",0,3,3,0,6
"cg16469871",3,1,0,0,4
"cg16470655",0,0,1,0,1
"cg16470772",0,1,0,0,1
"cg16470902",1,1,0,0,2
"cg16470905",2,0,0,0,2
"cg16470963",110,18,2,0,130
"cg16471239",1,0,0,0,1
"cg16471481",1,0,0,0,1
"cg16471635",0,2,10,0,12
"cg16471678",266,81,0,0,347
"cg16472002",0,0,1,0,1
"cg16472933",0,0,1,0,1
"cg16472945",105,207,12,0,324
"cg16475255",0,5,3,0,8
"cg16475667",0,0,2,0,2
"cg16476317",0,0,1,0,1
"cg16476382",0,1,0,0,1
"cg16476386",6,0,0,0,6
"cg16477196",0,0,1,0,1
"cg16477959",0,0,1,0,1
"cg16480634",0,0,1,0,1
"cg16481352",1,1,0,0,2
"cg16481465",0,0,1,0,1
"cg16481584",1,1,0,0,2
"cg16483251",2,0,0,0,2
"cg16483473",1,2,0,0,3
"cg16483832",21,6,2,0,29
"cg16483846",0,1,0,0,1
"cg16484450",0,1,1,0,2
"cg16485315",1,1,0,0,2
"cg16486132",0,0,1,0,1
"cg16486298",0,4,0,0,4
"cg16486754",3,0,1,0,4
"cg16488174",0,0,1,0,1
"cg16489602",5,0,1,0,6
"cg16490739",0,8,5,0,13
"cg16491050",158,300,6,0,464
"cg16492395",40,10,4,0,54
"cg16492440",1,0,0,0,1
"cg16492577",185,68,4,0,257
"cg16492828",9,0,0,0,9
"cg16492960",1,0,0,0,1
"cg16493124",0,1,2,0,3
"cg16493874",0,0,4,0,4
"cg16494033",3,0,0,0,3
"cg16494597",0,0,2,0,2
"cg16494843",235,4,7,0,246
"cg16494896",2,0,0,0,2
"cg16496592",1,0,0,0,1
"cg16496973",0,0,1,0,1
"cg16497076",0,0,2,0,2
"cg16498359",0,2,0,0,2
"cg16498681",6,1,0,0,7
"cg16500097",1,0,0,0,1
"cg16500150",1,0,0,0,1
"cg16500769",31,5,0,0,36
"cg16501560",2,0,0,0,2
"cg16501885",5,1,2,0,8
"cg16501959",1,0,0,0,1
"cg16502364",4,0,0,0,4
"cg16502438",1,1,0,0,2
"cg16503713",339,125,15,0,479
"cg16503714",0,1,0,0,1
"cg16504939",1,0,0,0,1
"cg16504944",30,16,3,0,49
"cg16505427",1,0,0,0,1
"cg16505548",0,1,0,0,1
"cg16505657",0,1,0,0,1
"cg16506887",0,0,1,0,1
"cg16507274",0,0,1,0,1
"cg16508426",6,0,0,0,6
"cg16508904",1,5,1,1,8
"cg16510409",9,1,0,0,10
"cg16511086",0,0,0,1,1
"cg16511392",49,2,0,0,51
"cg16511454",2,1,0,0,3
"cg16511983",0,0,2,0,2
"cg16512924",0,3,0,0,3
"cg16513149",1,0,0,0,1
"cg16513681",1,0,0,0,1
"cg16514059",0,1,0,0,1
"cg16515087",0,1,2,0,3
"cg16516856",0,0,6,0,6
"cg16517186",1,0,0,0,1
"cg16517543",9,4,0,0,13
"cg16517561",0,0,1,0,1
"cg16518291",1,0,0,0,1
"cg16518990",222,13,0,0,235
"cg16519842",0,1,1,0,2
"cg16520886",0,0,1,0,1
"cg16520898",1,0,1,0,2
"cg16520955",0,0,6,0,6
"cg16521110",0,0,1,0,1
"cg16521309",0,0,1,0,1
"cg16521629",0,0,1,0,1
"cg16521643",0,3,2,0,5
"cg16522344",11,0,0,0,11
"cg16522370",0,0,1,0,1
"cg16522835",0,0,1,0,1
"cg16522960",0,0,1,0,1
"cg16523680",1,0,0,0,1
"cg16524869",238,32,0,0,270
"cg16525244",5,1,0,0,6
"cg16525258",2,1,1,0,4
"cg16525287",0,1,0,0,1
"cg16526390",2,0,0,0,2
"cg16526477",0,0,8,0,8
"cg16526636",208,147,18,0,373
"cg16527107",0,1,4,0,5
"cg16527260",5,0,0,0,5
"cg16527761",1,0,0,0,1
"cg16527939",2,0,0,0,2
"cg16528088",1,1,1,0,3
"cg16528186",2,2,1,0,5
"cg16528497",0,0,1,0,1
"cg16528596",0,0,1,0,1
"cg16529795",1,3,0,0,4
"cg16530208",11,15,0,0,26
"cg16531718",14,4,0,0,18
"cg16532100",14,37,1,0,52
"cg16532362",286,21,3,0,310
"cg16533315",2,1,0,0,3
"cg16535653",0,1,0,0,1
"cg16535779",1,4,5,0,10
"cg16537132",592,22,0,0,614
"cg16537150",2,0,0,0,2
"cg16537859",24,0,0,0,24
"cg16538507",0,1,0,0,1
"cg16538680",1,0,0,0,1
"cg16539218",0,1,0,0,1
"cg16539488",0,1,0,0,1
"cg16541353",4,0,0,0,4
"cg16541653",0,1,0,0,1
"cg16542426",109,7,1,0,117
"cg16542484",1,0,0,0,1
"cg16543129",2,0,0,0,2
"cg16543876",70,5,0,0,75
"cg16544429",0,1,0,0,1
"cg16545218",0,1,0,0,1
"cg16546340",0,1,5,0,6
"cg16546841",0,2,2,0,4
"cg16547673",2,0,0,0,2
"cg16547691",0,0,1,0,1
"cg16547862",27,1,0,0,28
"cg16548916",7,1,0,0,8
"cg16549633",15,1,0,0,16
"cg16550505",39,51,0,0,90
"cg16550555",10,3,4,0,17
"cg16551039",0,0,1,0,1
"cg16551054",1,0,0,0,1
"cg16551171",2,0,0,0,2
"cg16551963",0,1,0,0,1
"cg16552042",0,1,0,0,1
"cg16552500",0,1,0,0,1
"cg16553026",0,0,1,0,1
"cg16553126",0,0,1,0,1
"cg16553574",2,1,0,0,3
"cg16554959",1,0,1,0,2
"cg16555088",0,0,2,0,2
"cg16555411",1,5,1,0,7
"cg16555544",0,0,1,0,1
"cg16556656",14,2,0,0,16
"cg16556921",3,7,0,0,10
"cg16558177",1,2,1,0,4
"cg16558450",3,2,3,0,8
"cg16558462",0,0,1,0,1
"cg16558465",22,2,0,0,24
"cg16560173",0,1,1,0,2
"cg16561237",54,57,31,0,142
"cg16562257",1,0,0,0,1
"cg16562778",0,0,1,0,1
"cg16564230",1,0,0,0,1
"cg16564302",1,0,0,0,1
"cg16564327",384,52,1,0,437
"cg16565638",8,1,0,0,9
"cg16565902",0,1,0,0,1
"cg16566222",0,1,0,0,1
"cg16566605",0,0,3,0,3
"cg16567836",2,0,0,0,2
"cg16568000",1,0,0,0,1
"cg16568131",107,17,2,0,126
"cg16568132",1,0,0,0,1
"cg16569160",0,1,0,0,1
"cg16569687",1,0,0,0,1
"cg16570980",10,8,1,0,19
"cg16571694",47,18,1,0,66
"cg16572020",1,0,0,0,1
"cg16572079",0,3,0,0,3
"cg16572603",0,1,0,0,1
"cg16573282",0,0,1,0,1
"cg16573708",1,1,0,0,2
"cg16575261",0,0,1,0,1
"cg16575544",0,0,5,0,5
"cg16576160",0,0,1,0,1
"cg16578802",200,566,20,0,786
"cg16578944",1,0,0,0,1
"cg16579369",1,0,0,0,1
"cg16579400",0,0,1,0,1
"cg16580556",0,4,4,0,8
"cg16580681",25,5,0,0,30
"cg16580985",0,1,0,0,1
"cg16581647",68,44,2,0,114
"cg16582077",0,1,0,0,1
"cg16582459",0,0,1,0,1
"cg16583381",262,178,13,0,453
"cg16583917",1,0,0,0,1
"cg16584092",1,0,0,0,1
"cg16584392",0,0,1,0,1
"cg16584525",0,1,0,0,1
"cg16586559",0,4,15,0,19
"cg16586563",0,1,0,0,1
"cg16586749",0,0,1,0,1
"cg16587567",114,105,5,0,224
"cg16587635",0,0,1,0,1
"cg16588159",0,0,5,0,5
"cg16588509",0,0,1,0,1
"cg16589802",0,1,0,0,1
"cg16590086",4,2,0,0,6
"cg16590151",0,0,1,0,1
"cg16591002",151,20,0,0,171
"cg16591003",1,1,0,0,2
"cg16591272",42,5,0,0,47
"cg16591450",1,1,0,0,2
"cg16592391",4,3,0,0,7
"cg16593027",1,4,3,0,8
"cg16593864",0,0,1,0,1
"cg16594220",2,0,0,0,2
"cg16594581",1,8,1,0,10
"cg16595269",434,80,3,0,517
"cg16595541",0,0,1,0,1
"cg16595953",0,4,0,0,4
"cg16595974",223,143,2,0,368
"cg16596250",24,39,4,0,67
"cg16596411",1,0,1,0,2
"cg16597537",0,0,1,0,1
"cg16597863",19,1,0,0,20
"cg16598513",2,12,2,0,16
"cg16600020",1,0,1,0,2
"cg16601146",216,41,1,0,258
"cg16601461",0,0,2,0,2
"cg16602117",1,0,0,0,1
"cg16604554",0,3,1,0,4
"cg16604837",0,1,0,0,1
"cg16605431",10,7,1,0,18
"cg16607364",0,2,4,0,6
"cg16607773",18,6,1,0,25
"cg16609139",4,0,0,0,4
"cg16609966",0,1,0,0,1
"cg16611858",6,2,0,0,8
"cg16611911",63,59,0,0,122
"cg16613176",0,1,0,0,1
"cg16613707",0,0,2,0,2
"cg16613750",0,0,1,0,1
"cg16614114",0,0,1,0,1
"cg16615339",3,0,0,0,3
"cg16615900",38,2,0,0,40
"cg16617316",3,0,0,0,3
"cg16617996",7,0,0,0,7
"cg16618141",1,0,0,0,1
"cg16618507",0,0,1,0,1
"cg16619805",4,0,0,0,4
"cg16620160",38,3,0,0,41
"cg16620804",1,1,0,0,2
"cg16621364",0,1,0,0,1
"cg16622085",0,4,0,0,4
"cg16622511",0,0,1,0,1
"cg16624177",2,1,3,0,6
"cg16624787",0,1,0,0,1
"cg16625908",0,1,0,0,1
"cg16626452",0,1,8,0,9
"cg16626580",0,6,1,0,7
"cg16627086",1,0,0,0,1
"cg16627470",0,0,1,0,1
"cg16629452",0,1,0,0,1
"cg16630453",70,9,0,0,79
"cg16630770",540,17,0,0,557
"cg16630773",1,0,0,0,1
"cg16631682",0,0,1,0,1
"cg16631698",0,0,1,0,1
"cg16631827",0,1,0,0,1
"cg16631992",0,0,2,0,2
"cg16632575",8,0,0,0,8
"cg16632707",1,0,0,0,1
"cg16635480",1,0,0,0,1
"cg16636682",0,1,1,0,2
"cg16636777",2,0,0,0,2
"cg16636935",0,0,1,0,1
"cg16637899",2,0,0,0,2
"cg16638580",3,0,0,0,3
"cg16638931",0,1,0,0,1
"cg16639745",0,3,20,0,23
"cg16640135",1,0,0,0,1
"cg16640496",1,1,0,0,2
"cg16642003",1,0,0,0,1
"cg16642717",14,0,0,0,14
"cg16643033",0,0,1,0,1
"cg16643169",1,0,0,0,1
"cg16643669",1,0,0,0,1
"cg16643851",5,1,16,0,22
"cg16643997",4,0,0,0,4
"cg16644513",0,0,0,1,1
"cg16644647",83,6,0,0,89
"cg16644803",0,0,2,0,2
"cg16645560",2,0,0,0,2
"cg16645752",5,2,3,0,10
"cg16645977",0,1,1,0,2
"cg16646024",2,0,0,0,2
"cg16646879",1,20,4,0,25
"cg16647410",33,6,0,0,39
"cg16647868",0,1,0,0,1
"cg16648426",0,0,1,0,1
"cg16648494",0,1,0,0,1
"cg16648579",0,1,0,0,1
"cg16649915",0,2,0,0,2
"cg16650002",43,42,3,0,88
"cg16650151",190,16,0,0,206
"cg16650245",1,0,0,0,1
"cg16650443",0,4,7,0,11
"cg16650896",3,1,2,0,6
"cg16650929",0,1,0,0,1
"cg16652462",0,0,1,0,1
"cg16652617",1,0,0,0,1
"cg16652705",0,1,0,0,1
"cg16652841",0,0,1,0,1
"cg16652931",0,1,0,0,1
"cg16654802",1,0,1,0,2
"cg16655175",21,11,0,0,32
"cg16656630",0,2,0,0,2
"cg16656939",4,0,0,0,4
"cg16657479",0,1,0,0,1
"cg16659202",0,1,0,0,1
"cg16659657",3,8,13,0,24
"cg16660306",1,0,0,0,1
"cg16661939",0,1,0,0,1
"cg16662829",18,0,0,0,18
"cg16663808",1,0,0,0,1
"cg16664876",4,1,5,0,10
"cg16665598",0,0,1,0,1
"cg16666405",1,0,0,0,1
"cg16666458",0,1,0,0,1
"cg16667192",0,1,0,0,1
"cg16667687",1,0,0,0,1
"cg16668293",1,0,0,0,1
"cg16668315",2,1,1,0,4
"cg16668534",0,1,0,0,1
"cg16669468",498,18,1,0,517
"cg16669957",3,0,0,0,3
"cg16671160",0,1,0,0,1
"cg16671370",1,0,0,0,1
"cg16671988",0,4,0,0,4
"cg16672108",0,1,0,0,1
"cg16672535",0,1,0,0,1
"cg16672830",0,0,1,0,1
"cg16673286",0,1,0,0,1
"cg16673508",0,0,1,0,1
"cg16673712",10,1,0,0,11
"cg16675810",3,2,0,0,5
"cg16678686",7,1,0,0,8
"cg16679718",0,0,2,0,2
"cg16681355",1,0,0,0,1
"cg16681520",0,0,1,0,1
"cg16681934",0,1,0,0,1
"cg16682657",0,1,1,0,2
"cg16683647",0,2,0,0,2
"cg16684211",715,66,0,0,781
"cg16684846",22,1,0,0,23
"cg16685662",3,3,1,0,7
"cg16685798",1,0,2,0,3
"cg16685990",0,0,1,0,1
"cg16686848",1,0,0,0,1
"cg16687321",0,0,1,0,1
"cg16688318",10,7,0,0,17
"cg16689564",4,0,0,0,4
"cg16690972",2,0,0,0,2
"cg16691023",0,0,1,0,1
"cg16691152",12,2,5,0,19
"cg16691254",0,0,2,0,2
"cg16691557",23,10,2,0,35
"cg16691568",33,3,0,0,36
"cg16691681",30,9,0,0,39
"cg16691831",1,0,0,0,1
"cg16692604",1,0,0,0,1
"cg16692788",1,0,0,0,1
"cg16694311",0,1,1,0,2
"cg16694397",0,1,0,0,1
"cg16695599",0,5,0,0,5
"cg16696019",1,0,0,0,1
"cg16696781",3,0,0,0,3
"cg16696815",0,1,0,0,1
"cg16697004",1,0,0,0,1
"cg16699528",1,0,0,0,1
"cg16699635",0,1,0,0,1
"cg16699736",0,1,0,0,1
"cg16699956",1,1,0,0,2
"cg16700226",2,0,1,0,3
"cg16700399",18,1,0,0,19
"cg16700426",1,0,0,0,1
"cg16700716",0,1,1,0,2
"cg16700904",162,6,0,0,168
"cg16701003",2,2,1,0,5
"cg16701121",0,1,0,0,1
"cg16701655",0,0,1,0,1
"cg16702191",0,2,0,0,2
"cg16704344",20,1,0,0,21
"cg16704464",0,0,1,0,1
"cg16704720",0,1,0,0,1
"cg16706593",1,0,0,0,1
"cg16706690",0,2,1,1,4
"cg16706813",0,0,1,0,1
"cg16707236",1,0,0,0,1
"cg16707391",117,6,0,0,123
"cg16707536",1,0,0,0,1
"cg16707690",1,0,1,0,2
"cg16708162",0,1,0,0,1
"cg16708281",0,0,6,0,6
"cg16708835",1,0,0,0,1
"cg16710183",0,0,1,0,1
"cg16710828",300,83,1,0,384
"cg16711165",0,0,1,0,1
"cg16712639",1,0,0,0,1
"cg16712679",0,0,1,0,1
"cg16713069",42,56,7,0,105
"cg16713490",0,1,0,0,1
"cg16714755",0,0,1,0,1
"cg16714933",1,1,0,0,2
"cg16715528",1,0,0,0,1
"cg16716209",1,0,0,0,1
"cg16717773",0,1,1,0,2
"cg16718537",0,1,0,0,1
"cg16718902",0,0,2,0,2
"cg16719825",11,1,0,0,12
"cg16721879",1,1,4,0,6
"cg16723182",0,0,31,0,31
"cg16724416",0,0,2,0,2
"cg16724585",0,1,3,0,4
"cg16726374",0,0,1,0,1
"cg16727776",0,0,1,0,1
"cg16729686",1,0,0,0,1
"cg16730596",1,1,1,0,3
"cg16731428",6,2,0,0,8
"cg16732139",0,0,1,0,1
"cg16732626",6,1,0,0,7
"cg16732884",0,2,0,0,2
"cg16733589",4,0,0,0,4
"cg16733598",0,1,1,0,2
"cg16734191",1,0,0,0,1
"cg16734258",1,0,0,0,1
"cg16734683",2,2,0,0,4
"cg16735072",0,1,17,0,18
"cg16735130",5,1,0,0,6
"cg16735473",1,0,0,0,1
"cg16735901",2,9,2,0,13
"cg16736181",6,3,0,0,9
"cg16736799",617,258,5,0,880
"cg16737422",0,1,0,0,1
"cg16739054",144,35,3,0,182
"cg16739385",14,0,0,0,14
"cg16740746",30,0,0,0,30
"cg16741245",7,1,0,0,8
"cg16741463",5,3,0,0,8
"cg16742075",1,0,0,0,1
"cg16742960",0,6,3,0,9
"cg16743048",3,0,0,0,3
"cg16743143",1,3,1,0,5
"cg16744250",1,0,0,0,1
"cg16744883",1,2,4,0,7
"cg16744892",1,2,0,0,3
"cg16744913",0,1,0,0,1
"cg16745078",0,0,1,0,1
"cg16746007",0,1,0,0,1
"cg16747427",2,1,0,0,3
"cg16747643",0,0,2,0,2
"cg16747885",2,3,0,0,5
"cg16748632",0,1,1,0,2
"cg16749589",0,0,1,0,1
"cg16750112",4,0,0,0,4
"cg16750946",0,1,0,0,1
"cg16752008",1,0,0,0,1
"cg16752985",1,3,11,0,15
"cg16753180",74,49,2,0,125
"cg16753494",2,1,0,0,3
"cg16753670",0,0,1,0,1
"cg16754099",6,1,0,0,7
"cg16754643",0,0,0,1,1
"cg16754747",1,3,0,0,4
"cg16755848",6,0,0,0,6
"cg16756330",98,18,0,0,116
"cg16757485",0,0,1,0,1
"cg16757592",0,1,0,0,1
"cg16757780",5,4,0,0,9
"cg16757992",1,0,0,0,1
"cg16758325",0,7,2,0,9
"cg16758462",0,0,2,0,2
"cg16758820",0,1,0,0,1
"cg16759615",8,1,0,0,9
"cg16760291",558,25,0,0,583
"cg16762794",0,6,22,0,28
"cg16764616",0,3,0,0,3
"cg16764637",1,0,1,0,2
"cg16765129",7,0,0,0,7
"cg16766459",1,0,0,0,1
"cg16767192",0,1,0,0,1
"cg16767274",9,10,8,0,27
"cg16767307",0,0,1,0,1
"cg16767916",1,0,1,0,2
"cg16768592",1,0,0,0,1
"cg16769135",4,1,0,0,5
"cg16769658",1,0,0,0,1
"cg16769772",0,1,0,0,1
"cg16770309",0,4,4,0,8
"cg16770759",3,0,0,0,3
"cg16771033",0,1,0,0,1
"cg16771862",164,29,0,0,193
"cg16773563",1,0,0,0,1
"cg16773813",0,0,0,1,1
"cg16775198",319,14,0,0,333
"cg16776717",0,0,1,0,1
"cg16777317",4,1,8,0,13
"cg16777369",0,0,1,0,1
"cg16777910",0,1,0,0,1
"cg16778382",0,1,0,0,1
"cg16778714",0,2,0,0,2
"cg16779295",0,1,1,0,2
"cg16780032",121,320,239,0,680
"cg16780259",0,0,3,0,3
"cg16780401",0,1,0,0,1
"cg16780784",0,0,3,0,3
"cg16782170",1,0,0,0,1
"cg16782848",0,0,4,0,4
"cg16783668",122,27,4,0,153
"cg16783781",0,1,0,0,1
"cg16784100",0,1,0,0,1
"cg16784654",0,1,1,0,2
"cg16786388",0,1,1,0,2
"cg16786678",0,0,1,0,1
"cg16786721",72,15,1,0,88
"cg16787652",1,0,0,0,1
"cg16788179",2,1,0,0,3
"cg16789862",0,0,2,0,2
"cg16789863",1,0,0,0,1
"cg16789902",82,440,22,0,544
"cg16790144",5,14,10,0,29
"cg16790645",0,1,0,0,1
"cg16790676",306,139,6,0,451
"cg16790794",1,1,1,0,3
"cg16790843",1,0,0,0,1
"cg16790895",0,0,1,0,1
"cg16791636",0,0,2,0,2
"cg16791686",0,0,1,0,1
"cg16791781",0,1,0,0,1
"cg16792363",1,0,0,0,1
"cg16792875",0,1,3,2,6
"cg16794576",1,1,0,0,2
"cg16794708",0,0,1,0,1
"cg16795480",0,1,0,0,1
"cg16795759",0,0,1,0,1
"cg16795898",0,0,0,1,1
"cg16796247",57,35,1,0,93
"cg16796381",1,0,0,0,1
"cg16796951",1,1,0,0,2
"cg16797296",4,0,0,0,4
"cg16798345",0,1,0,0,1
"cg16798844",1,0,0,0,1
"cg16799087",1,0,0,0,1
"cg16800015",0,4,0,0,4
"cg16800343",89,3,0,0,92
"cg16803085",0,0,1,0,1
"cg16803232",0,0,1,0,1
"cg16803643",1,0,0,0,1
"cg16803840",0,0,1,0,1
"cg16806279",0,1,0,0,1
"cg16806519",0,2,0,0,2
"cg16807086",1,0,0,0,1
"cg16807273",0,1,0,0,1
"cg16808387",0,0,1,0,1
"cg16809217",1,0,0,0,1
"cg16809962",0,0,1,0,1
"cg16810276",1,0,0,0,1
"cg16810399",3,0,0,0,3
"cg16810457",1,1,0,0,2
"cg16811756",0,1,1,0,2
"cg16812288",315,19,0,0,334
"cg16812678",1,0,0,0,1
"cg16813087",0,1,0,0,1
"cg16813176",9,3,0,0,12
"cg16813360",0,1,1,0,2
"cg16814483",0,1,0,0,1
"cg16814522",1,0,0,0,1
"cg16817413",274,344,9,0,627
"cg16817496",0,0,1,0,1
"cg16817502",0,1,0,0,1
"cg16818658",1,0,0,0,1
"cg16818787",0,0,1,0,1
"cg16819573",485,126,12,0,623
"cg16821414",0,1,0,0,1
"cg16821528",0,1,0,0,1
"cg16821904",2,2,1,0,5
"cg16822841",22,10,0,0,32
"cg16823143",4,0,1,0,5
"cg16823665",0,1,0,0,1
"cg16824035",5,0,0,0,5
"cg16824822",2,0,0,0,2
"cg16827186",1,0,0,0,1
"cg16830248",25,8,0,0,33
"cg16830328",0,1,1,0,2
"cg16830994",18,3,0,0,21
"cg16831050",0,0,1,0,1
"cg16832693",2,1,1,0,4
"cg16834787",76,45,2,0,123
"cg16834845",0,1,4,0,5
"cg16835141",0,0,3,0,3
"cg16835357",1,0,0,0,1
"cg16836040",0,0,1,0,1
"cg16836995",0,0,1,0,1
"cg16837181",1,0,0,0,1
"cg16837571",1,0,0,0,1
"cg16838359",1,0,0,0,1
"cg16838729",0,0,1,0,1
"cg16839655",42,4,0,0,46
"cg16840574",0,2,1,0,3
"cg16840744",1,0,0,0,1
"cg16840889",1,0,0,0,1
"cg16841079",0,1,0,0,1
"cg16841676",1,0,0,0,1
"cg16842528",10,2,0,0,12
"cg16842832",1,0,0,0,1
"cg16843437",1,0,0,0,1
"cg16843799",1,1,0,0,2
"cg16843862",1,0,0,0,1
"cg16844471",1,0,0,0,1
"cg16844720",0,1,0,0,1
"cg16845136",1,0,0,0,1
"cg16845367",3,0,1,0,4
"cg16845778",0,1,0,0,1
"cg16845953",9,7,5,0,21
"cg16846728",444,111,4,0,559
"cg16847401",0,1,2,0,3
"cg16847604",7,2,2,0,11
"cg16848261",0,0,1,0,1
"cg16849020",0,0,1,0,1
"cg16850578",25,14,7,0,46
"cg16851485",0,1,1,0,2
"cg16851699",0,1,1,0,2
"cg16851858",0,3,20,0,23
"cg16852215",1,7,3,0,11
"cg16852253",0,0,1,0,1
"cg16853787",1,0,0,0,1
"cg16855331",0,1,2,0,3
"cg16855584",610,839,68,0,1517
"cg16855970",3,1,0,0,4
"cg16856342",0,1,2,0,3
"cg16856720",0,0,2,0,2
"cg16856734",2,0,0,0,2
"cg16856766",6,1,0,0,7
"cg16857700",3,0,0,0,3
"cg16857801",0,1,0,0,1
"cg16858025",1,0,0,0,1
"cg16858236",1,0,0,0,1
"cg16858871",30,2,0,0,32
"cg16861598",0,0,1,0,1
"cg16861845",0,1,2,0,3
"cg16861959",4,2,4,0,10
"cg16862729",287,5,0,0,292
"cg16864359",1,2,0,0,3
"cg16864700",0,0,1,0,1
"cg16864781",0,0,1,0,1
"cg16864836",0,2,1,0,3
"cg16864938",0,1,0,0,1
"cg16868202",6,0,0,0,6
"cg16870073",1,0,0,0,1
"cg16870526",1,0,0,0,1
"cg16871667",0,1,4,0,5
"cg16872328",0,0,1,0,1
"cg16872756",3,4,0,0,7
"cg16873648",0,0,1,0,1
"cg16875960",1,0,0,0,1
"cg16876348",0,0,1,0,1
"cg16876527",0,2,0,0,2
"cg16876703",8,2,2,0,12
"cg16877946",23,8,0,0,31
"cg16879233",1,0,0,0,1
"cg16879806",5,0,2,0,7
"cg16880688",35,27,3,0,65
"cg16881209",0,2,0,0,2
"cg16881730",0,0,2,1,3
"cg16884081",87,38,4,0,129
"cg16884295",2,0,0,0,2
"cg16884555",4,2,0,0,6
"cg16885061",7,18,4,0,29
"cg16885498",608,17,0,0,625
"cg16885511",0,0,3,0,3
"cg16885805",3,0,0,0,3
"cg16886403",1,0,0,0,1
"cg16888038",0,1,0,0,1
"cg16889057",0,0,1,0,1
"cg16889350",0,3,0,0,3
"cg16889427",0,1,1,0,2
"cg16889895",3,0,0,0,3
"cg16890362",0,1,0,0,1
"cg16890606",1,0,0,0,1
"cg16890752",2,1,0,0,3
"cg16891080",0,0,1,0,1
"cg16891165",5,1,0,0,6
"cg16891561",0,0,1,0,1
"cg16891632",0,1,0,0,1
"cg16893455",1,1,0,0,2
"cg16893618",0,0,1,0,1
"cg16893861",119,10,0,0,129
"cg16894009",1,0,0,0,1
"cg16896708",1,0,0,0,1
"cg16897306",0,1,1,0,2
"cg16898066",1,1,0,0,2
"cg16899358",6,1,0,0,7
"cg16899395",2,0,0,0,2
"cg16900013",0,0,1,0,1
"cg16900091",220,73,2,0,295
"cg16901092",19,1,0,0,20
"cg16901465",1,0,0,0,1
"cg16903269",0,1,0,0,1
"cg16903283",1,0,0,0,1
"cg16903605",0,1,1,0,2
"cg16903887",0,1,0,0,1
"cg16905211",298,14,1,0,313
"cg16905984",0,5,2,2,9
"cg16906105",1,0,0,0,1
"cg16906995",69,15,0,0,84
"cg16908978",0,0,1,0,1
"cg16909370",0,1,0,0,1
"cg16909526",1,0,0,0,1
"cg16910047",184,7,0,0,191
"cg16911594",1,0,0,0,1
"cg16912134",168,21,2,0,191
"cg16913560",0,1,1,0,2
"cg16913998",1,0,0,0,1
"cg16914123",1,2,0,0,3
"cg16914617",0,0,1,0,1
"cg16917215",0,0,1,0,1
"cg16917406",4,0,0,0,4
"cg16919567",0,2,0,0,2
"cg16919579",4,0,0,0,4
"cg16919808",1,0,0,0,1
"cg16921529",269,12,1,0,282
"cg16922384",1,0,0,0,1
"cg16922400",1,0,0,0,1
"cg16922506",1,0,0,0,1
"cg16922981",1,0,0,0,1
"cg16923710",757,82,0,0,839
"cg16925999",13,8,0,0,21
"cg16926147",1113,452,2,0,1567
"cg16926298",548,188,1,0,737
"cg16927481",1,0,0,0,1
"cg16927664",0,0,1,0,1
"cg16927796",1,0,0,0,1
"cg16928808",3,0,0,0,3
"cg16929318",0,2,0,0,2
"cg16929636",3,5,4,0,12
"cg16929726",2,0,0,0,2
"cg16929959",2,0,0,0,2
"cg16930407",1,0,0,1,2
"cg16930733",0,0,1,0,1
"cg16930947",169,87,1,0,257
"cg16933967",7,0,0,0,7
"cg16934357",2,2,0,0,4
"cg16935370",0,0,1,0,1
"cg16935913",1,0,0,0,1
"cg16936273",50,14,1,0,65
"cg16936867",1,0,0,0,1
"cg16937266",160,7,0,0,167
"cg16937468",0,0,1,0,1
"cg16940316",2,5,0,0,7
"cg16940803",19,0,0,0,19
"cg16943087",642,19,0,0,661
"cg16943505",0,4,0,0,4
"cg16944208",3,1,0,0,4
"cg16944496",18,3,0,0,21
"cg16945378",7,8,1,0,16
"cg16946997",1,0,0,0,1
"cg16947555",1,0,0,0,1
"cg16950616",1,0,0,0,1
"cg16951163",1,2,1,0,4
"cg16951730",1,2,22,0,25
"cg16951815",0,0,0,1,1
"cg16952109",5,1,0,0,6
"cg16953114",1,0,0,0,1
"cg16953753",294,135,15,0,444
"cg16953845",3,1,0,0,4
"cg16954629",0,1,0,0,1
"cg16955823",0,1,1,0,2
"cg16957126",0,0,1,0,1
"cg16957514",0,1,0,0,1
"cg16957902",16,0,2,0,18
"cg16959941",1,0,0,0,1
"cg16960213",1,0,0,0,1
"cg16960797",784,544,11,0,1339
"cg16961048",2,0,0,0,2
"cg16961080",0,2,0,0,2
"cg16961168",0,0,1,0,1
"cg16962838",1,2,1,0,4
"cg16963656",1,0,0,0,1
"cg16964102",0,0,1,0,1
"cg16964533",0,1,5,0,6
"cg16966246",0,0,1,0,1
"cg16966958",0,1,0,0,1
"cg16967722",1,0,0,0,1
"cg16968130",0,0,1,0,1
"cg16969772",38,3,1,0,42
"cg16971126",2,0,0,0,2
"cg16971885",0,1,1,0,2
"cg16972057",1,0,0,0,1
"cg16972833",0,1,0,0,1
"cg16973203",0,0,1,0,1
"cg16973650",11,6,4,0,21
"cg16974915",0,0,1,0,1
"cg16976419",1,3,0,0,4
"cg16977147",0,0,0,1,1
"cg16977304",0,1,1,0,2
"cg16978449",1,0,0,0,1
"cg16978673",1,0,0,0,1
"cg16980321",0,0,1,0,1
"cg16981006",0,0,2,0,2
"cg16982658",0,0,1,0,1
"cg16984019",130,9,1,0,140
"cg16984151",114,4,0,0,118
"cg16985363",0,2,0,0,2
"cg16985752",1,0,0,0,1
"cg16986096",0,1,1,0,2
"cg16986499",0,0,1,0,1
"cg16986846",1,0,0,0,1
"cg16987848",0,0,1,0,1
"cg16988185",0,0,1,0,1
"cg16989332",49,111,28,0,188
"cg16989646",0,1,0,0,1
"cg16989680",0,1,0,0,1
"cg16989714",29,29,7,0,65
"cg16990083",0,0,1,0,1
"cg16990892",0,0,0,1,1
"cg16992268",0,0,1,0,1
"cg16993797",10,1,0,0,11
"cg16994330",0,0,5,0,5
"cg16994872",2,0,0,0,2
"cg16996343",6,6,1,0,13
"cg16996746",26,137,186,0,349
"cg16997188",887,52,2,0,941
"cg16999568",1,7,1,0,9
"cg17000343",0,2,18,0,20
"cg17000363",5,2,0,0,7
"cg17001531",0,2,0,0,2
"cg17002126",0,7,0,0,7
"cg17002216",0,1,1,0,2
"cg17002713",0,0,3,0,3
"cg17002771",3,2,1,0,6
"cg17003221",0,1,0,0,1
"cg17004212",0,1,0,0,1
"cg17004975",1,2,0,0,3
"cg17005068",16,0,0,0,16
"cg17005446",0,3,2,0,5
"cg17006026",1,2,0,0,3
"cg17006143",0,1,0,0,1
"cg17006199",534,37,0,0,571
"cg17006667",8,1,0,0,9
"cg17007647",0,1,0,0,1
"cg17007677",0,1,0,0,1
"cg17008031",0,0,1,0,1
"cg17008454",0,1,0,0,1
"cg17009073",0,0,2,0,2
"cg17009574",1,0,1,0,2
"cg17009836",2,0,1,0,3
"cg17011276",0,1,0,0,1
"cg17012346",2,3,0,0,5
"cg17012465",7,1,0,0,8
"cg17013002",1,0,0,0,1
"cg17013870",559,750,48,0,1357
"cg17014035",2,0,0,0,2
"cg17014718",0,1,1,0,2
"cg17014927",3,0,0,0,3
"cg17015234",0,0,1,0,1
"cg17016136",86,611,22,0,719
"cg17016258",1,1,0,0,2
"cg17016483",1,0,0,0,1
"cg17017539",0,0,2,0,2
"cg17018505",0,1,0,0,1
"cg17019032",1,0,0,0,1
"cg17020464",0,0,1,0,1
"cg17020497",0,1,1,0,2
"cg17022953",2,2,1,0,5
"cg17023122",0,0,2,0,2
"cg17023631",0,0,1,0,1
"cg17023679",1,1,0,0,2
"cg17025087",63,53,2,0,118
"cg17026245",8,3,2,1,14
"cg17026542",0,0,1,0,1
"cg17027033",121,322,239,0,682
"cg17027952",3,1,1,0,5
"cg17028450",1,1,0,0,2
"cg17029089",0,0,2,0,2
"cg17029207",0,4,0,0,4
"cg17029374",313,164,5,0,482
"cg17029786",0,6,1,0,7
"cg17030721",0,3,2,0,5
"cg17031457",1,0,0,0,1
"cg17032037",1,124,1,0,126
"cg17032383",146,522,50,0,718
"cg17033185",3,1,0,0,4
"cg17035513",165,425,74,0,664
"cg17035591",1,0,1,0,2
"cg17036492",0,1,3,0,4
"cg17036978",1,0,0,0,1
"cg17038096",97,3,0,0,100
"cg17038417",14,9,1,0,24
"cg17038764",0,6,3,0,9
"cg17038857",1,0,0,0,1
"cg17039011",1,0,1,0,2
"cg17039384",0,0,1,0,1
"cg17040037",0,1,0,0,1
"cg17040156",2,3,0,0,5
"cg17040753",0,0,2,0,2
"cg17043072",0,0,2,0,2
"cg17043191",23,1,0,0,24
"cg17043637",5,0,0,0,5
"cg17043651",0,4,1,0,5
"cg17043922",0,0,1,0,1
"cg17045138",1,0,0,0,1
"cg17045790",0,0,2,0,2
"cg17045844",3,0,0,0,3
"cg17046348",1,0,0,0,1
"cg17048610",1,0,0,0,1
"cg17048660",0,0,1,0,1
"cg17049705",14,1,0,0,15
"cg17049825",0,2,0,0,2
"cg17050704",1,3,0,0,4
"cg17050807",1,1,0,0,2
"cg17050937",128,5,0,0,133
"cg17051239",0,0,1,0,1
"cg17051552",72,455,6,0,533
"cg17051831",0,2,0,0,2
"cg17052045",1,6,10,0,17
"cg17052441",1,0,0,0,1
"cg17053590",0,0,1,0,1
"cg17053678",0,0,2,0,2
"cg17054045",0,0,1,0,1
"cg17054485",4,0,0,0,4
"cg17054879",0,2,0,0,2
"cg17055585",0,0,1,0,1
"cg17055734",0,0,1,0,1
"cg17055895",9,3,0,0,12
"cg17056364",0,0,1,0,1
"cg17056835",0,0,1,0,1
"cg17057705",1,0,0,0,1
"cg17061710",0,0,6,0,6
"cg17061953",0,0,2,0,2
"cg17063158",0,0,2,0,2
"cg17063731",244,512,46,0,802
"cg17064927",0,0,1,0,1
"cg17065011",88,32,4,0,124
"cg17065810",34,6,0,0,40
"cg17067087",545,57,0,0,602
"cg17067847",1,0,1,0,2
"cg17068675",2,0,1,0,3
"cg17069261",4,0,0,0,4
"cg17069395",48,45,0,0,93
"cg17073659",2,0,0,0,2
"cg17074017",0,1,0,0,1
"cg17074173",0,0,1,0,1
"cg17074215",0,0,1,0,1
"cg17075151",18,4,1,0,23
"cg17075189",1,0,0,0,1
"cg17075252",1,0,0,0,1
"cg17075461",1,0,0,0,1
"cg17076573",0,0,1,0,1
"cg17078136",148,27,2,0,177
"cg17079026",4,3,1,0,8
"cg17079455",39,2,0,0,41
"cg17079919",0,1,1,0,2
"cg17080144",111,54,12,0,177
"cg17082285",1,0,0,0,1
"cg17082366",49,42,0,0,91
"cg17082990",0,0,1,0,1
"cg17083321",5,2,0,0,7
"cg17084199",5,0,0,0,5
"cg17085004",26,23,4,0,53
"cg17085688",0,0,1,0,1
"cg17086219",11,16,22,0,49
"cg17086230",0,0,1,0,1
"cg17086791",8,0,0,0,8
"cg17086808",0,1,0,0,1
"cg17088011",5,2,0,0,7
"cg17088187",1,0,0,0,1
"cg17090605",10,0,0,0,10
"cg17092027",1,0,1,0,2
"cg17092583",0,1,7,0,8
"cg17092609",4,0,0,0,4
"cg17092637",0,0,1,1,2
"cg17092860",380,63,3,0,446
"cg17093237",0,1,0,0,1
"cg17093478",4,0,0,0,4
"cg17093485",1,0,0,0,1
"cg17094268",1,0,0,0,1
"cg17095167",2,0,0,0,2
"cg17095216",1,1,2,0,4
"cg17095912",0,1,0,0,1
"cg17096979",1,0,0,0,1
"cg17097119",158,3,0,0,161
"cg17097312",0,1,1,0,2
"cg17098255",4,1,0,0,5
"cg17099306",1,0,0,0,1
"cg17099931",9,0,0,0,9
"cg17103026",3,0,0,0,3
"cg17106602",5,1,2,0,8
"cg17108095",1,0,0,0,1
"cg17108676",0,0,5,0,5
"cg17108748",0,1,5,0,6
"cg17108836",20,2,0,0,22
"cg17109011",1,0,0,0,1
"cg17109374",0,5,0,0,5
"cg17109442",0,1,0,0,1
"cg17110702",0,0,1,0,1
"cg17111346",2,7,11,0,20
"cg17113117",0,0,1,0,1
"cg17114402",0,1,1,0,2
"cg17114851",20,0,0,0,20
"cg17114866",1,1,0,0,2
"cg17116694",149,571,30,0,750
"cg17117871",7,1,0,0,8
"cg17118330",0,1,1,0,2
"cg17119525",1,1,0,0,2
"cg17120654",11,0,0,0,11
"cg17121704",0,0,1,0,1
"cg17121888",1,0,0,0,1
"cg17122301",170,13,1,0,184
"cg17122456",0,0,2,0,2
"cg17122475",0,0,1,0,1
"cg17123714",0,0,1,0,1
"cg17125719",1,0,0,0,1
"cg17125897",0,1,1,0,2
"cg17126297",0,1,0,0,1
"cg17127291",1,6,18,0,25
"cg17127390",123,4,0,0,127
"cg17127610",0,0,3,0,3
"cg17127929",0,0,1,0,1
"cg17128082",144,4,0,0,148
"cg17128256",0,0,2,0,2
"cg17130160",1,2,7,0,10
"cg17130882",0,1,0,0,1
"cg17131252",3,3,0,0,6
"cg17131580",5,0,0,0,5
"cg17131949",2,0,1,0,3
"cg17132591",15,3,0,0,18
"cg17132967",3,0,0,0,3
"cg17136489",0,0,1,0,1
"cg17139028",0,1,3,0,4
"cg17139213",1,0,0,0,1
"cg17140103",5,0,0,0,5
"cg17140133",39,3,0,0,42
"cg17140381",0,0,1,0,1
"cg17140902",0,7,1,0,8
"cg17141370",0,0,2,0,2
"cg17141667",233,47,1,0,281
"cg17141912",12,2,0,0,14
"cg17142105",0,1,0,0,1
"cg17143168",0,1,0,0,1
"cg17143303",0,1,0,0,1
"cg17143459",0,0,1,0,1
"cg17144446",0,1,0,0,1
"cg17145196",2,0,0,0,2
"cg17145388",0,0,1,0,1
"cg17145862",0,0,1,0,1
"cg17145983",0,1,0,0,1
"cg17146111",0,0,2,0,2
"cg17146127",4,0,0,0,4
"cg17146172",0,0,1,0,1
"cg17146558",2,7,2,0,11
"cg17146638",116,207,8,0,331
"cg17147317",0,0,1,0,1
"cg17147391",0,0,0,1,1
"cg17147758",1,9,9,0,19
"cg17148245",1,1,0,0,2
"cg17148379",62,31,0,0,93
"cg17149495",0,5,0,0,5
"cg17149751",0,0,3,1,4
"cg17150074",10,0,0,0,10
"cg17150091",2,0,0,0,2
"cg17150169",1,0,0,0,1
"cg17150495",1,0,0,0,1
"cg17152989",0,0,1,0,1
"cg17153078",12,9,0,0,21
"cg17153685",0,0,4,0,4
"cg17154629",0,1,0,0,1
"cg17155115",1,0,0,0,1
"cg17155417",1,1,0,0,2
"cg17156464",0,0,1,0,1
"cg17156677",0,0,1,0,1
"cg17157466",0,1,0,0,1
"cg17158811",1,0,1,0,2
"cg17160203",1,0,0,0,1
"cg17160329",28,37,13,0,78
"cg17161483",0,1,1,0,2
"cg17164315",14,3,0,0,17
"cg17164474",1,0,0,0,1
"cg17164520",1,8,2,0,11
"cg17165218",4,18,10,0,32
"cg17166067",0,0,2,0,2
"cg17166941",0,1,0,0,1
"cg17167278",0,4,0,0,4
"cg17167790",0,1,0,0,1
"cg17167807",16,0,0,0,16
"cg17168000",0,1,0,0,1
"cg17168519",0,0,1,0,1
"cg17169510",3,1,0,0,4
"cg17170942",1,0,0,0,1
"cg17171938",2,0,0,0,2
"cg17171976",0,0,2,0,2
"cg17172071",4,0,0,0,4
"cg17172316",0,0,2,0,2
"cg17173227",0,0,2,0,2
"cg17173442",3,2,0,0,5
"cg17174845",17,89,78,0,184
"cg17175026",4,0,2,0,6
"cg17175893",0,0,1,0,1
"cg17176894",1,0,0,0,1
"cg17176978",1220,182,2,0,1404
"cg17177528",1,0,0,0,1
"cg17178504",3,7,20,0,30
"cg17179051",12,0,0,0,12
"cg17179589",0,0,1,0,1
"cg17179684",0,0,1,0,1
"cg17179792",0,1,1,0,2
"cg17181092",1,0,0,0,1
"cg17181158",0,0,1,0,1
"cg17181476",2,2,1,0,5
"cg17181956",0,1,1,0,2
"cg17182002",747,72,4,0,823
"cg17182446",413,84,13,0,510
"cg17184448",0,0,1,0,1
"cg17184855",0,1,2,0,3
"cg17185068",0,0,1,0,1
"cg17185176",166,143,27,0,336
"cg17186328",0,0,1,0,1
"cg17186990",0,1,0,0,1
"cg17189167",1,1,0,0,2
"cg17189664",0,0,0,1,1
"cg17189893",0,0,1,1,2
"cg17190363",5,0,0,0,5
"cg17190602",0,6,0,0,6
"cg17191791",0,1,0,0,1
"cg17192034",1,3,2,0,6
"cg17193155",1,10,5,0,16
"cg17193281",14,0,0,0,14
"cg17193436",1,0,0,0,1
"cg17193532",1,0,0,0,1
"cg17194129",0,0,2,0,2
"cg17195606",3,0,0,0,3
"cg17196244",4,0,0,0,4
"cg17196681",1,0,0,0,1
"cg17196946",1,0,0,0,1
"cg17197051",6,0,0,0,6
"cg17198200",116,74,3,0,193
"cg17198360",0,0,1,0,1
"cg17201409",1,2,0,0,3
"cg17201535",0,2,0,0,2
"cg17202109",0,0,3,0,3
"cg17202706",0,0,1,0,1
"cg17203027",0,0,1,0,1
"cg17203119",6,1,0,0,7
"cg17204012",0,2,21,0,23
"cg17204288",0,8,6,0,14
"cg17204510",2,0,0,0,2
"cg17204569",1,0,1,0,2
"cg17204652",2,1,0,0,3
"cg17206564",4,1,0,0,5
"cg17207064",1,0,0,0,1
"cg17207170",6,3,0,0,9
"cg17207454",0,1,1,0,2
"cg17208974",0,0,1,0,1
"cg17209059",0,0,1,0,1
"cg17209231",699,817,38,0,1554
"cg17210130",217,464,66,0,747
"cg17210929",0,0,1,0,1
"cg17212184",0,0,2,0,2
"cg17213445",0,0,0,1,1
"cg17213462",0,0,1,0,1
"cg17214222",289,240,4,0,533
"cg17214351",0,0,4,0,4
"cg17214383",1,2,0,0,3
"cg17215065",0,0,1,0,1
"cg17215399",0,0,5,0,5
"cg17215497",1,1,0,0,2
"cg17216380",0,0,1,0,1
"cg17216506",1,0,0,0,1
"cg17218342",0,1,0,0,1
"cg17219203",0,1,0,0,1
"cg17219689",313,217,0,0,530
"cg17219828",13,9,0,0,22
"cg17220512",0,2,1,2,5
"cg17220983",1,0,2,0,3
"cg17221315",0,0,1,0,1
"cg17222152",0,3,0,0,3
"cg17222879",74,72,0,0,146
"cg17223971",5,1,0,0,6
"cg17225479",0,1,0,0,1
"cg17225947",5,3,0,0,8
"cg17226303",1,1,5,0,7
"cg17226602",0,0,1,0,1
"cg17228560",1,0,0,0,1
"cg17231524",1,0,0,0,1
"cg17231600",0,1,3,0,4
"cg17232111",0,0,3,0,3
"cg17232271",0,1,0,0,1
"cg17232303",0,0,2,0,2
"cg17232609",0,1,0,0,1
"cg17233998",0,0,3,0,3
"cg17234520",0,0,1,0,1
"cg17235151",0,1,1,0,2
"cg17236027",0,1,0,0,1
"cg17236673",0,1,0,0,1
"cg17236994",1,1,0,0,2
"cg17239568",1,0,0,0,1
"cg17240039",0,0,1,0,1
"cg17240450",0,0,1,0,1
"cg17240701",47,24,0,0,71
"cg17240885",27,5,0,0,32
"cg17240934",1,0,0,0,1
"cg17242812",1,0,4,0,5
"cg17243044",1,0,0,0,1
"cg17243582",0,0,1,0,1
"cg17243872",228,166,17,0,411
"cg17243957",0,0,3,0,3
"cg17244002",0,0,1,0,1
"cg17245495",1,0,0,0,1
"cg17247131",0,0,4,0,4
"cg17249974",18,0,0,0,18
"cg17250037",0,0,1,0,1
"cg17251843",3,1,2,0,6
"cg17254384",9,7,2,0,18
"cg17254442",1,0,1,0,2
"cg17254454",4,1,0,0,5
"cg17255144",0,1,5,0,6
"cg17255150",1,0,0,0,1
"cg17255714",3,0,0,0,3
"cg17255939",3,0,0,0,3
"cg17256152",2,4,1,0,7
"cg17256240",1,0,1,0,2
"cg17256697",1,0,0,0,1
"cg17256729",2,2,0,0,4
"cg17256930",1,0,0,0,1
"cg17258140",0,0,3,0,3
"cg17258393",1,0,0,0,1
"cg17258727",4,1,0,0,5
"cg17259334",0,1,0,0,1
"cg17260058",33,5,0,0,38
"cg17260274",0,1,0,0,1
"cg17260591",2,0,0,0,2
"cg17261118",0,0,1,0,1
"cg17261189",1,1,0,0,2
"cg17261508",2,0,0,0,2
"cg17264299",0,1,1,0,2
"cg17264650",0,0,4,0,4
"cg17264834",1,0,1,0,2
"cg17265330",1,1,0,0,2
"cg17265790",8,1,0,0,9
"cg17266153",18,1,0,0,19
"cg17266238",0,0,2,0,2
"cg17266690",10,3,0,0,13
"cg17266935",1,0,0,0,1
"cg17267064",0,1,0,0,1
"cg17267239",1,0,0,0,1
"cg17267396",2,0,0,0,2
"cg17267508",7,0,0,0,7
"cg17267720",1,2,0,0,3
"cg17267907",0,0,1,0,1
"cg17268033",3,0,0,0,3
"cg17268245",0,1,0,0,1
"cg17268699",0,0,1,0,1
"cg17268801",2,0,0,0,2
"cg17269361",1,0,0,0,1
"cg17269548",1,0,1,0,2
"cg17269565",4,9,4,0,17
"cg17270234",0,0,1,0,1
"cg17270370",2,0,0,0,2
"cg17270736",2,0,0,0,2
"cg17271494",5,1,0,0,6
"cg17271683",0,0,1,0,1
"cg17272374",0,0,1,0,1
"cg17273919",15,108,496,0,619
"cg17274013",0,0,1,0,1
"cg17274288",2,3,0,0,5
"cg17274357",1,2,1,0,4
"cg17274387",0,1,0,0,1
"cg17274497",0,1,0,0,1
"cg17274881",0,1,0,0,1
"cg17275311",0,0,1,0,1
"cg17275432",3,4,2,0,9
"cg17275695",10,0,0,0,10
"cg17275991",0,0,1,0,1
"cg17276329",0,0,1,0,1
"cg17276647",2,3,3,0,8
"cg17276837",2,0,0,0,2
"cg17278295",1,0,0,0,1
"cg17278419",0,0,1,0,1
"cg17278468",0,0,1,0,1
"cg17278472",25,2,0,0,27
"cg17278595",1,0,0,0,1
"cg17278793",0,0,2,0,2
"cg17278839",0,1,0,0,1
"cg17279773",2,0,0,0,2
"cg17281073",298,10,1,0,309
"cg17281297",52,1,0,0,53
"cg17281975",0,1,0,0,1
"cg17281984",6,0,0,0,6
"cg17281993",0,0,1,0,1
"cg17282539",2,0,0,0,2
"cg17284137",0,0,1,0,1
"cg17284440",0,0,0,1,1
"cg17284568",371,763,51,0,1185
"cg17284963",40,3,0,0,43
"cg17285397",3,3,6,0,12
"cg17285822",5,1,0,0,6
"cg17286284",1,0,0,0,1
"cg17286435",4,7,0,0,11
"cg17286719",0,1,1,0,2
"cg17286976",45,3,0,0,48
"cg17287188",1,0,1,0,2
"cg17287630",0,0,2,0,2
"cg17288382",0,1,0,0,1
"cg17290718",9,0,0,0,9
"cg17290897",0,0,2,0,2
"cg17291906",1,0,0,0,1
"cg17293429",1,1,0,0,2
"cg17294040",0,1,2,0,3
"cg17295720",0,1,1,0,2
"cg17295908",2,0,0,0,2
"cg17296650",0,1,0,0,1
"cg17296753",5,1,1,0,7
"cg17296881",0,0,2,0,2
"cg17298733",619,10,1,0,630
"cg17298859",1,2,0,0,3
"cg17299174",0,0,2,0,2
"cg17299451",510,11,0,0,521
"cg17299712",0,0,1,0,1
"cg17300602",8,1,0,0,9
"cg17300966",7,2,0,0,9
"cg17303578",27,0,0,0,27
"cg17303795",0,1,0,0,1
"cg17303851",1,0,0,0,1
"cg17304089",1,0,0,0,1
"cg17304585",0,1,5,0,6
"cg17305128",40,3,0,0,43
"cg17305529",4,0,0,0,4
"cg17305802",13,5,0,0,18
"cg17306624",1,0,0,0,1
"cg17306802",0,1,1,0,2
"cg17306975",14,0,0,0,14
"cg17307919",1,0,0,0,1
"cg17308840",0,0,5,0,5
"cg17309074",322,154,16,0,492
"cg17309610",0,2,0,0,2
"cg17310037",229,11,0,0,240
"cg17310754",2,0,0,0,2
"cg17311564",0,0,2,0,2
"cg17311649",4,0,0,0,4
"cg17313031",0,0,2,0,2
"cg17313244",4,3,0,0,7
"cg17313621",0,0,0,1,1
"cg17316316",0,0,1,0,1
"cg17317274",3,2,0,0,5
"cg17317359",3,1,12,0,16
"cg17317635",0,1,0,0,1
"cg17317869",0,0,1,0,1
"cg17318081",0,1,0,0,1
"cg17319290",3,0,1,0,4
"cg17320316",0,1,0,0,1
"cg17320702",2,1,0,0,3
"cg17320988",0,0,1,0,1
"cg17321607",0,2,1,0,3
"cg17322396",52,78,39,0,169
"cg17322668",22,5,1,0,28
"cg17324941",1,1,0,0,2
"cg17325094",1,0,0,0,1
"cg17325640",4,0,0,0,4
"cg17326173",0,7,4,0,11
"cg17326327",0,0,1,0,1
"cg17326875",2,2,3,0,7
"cg17326994",95,164,5,0,264
"cg17327934",1,7,5,0,13
"cg17327986",1,0,3,0,4
"cg17329835",56,62,3,0,121
"cg17330505",0,1,0,0,1
"cg17331065",1,1,0,0,2
"cg17331757",6,0,0,0,6
"cg17332295",2,1,0,0,3
"cg17332379",0,2,0,0,2
"cg17333109",2,0,0,0,2
"cg17334646",0,2,1,0,3
"cg17334970",1,0,0,0,1
"cg17335617",0,0,1,0,1
"cg17336423",1,0,0,0,1
"cg17336768",1,0,1,0,2
"cg17336866",2,0,0,0,2
"cg17337695",0,1,0,0,1
"cg17337782",1,0,0,0,1
"cg17338219",3,0,0,0,3
"cg17338368",110,329,75,0,514
"cg17338411",0,0,1,0,1
"cg17338443",0,0,1,0,1
"cg17338969",0,2,3,0,5
"cg17340058",0,0,1,0,1
"cg17340268",5,2,0,0,7
"cg17340556",1,0,0,0,1
"cg17341790",2,0,3,0,5
"cg17342360",1,1,1,0,3
"cg17342491",2,0,0,0,2
"cg17346866",1,2,0,0,3
"cg17347851",0,1,1,0,2
"cg17349143",0,0,2,0,2
"cg17349654",1,3,1,0,5
"cg17350690",0,1,0,0,1
"cg17351951",1,0,0,0,1
"cg17353079",0,2,0,0,2
"cg17353896",0,0,1,0,1
"cg17354521",9,3,0,0,12
"cg17355083",3,0,0,0,3
"cg17355791",1,1,2,0,4
"cg17357698",4,1,0,0,5
"cg17357984",1,0,0,0,1
"cg17360047",0,1,0,0,1
"cg17360336",391,1380,151,0,1922
"cg17361070",1,0,0,0,1
"cg17361124",2,0,0,0,2
"cg17361593",1,1,0,0,2
"cg17362247",0,3,0,0,3
"cg17362321",0,1,0,0,1
"cg17362479",0,1,0,0,1
"cg17362833",0,1,0,0,1
"cg17363118",1,0,0,0,1
"cg17364580",0,1,0,0,1
"cg17365377",5,11,0,0,16
"cg17366081",550,6,1,0,557
"cg17367367",3,2,0,0,5
"cg17367457",238,555,20,0,813
"cg17367551",1,0,0,0,1
"cg17368114",0,1,0,0,1
"cg17368632",3,4,0,0,7
"cg17369452",1,0,0,0,1
"cg17370272",0,0,1,0,1
"cg17370404",0,1,0,0,1
"cg17370458",2,4,0,0,6
"cg17370647",0,1,0,0,1
"cg17370766",1,1,0,0,2
"cg17371000",6,0,2,0,8
"cg17371487",0,1,1,0,2
"cg17372841",5,7,6,0,18
"cg17376015",0,0,1,0,1
"cg17376141",1,0,0,0,1
"cg17376206",0,0,0,1,1
"cg17376820",1,0,0,0,1
"cg17376861",0,1,1,0,2
"cg17377802",1,1,0,0,2
"cg17378066",22,1,0,0,23
"cg17378387",15,2,0,0,17
"cg17378655",1,0,0,0,1
"cg17380160",2,0,0,0,2
"cg17380780",0,2,0,0,2
"cg17381013",9,0,0,0,9
"cg17381139",24,2,0,0,26
"cg17381781",7,7,1,0,15
"cg17382950",1,0,0,0,1
"cg17383024",0,2,0,0,2
"cg17384733",2,0,0,0,2
"cg17385749",0,1,0,0,1
"cg17386050",85,32,2,0,119
"cg17386934",0,1,0,0,1
"cg17387749",5,0,0,0,5
"cg17388149",2,0,0,0,2
"cg17388912",0,0,0,2,2
"cg17390497",7,0,1,0,8
"cg17391104",1,0,0,0,1
"cg17391339",4,0,0,0,4
"cg17391518",2,0,0,0,2
"cg17391569",1,0,0,0,1
"cg17392334",7,2,0,0,9
"cg17392618",14,4,0,0,18
"cg17393272",0,0,3,0,3
"cg17393309",0,1,0,0,1
"cg17393974",10,2,0,0,12
"cg17394170",1,0,0,0,1
"cg17394506",2,0,0,0,2
"cg17394623",0,0,1,0,1
"cg17394888",1,0,0,0,1
"cg17395272",0,0,1,0,1
"cg17397424",0,1,0,0,1
"cg17398003",0,0,1,0,1
"cg17399795",1,0,0,0,1
"cg17402045",0,1,0,0,1
"cg17404186",0,0,6,0,6
"cg17404532",0,0,1,0,1
"cg17406445",0,0,1,0,1
"cg17407331",0,1,0,0,1
"cg17407908",0,0,1,0,1
"cg17408314",0,0,2,0,2
"cg17408673",0,2,0,0,2
"cg17409405",1,1,1,0,3
"cg17409876",1,0,0,0,1
"cg17410803",10,0,0,0,10
"cg17411424",0,0,4,0,4
"cg17412069",6,0,0,0,6
"cg17412165",0,0,1,0,1
"cg17412240",0,0,0,1,1
"cg17412528",0,0,2,0,2
"cg17412580",0,1,0,0,1
"cg17412632",161,9,0,0,170
"cg17412974",4,5,1,0,10
"cg17413349",0,0,1,0,1
"cg17413865",1,0,0,0,1
"cg17414312",11,1,0,0,12
"cg17414733",1,0,0,0,1
"cg17416231",174,24,3,0,201
"cg17417318",0,0,3,0,3
"cg17417347",1,4,1,0,6
"cg17418407",171,5,0,0,176
"cg17418579",0,0,1,0,1
"cg17419451",0,0,2,0,2
"cg17420470",0,0,1,0,1
"cg17420968",1,1,0,0,2
"cg17420980",0,0,1,0,1
"cg17421062",0,0,2,0,2
"cg17422543",0,1,0,0,1
"cg17423209",0,3,3,0,6
"cg17424134",0,4,5,0,9
"cg17424822",0,0,1,0,1
"cg17424859",0,2,0,0,2
"cg17425216",1,0,0,0,1
"cg17428089",0,0,2,0,2
"cg17430270",1,0,0,0,1
"cg17430636",0,0,1,0,1
"cg17430714",2,0,0,0,2
"cg17431023",0,0,1,0,1
"cg17431380",1,0,0,0,1
"cg17432154",2,1,2,0,5
"cg17432289",0,1,0,0,1
"cg17435182",354,39,0,0,393
"cg17435824",1,1,0,0,2
"cg17437567",0,3,2,0,5
"cg17438211",1,0,0,0,1
"cg17439357",53,24,1,0,78
"cg17440987",396,56,0,0,452
"cg17442269",2,0,0,0,2
"cg17442546",0,1,0,0,1
"cg17442548",0,0,1,0,1
"cg17442776",1,6,4,0,11
"cg17444493",129,93,33,0,255
"cg17444600",1,0,0,0,1
"cg17445273",0,0,1,0,1
"cg17447300",64,360,67,0,491
"cg17447517",1,0,1,0,2
"cg17447518",1,0,2,0,3
"cg17448023",4,0,0,0,4
"cg17448072",0,5,14,0,19
"cg17448109",156,468,118,0,742
"cg17448513",1,1,0,0,2
"cg17450090",0,0,1,0,1
"cg17451771",1,0,0,0,1
"cg17451855",1,0,0,0,1
"cg17451879",0,1,0,0,1
"cg17453598",2,0,0,0,2
"cg17454427",102,14,1,0,117
"cg17455847",0,0,2,0,2
"cg17456545",0,0,1,0,1
"cg17458425",0,0,1,0,1
"cg17458486",0,0,2,0,2
"cg17459022",0,0,1,0,1
"cg17459443",0,0,1,0,1
"cg17460597",3,0,0,0,3
"cg17461271",0,1,0,0,1
"cg17463959",0,0,1,0,1
"cg17464196",0,5,1,0,6
"cg17464807",0,0,1,0,1
"cg17465408",3,0,0,0,3
"cg17465549",1,0,0,0,1
"cg17466102",70,8,0,0,78
"cg17467879",1,0,0,0,1
"cg17468640",2,1,0,0,3
"cg17470449",0,0,3,0,3
"cg17470527",14,0,0,0,14
"cg17471456",254,343,17,0,614
"cg17472297",3,0,1,0,4
"cg17472979",1,0,0,0,1
"cg17473580",0,0,4,0,4
"cg17473905",4,2,0,0,6
"cg17474338",1,2,0,0,3
"cg17474665",1,0,0,0,1
"cg17474839",1,1,0,0,2
"cg17474924",2,0,0,0,2
"cg17475084",6,1,0,0,7
"cg17475269",1,0,0,0,1
"cg17475918",1,0,0,0,1
"cg17475960",1,0,0,0,1
"cg17476056",1,0,0,0,1
"cg17476752",2,0,0,0,2
"cg17476835",0,1,0,0,1
"cg17477380",0,1,0,0,1
"cg17479192",1,0,0,0,1
"cg17479811",3,1,1,0,5
"cg17480368",1,1,1,0,3
"cg17480546",1,0,0,0,1
"cg17480781",0,4,0,0,4
"cg17480803",0,1,0,0,1
"cg17482089",0,1,0,0,1
"cg17482273",90,344,208,0,642
"cg17483411",1,0,0,0,1
"cg17483590",0,0,1,0,1
"cg17484267",5,0,0,0,5
"cg17485924",0,0,0,1,1
"cg17486639",3,0,0,0,3
"cg17487010",0,1,0,0,1
"cg17487301",462,162,4,0,628
"cg17487999",1,0,0,0,1
"cg17488357",0,2,3,0,5
"cg17488939",15,2,0,0,17
"cg17489280",3,0,0,0,3
"cg17489282",123,189,39,0,351
"cg17489876",0,0,2,0,2
"cg17489897",0,1,0,0,1
"cg17489999",52,29,34,0,115
"cg17491656",651,143,2,0,796
"cg17491915",193,42,4,0,239
"cg17492495",0,1,0,0,1
"cg17493004",0,0,1,0,1
"cg17493574",900,537,15,0,1452
"cg17493653",0,0,1,0,1
"cg17495291",7,0,0,0,7
"cg17495836",44,2,0,0,46
"cg17495943",0,0,1,0,1
"cg17496540",18,8,1,0,27
"cg17496869",0,1,0,0,1
"cg17496899",1,0,0,0,1
"cg17497187",1,1,0,0,2
"cg17500282",1,0,0,0,1
"cg17501386",0,0,1,0,1
"cg17501452",389,162,7,0,558
"cg17501828",2,5,3,1,11
"cg17503027",0,0,1,0,1
"cg17503439",0,0,1,0,1
"cg17503823",0,1,0,0,1
"cg17504737",1,0,0,0,1
"cg17504767",0,2,0,0,2
"cg17504841",0,1,0,0,1
"cg17505409",1,1,0,0,2
"cg17505463",0,0,1,0,1
"cg17505557",17,3,0,0,20
"cg17506437",2,1,0,0,3
"cg17508063",1,0,0,0,1
"cg17508591",5,2,0,0,7
"cg17508894",0,1,5,0,6
"cg17509107",1,0,0,0,1
"cg17510601",9,1,0,0,10
"cg17510910",0,0,2,0,2
"cg17511151",0,0,1,0,1
"cg17511829",0,0,4,0,4
"cg17511873",1,0,0,0,1
"cg17512035",0,0,1,0,1
"cg17512180",125,11,0,0,136
"cg17512365",1,2,1,0,4
"cg17512367",4,7,0,0,11
"cg17512799",0,1,0,0,1
"cg17512893",163,10,0,0,173
"cg17514245",0,0,1,0,1
"cg17514291",5,2,0,0,7
"cg17514757",1,0,0,0,1
"cg17517480",0,0,1,0,1
"cg17517737",1,0,0,0,1
"cg17518613",0,0,1,0,1
"cg17518818",857,23,0,0,880
"cg17518884",0,0,0,1,1
"cg17519037",0,0,1,0,1
"cg17520159",0,1,0,0,1
"cg17520270",0,0,1,0,1
"cg17521070",0,0,1,0,1
"cg17521526",446,245,9,0,700
"cg17521897",1,2,0,0,3
"cg17522354",6,0,0,0,6
"cg17522550",35,2,0,0,37
"cg17523663",1,0,0,0,1
"cg17524162",0,1,0,0,1
"cg17526060",10,2,0,0,12
"cg17529235",0,1,0,0,1
"cg17529553",0,0,1,0,1
"cg17530841",259,260,27,0,546
"cg17530918",0,0,3,0,3
"cg17531228",1,0,0,0,1
"cg17532112",3,7,1,0,11
"cg17533477",1,0,0,0,1
"cg17533522",0,0,1,0,1
"cg17533780",1,0,0,0,1
"cg17536917",0,1,1,0,2
"cg17537596",0,0,1,0,1
"cg17542097",50,2,4,0,56
"cg17543884",5,0,1,0,6
"cg17544079",0,1,1,0,2
"cg17544636",0,5,0,0,5
"cg17545114",1,2,0,0,3
"cg17545232",5,3,2,0,10
"cg17545416",0,0,1,0,1
"cg17545435",1,0,0,0,1
"cg17546196",0,0,1,0,1
"cg17546251",6,0,1,0,7
"cg17546493",0,0,1,0,1
"cg17546822",1,0,0,0,1
"cg17547157",1,0,0,0,1
"cg17547666",0,0,1,0,1
"cg17547722",6,0,0,0,6
"cg17548533",0,1,0,0,1
"cg17548900",0,0,1,0,1
"cg17548932",3,0,0,0,3
"cg17549167",4,6,2,0,12
"cg17549878",0,1,0,0,1
"cg17551289",3,0,0,0,3
"cg17552399",1,1,0,0,2
"cg17552643",4,0,0,0,4
"cg17552650",0,1,0,0,1
"cg17553489",0,0,1,0,1
"cg17556788",0,1,0,0,1
"cg17557667",0,1,0,0,1
"cg17559292",207,17,1,0,225
"cg17560327",0,2,0,0,2
"cg17561243",0,1,0,0,1
"cg17561604",2,0,0,0,2
"cg17563447",2,0,0,0,2
"cg17563888",0,1,0,0,1
"cg17563995",136,587,0,0,723
"cg17564316",3,0,20,0,23
"cg17564553",43,7,0,0,50
"cg17565215",1,1,0,0,2
"cg17565410",255,95,9,0,359
"cg17565485",1,0,0,0,1
"cg17566167",4,0,0,0,4
"cg17566179",0,0,2,0,2
"cg17566204",1,0,0,0,1
"cg17566920",196,28,0,0,224
"cg17568448",1,0,0,0,1
"cg17568534",0,0,1,0,1
"cg17570147",0,0,1,0,1
"cg17570226",0,0,1,0,1
"cg17570261",0,2,0,0,2
"cg17570350",0,2,0,0,2
"cg17571787",0,0,1,0,1
"cg17571933",0,0,3,0,3
"cg17574078",0,1,0,0,1
"cg17574550",171,41,0,0,212
"cg17575113",1,0,0,0,1
"cg17576104",257,29,2,0,288
"cg17576127",0,1,0,0,1
"cg17576657",0,1,0,0,1
"cg17577146",1,0,0,0,1
"cg17577701",1,1,2,0,4
"cg17578653",0,1,0,0,1
"cg17579854",10,0,0,0,10
"cg17581364",3,0,0,0,3
"cg17581615",1,1,0,0,2
"cg17582466",107,227,145,0,479
"cg17582712",26,0,0,0,26
"cg17583292",0,0,1,0,1
"cg17583338",0,1,0,0,1
"cg17583499",0,0,1,0,1
"cg17585025",0,0,1,0,1
"cg17585066",0,0,1,0,1
"cg17585421",1,1,1,0,3
"cg17585507",1,0,0,0,1
"cg17585590",1,0,0,0,1
"cg17586368",399,34,1,0,434
"cg17586419",7,0,0,0,7
"cg17588171",23,1,0,0,24
"cg17588283",0,2,8,0,10
"cg17588585",3,0,1,0,4
"cg17590179",24,20,2,0,46
"cg17590224",70,10,0,0,80
"cg17590488",3,0,0,0,3
"cg17590499",3,0,2,0,5
"cg17590657",1,2,0,0,3
"cg17592461",3,0,0,0,3
"cg17592693",28,10,0,0,38
"cg17594341",0,0,1,0,1
"cg17594592",1,0,0,0,1
"cg17595655",0,1,0,0,1
"cg17597183",0,1,0,0,1
"cg17597639",0,0,1,0,1
"cg17599298",19,1,0,0,20
"cg17599379",0,0,1,0,1
"cg17599831",1,0,4,0,5
"cg17600743",1,0,0,0,1
"cg17600782",0,0,1,0,1
"cg17604953",4,0,0,0,4
"cg17605235",0,1,0,0,1
"cg17606287",0,0,1,0,1
"cg17606634",0,1,0,0,1
"cg17607116",1,0,0,0,1
"cg17607330",0,2,0,0,2
"cg17611150",0,1,0,0,1
"cg17611291",1,1,0,0,2
"cg17612342",1,0,0,0,1
"cg17613214",0,1,0,0,1
"cg17613596",0,0,3,0,3
"cg17613810",2,0,1,0,3
"cg17614939",3,1,4,0,8
"cg17615773",1,0,0,0,1
"cg17616547",0,0,1,0,1
"cg17617720",34,2,0,0,36
"cg17617900",1,0,0,0,1
"cg17618039",0,0,2,0,2
"cg17618596",1,0,0,0,1
"cg17618758",0,0,1,0,1
"cg17619053",0,0,1,0,1
"cg17619208",0,0,1,0,1
"cg17620390",0,1,0,0,1
"cg17620395",0,0,2,0,2
"cg17620576",1,2,0,0,3
"cg17621419",0,1,0,0,1
"cg17622412",4,0,0,0,4
"cg17623193",0,1,0,0,1
"cg17623751",1,0,0,0,1
"cg17625224",0,0,1,0,1
"cg17626801",1,0,0,0,1
"cg17627843",3,1,0,0,4
"cg17627973",0,1,0,0,1
"cg17630079",2,0,0,0,2
"cg17630217",0,0,1,0,1
"cg17630248",537,26,0,0,563
"cg17631198",1,5,4,0,10
"cg17631914",0,8,10,0,18
"cg17632486",0,0,1,0,1
"cg17634528",0,0,0,1,1
"cg17635013",0,1,0,0,1
"cg17636086",1,0,21,0,22
"cg17636693",0,1,0,0,1
"cg17636883",1,1,0,0,2
"cg17636934",16,13,1,0,30
"cg17637045",1,0,0,0,1
"cg17637837",0,0,3,0,3
"cg17639987",0,0,1,0,1
"cg17641041",0,1,0,0,1
"cg17642353",2,3,0,0,5
"cg17642873",1,0,0,0,1
"cg17643069",0,0,1,0,1
"cg17643402",0,1,0,0,1
"cg17644602",0,0,1,0,1
"cg17645029",0,0,1,0,1
"cg17645278",1,0,0,0,1
"cg17647597",3,2,3,0,8
"cg17649176",0,1,0,0,1
"cg17649906",0,2,0,0,2
"cg17650589",0,1,1,0,2
"cg17651095",380,49,2,0,431
"cg17652028",1,0,0,0,1
"cg17652150",1,6,1,0,8
"cg17653061",1,0,0,0,1
"cg17653341",0,1,0,0,1
"cg17654335",0,1,0,0,1
"cg17654749",1,0,0,0,1
"cg17656474",0,0,1,0,1
"cg17657921",0,0,1,0,1
"cg17658742",0,0,1,0,1
"cg17659896",0,1,0,0,1
"cg17660026",0,1,0,0,1
"cg17660945",1,0,0,0,1
"cg17662053",2,0,0,0,2
"cg17662883",1,0,0,0,1
"cg17663358",34,82,5,0,121
"cg17665024",1,0,0,0,1
"cg17665268",1,0,0,0,1
"cg17665360",2,0,0,0,2
"cg17665897",9,16,0,0,25
"cg17667105",1,0,0,0,1
"cg17669412",5,14,9,0,28
"cg17669934",835,42,0,0,877
"cg17670191",0,0,1,0,1
"cg17670496",2,0,0,0,2
"cg17671345",2,0,0,0,2
"cg17672031",47,1,0,0,48
"cg17674229",0,3,0,0,3
"cg17675199",0,4,2,0,6
"cg17675288",1,0,0,0,1
"cg17675604",0,0,1,2,3
"cg17676036",1,2,1,0,4
"cg17676129",0,0,1,0,1
"cg17676225",1,0,0,0,1
"cg17677282",2,1,0,0,3
"cg17677413",0,0,1,0,1
"cg17678343",0,0,4,0,4
"cg17678494",1,1,0,0,2
"cg17678740",0,1,0,0,1
"cg17679620",0,0,2,0,2
"cg17680558",36,7,0,0,43
"cg17680813",0,1,0,0,1
"cg17682462",1,0,0,0,1
"cg17682874",1,0,0,0,1
"cg17685111",0,0,1,0,1
"cg17685767",262,282,35,0,579
"cg17689763",0,1,4,0,5
"cg17689925",0,0,1,0,1
"cg17691208",17,0,0,0,17
"cg17692259",1,3,0,0,4
"cg17692792",0,0,1,0,1
"cg17692797",1,0,0,0,1
"cg17693013",1,0,0,0,1
"cg17696406",69,141,2,0,212
"cg17696759",2,0,0,0,2
"cg17698198",36,20,1,0,57
"cg17698261",1,0,0,0,1
"cg17699212",0,1,1,0,2
"cg17700415",14,4,0,0,18
"cg17701107",1,0,0,0,1
"cg17701575",1,0,0,0,1
"cg17703761",2,0,0,0,2
"cg17703990",0,0,1,0,1
"cg17709065",0,1,0,0,1
"cg17709104",0,1,0,0,1
"cg17709129",5,2,3,0,10
"cg17709637",0,1,0,0,1
"cg17710334",0,1,0,0,1
"cg17711091",0,1,0,0,1
"cg17711265",1,0,0,0,1
"cg17711541",2,4,0,0,6
"cg17713613",4,1,0,0,5
"cg17714031",1,0,0,0,1
"cg17714760",0,1,0,0,1
"cg17715198",767,118,3,0,888
"cg17715267",6,0,0,0,6
"cg17715358",2,4,0,0,6
"cg17716297",1,1,1,0,3
"cg17716508",1,0,0,0,1
"cg17717588",0,1,0,0,1
"cg17717697",0,0,1,0,1
"cg17718321",5,4,3,0,12
"cg17718576",0,1,0,0,1
"cg17719229",0,1,1,0,2
"cg17720087",0,1,1,0,2
"cg17721715",4,1,0,0,5
"cg17722962",2,0,4,0,6
"cg17723597",3,0,0,0,3
"cg17725016",21,5,0,0,26
"cg17725136",0,1,1,0,2
"cg17726280",0,1,1,0,2
"cg17727418",430,96,3,0,529
"cg17727938",4,0,0,0,4
"cg17728216",0,0,1,0,1
"cg17728809",0,0,1,0,1
"cg17728820",0,1,0,0,1
"cg17728853",0,0,2,0,2
"cg17729007",1,0,6,0,7
"cg17730675",0,1,2,0,3
"cg17731710",0,1,0,0,1
"cg17732552",0,2,0,0,2
"cg17733141",0,0,1,0,1
"cg17735043",0,1,0,0,1
"cg17735385",0,0,3,0,3
"cg17736560",1,0,0,0,1
"cg17737993",10,15,4,0,29
"cg17738743",3,4,0,0,7
"cg17740524",1,0,1,0,2
"cg17741839",1,2,7,0,10
"cg17741977",77,4,0,0,81
"cg17742072",13,4,0,0,17
"cg17745210",1,0,0,0,1
"cg17745224",0,1,1,0,2
"cg17745262",0,0,1,0,1
"cg17745452",0,1,1,0,2
"cg17745575",1,2,1,0,4
"cg17745953",1,1,0,0,2
"cg17746130",0,0,1,0,1
"cg17746625",1,1,2,0,4
"cg17746638",0,1,2,0,3
"cg17747552",1,1,1,0,3
"cg17747619",3,8,0,0,11
"cg17748329",0,1,0,0,1
"cg17748975",0,1,0,0,1
"cg17749557",5,0,0,0,5
"cg17749578",0,0,1,0,1
"cg17750428",409,15,0,0,424
"cg17750898",0,1,0,0,1
"cg17751872",4,0,0,0,4
"cg17752268",400,9,0,0,409
"cg17752707",1,0,0,0,1
"cg17752899",9,1,1,0,11
"cg17753440",0,2,3,0,5
"cg17753953",2,0,0,0,2
"cg17755386",0,0,1,0,1
"cg17755554",1,0,0,0,1
"cg17755627",0,0,3,0,3
"cg17757281",0,5,0,0,5
"cg17757773",0,3,7,2,12
"cg17758324",0,0,1,0,1
"cg17759562",0,0,1,0,1
"cg17760849",0,1,0,0,1
"cg17761225",1,0,0,0,1
"cg17761743",0,0,1,0,1
"cg17761837",0,1,0,0,1
"cg17761898",5,7,0,0,12
"cg17762146",14,2,3,0,19
"cg17762631",1,0,0,0,1
"cg17762904",0,0,3,0,3
"cg17763192",1,0,0,0,1
"cg17763713",60,2,0,0,62
"cg17764125",3,1,0,0,4
"cg17765025",0,3,0,0,3
"cg17766496",0,0,1,0,1
"cg17766878",3,2,1,0,6
"cg17767185",0,1,0,0,1
"cg17767596",11,2,4,0,17
"cg17768143",0,0,1,0,1
"cg17769009",0,0,1,0,1
"cg17769629",1,0,0,0,1
"cg17769985",3,0,0,0,3
"cg17770461",1,0,1,0,2
"cg17770813",4,2,0,0,6
"cg17772430",3,2,0,0,5
"cg17772680",0,0,0,1,1
"cg17773562",1,0,0,0,1
"cg17773637",0,1,0,0,1
"cg17775009",0,0,1,0,1
"cg17775382",6,5,0,0,11
"cg17775736",2,2,2,0,6
"cg17776448",2,1,0,0,3
"cg17777544",0,0,1,0,1
"cg17777676",1,0,0,0,1
"cg17778453",2,0,1,0,3
"cg17779215",39,13,1,0,53
"cg17780687",1,0,0,0,1
"cg17781357",20,1,0,0,21
"cg17781772",0,0,1,0,1
"cg17781925",0,0,1,0,1
"cg17783183",1,0,0,2,3
"cg17784516",0,1,0,0,1
"cg17784744",0,1,0,0,1
"cg17785250",0,1,14,0,15
"cg17786496",0,1,1,0,2
"cg17786532",0,1,1,0,2
"cg17787161",1,0,0,0,1
"cg17787583",0,1,1,0,2
"cg17788362",0,1,0,0,1
"cg17788587",0,2,0,0,2
"cg17790372",1,0,0,0,1
"cg17790434",0,0,1,0,1
"cg17794241",5,0,0,0,5
"cg17794539",1,0,0,0,1
"cg17794784",1,1,1,0,3
"cg17795265",3,0,0,0,3
"cg17796010",1,0,0,0,1
"cg17797360",0,1,0,0,1
"cg17797514",20,2,0,0,22
"cg17798225",0,0,1,0,1
"cg17798614",0,1,0,0,1
"cg17799326",0,1,0,0,1
"cg17799508",3,5,3,0,11
"cg17800096",0,1,0,0,1
"cg17800708",1,0,0,0,1
"cg17801337",10,29,22,1,62
"cg17801369",30,35,6,0,71
"cg17801840",1,0,0,0,1
"cg17803410",0,1,0,0,1
"cg17804048",29,6,0,0,35
"cg17804143",1,0,0,0,1
"cg17804723",0,0,4,0,4
"cg17806461",1,0,0,0,1
"cg17806522",2,0,0,0,2
"cg17806762",0,1,0,0,1
"cg17806811",578,16,2,0,596
"cg17806847",1,16,1,0,18
"cg17807033",8,1,0,0,9
"cg17807393",6,31,1,0,38
"cg17809345",1,0,0,0,1
"cg17809780",0,1,0,0,1
"cg17811434",0,3,0,0,3
"cg17811578",4,0,0,0,4
"cg17811663",28,12,1,0,41
"cg17812503",1,3,1,0,5
"cg17812839",6,3,0,0,9
"cg17814680",0,1,0,0,1
"cg17816527",44,1,0,0,45
"cg17816905",0,1,0,0,1
"cg17817474",1,0,0,0,1
"cg17818035",0,0,1,0,1
"cg17818847",1,0,0,0,1
"cg17821327",2,0,0,0,2
"cg17821835",0,1,0,0,1
"cg17822327",1,0,0,0,1
"cg17824685",2,0,1,0,3
"cg17825185",3,0,0,0,3
"cg17825740",650,24,3,0,677
"cg17828437",0,0,1,0,1
"cg17828773",0,0,1,0,1
"cg17830067",77,56,0,0,133
"cg17830959",0,0,1,0,1
"cg17831117",0,0,1,0,1
"cg17832001",0,1,0,0,1
"cg17832921",1,2,2,0,5
"cg17833937",384,12,0,0,396
"cg17834341",2,1,0,0,3
"cg17834650",0,0,8,0,8
"cg17834671",20,3,0,0,23
"cg17835765",114,197,57,0,368
"cg17836303",26,58,5,0,89
"cg17836693",1,1,0,0,2
"cg17837162",0,0,7,0,7
"cg17837491",0,0,1,0,1
"cg17839388",24,17,2,0,43
"cg17840203",0,2,1,0,3
"cg17840367",1,0,0,0,1
"cg17841456",2,8,0,0,10
"cg17842218",78,32,6,0,116
"cg17842264",382,137,4,0,523
"cg17842698",1,0,0,0,1
"cg17843404",0,0,1,0,1
"cg17843563",2,1,0,0,3
"cg17843722",1,0,0,0,1
"cg17845066",0,0,1,0,1
"cg17846384",0,0,1,0,1
"cg17846761",0,1,0,0,1
"cg17846886",0,0,1,0,1
"cg17847446",1,0,0,0,1
"cg17851657",7,3,0,0,10
"cg17852221",2,1,0,0,3
"cg17852752",0,1,0,0,1
"cg17853071",5,2,0,0,7
"cg17853087",0,1,0,0,1
"cg17853818",0,0,2,0,2
"cg17854650",3,0,0,0,3
"cg17854654",0,1,0,0,1
"cg17855428",0,2,0,0,2
"cg17855514",0,1,0,0,1
"cg17857070",0,0,1,0,1
"cg17857642",11,1,0,0,12
"cg17859393",0,0,1,0,1
"cg17859700",0,0,1,0,1
"cg17859776",14,3,0,0,17
"cg17861477",1,2,0,0,3
"cg17861810",3,0,0,0,3
"cg17863134",0,1,0,0,1
"cg17863923",0,0,2,0,2
"cg17864421",11,0,0,0,11
"cg17864793",0,2,0,0,2
"cg17864904",2,2,21,0,25
"cg17865617",0,0,3,0,3
"cg17866181",3,6,6,0,15
"cg17866711",0,0,0,1,1
"cg17868557",1,0,1,0,2
"cg17868778",15,0,0,0,15
"cg17869030",0,4,2,0,6
"cg17869339",1,2,1,0,4
"cg17869472",72,27,3,0,102
"cg17869933",0,0,1,0,1
"cg17870520",4,0,0,0,4
"cg17872110",2,0,0,0,2
"cg17873414",1,1,0,0,2
"cg17874485",4,7,0,0,11
"cg17875084",3,2,0,0,5
"cg17875260",6,0,0,0,6
"cg17876020",4,2,0,0,6
"cg17876974",2,0,0,0,2
"cg17877470",0,1,0,0,1
"cg17877772",0,0,1,0,1
"cg17877776",11,0,0,0,11
"cg17877920",1,0,0,0,1
"cg17877933",0,1,1,0,2
"cg17879648",1,1,3,0,5
"cg17879804",0,1,0,0,1
"cg17880604",11,1,0,0,12
"cg17880889",0,2,6,2,10
"cg17880983",0,1,0,0,1
"cg17881380",198,11,0,0,209
"cg17882033",144,3,0,0,147
"cg17882544",200,13,1,0,214
"cg17883371",0,0,1,0,1
"cg17883491",1,2,2,0,5
"cg17883837",5,1,1,0,7
"cg17883914",0,0,1,0,1
"cg17884016",0,0,1,0,1
"cg17885191",1,3,0,0,4
"cg17885260",3,0,0,0,3
"cg17885684",0,1,0,0,1
"cg17886715",1,0,0,0,1
"cg17887793",1,0,0,0,1
"cg17888464",0,0,1,0,1
"cg17888979",36,2,0,0,38
"cg17889356",0,0,0,1,1
"cg17891759",3,0,2,0,5
"cg17891840",36,16,3,0,55
"cg17891896",1,0,0,0,1
"cg17892357",13,15,14,0,42
"cg17893219",1,1,4,0,6
"cg17894941",1,0,0,0,1
"cg17895006",4,0,0,0,4
"cg17895192",0,1,2,0,3
"cg17895895",0,1,1,0,2
"cg17895907",0,0,2,0,2
"cg17896636",0,1,0,0,1
"cg17896877",3,0,0,0,3
"cg17896880",0,0,1,0,1
"cg17897340",14,1,0,0,15
"cg17897445",6,5,3,0,14
"cg17897518",2,0,0,0,2
"cg17898252",0,1,0,0,1
"cg17898375",3,0,0,0,3
"cg17900273",8,1,0,0,9
"cg17900389",1,4,1,0,6
"cg17900593",0,1,0,0,1
"cg17902352",1,10,2,0,13
"cg17902377",0,0,1,0,1
"cg17905708",0,1,0,0,1
"cg17905936",1,0,0,0,1
"cg17908719",1,0,0,0,1
"cg17908754",1,0,0,0,1
"cg17908938",0,0,1,0,1
"cg17909385",8,7,2,1,18
"cg17910152",0,0,1,0,1
"cg17910380",82,11,0,0,93
"cg17910786",2,0,0,0,2
"cg17911958",56,1,0,0,57
"cg17912566",8,4,0,0,12
"cg17912803",0,0,2,0,2
"cg17913570",0,1,7,0,8
"cg17915621",0,1,1,0,2
"cg17915752",0,0,1,0,1
"cg17915922",3,6,0,0,9
"cg17916447",2,1,0,0,3
"cg17917920",409,80,5,0,494
"cg17918131",0,1,0,0,1
"cg17919763",2,2,0,0,4
"cg17919821",2,2,0,0,4
"cg17920653",3,0,0,0,3
"cg17920809",0,0,1,0,1
"cg17921423",0,0,1,0,1
"cg17921871",1,0,0,0,1
"cg17922153",0,1,0,0,1
"cg17922483",0,1,0,0,1
"cg17922994",1,0,0,0,1
"cg17923034",4,0,0,0,4
"cg17927889",2,0,0,0,2
"cg17931660",2,3,0,0,5
"cg17931946",0,0,1,0,1
"cg17932484",0,0,1,0,1
"cg17932598",6,6,1,0,13
"cg17932619",1,0,0,0,1
"cg17932934",10,10,1,0,21
"cg17932974",1,0,0,0,1
"cg17933282",0,0,1,0,1
"cg17934294",12,22,1,0,35
"cg17935105",0,0,1,0,1
"cg17935364",0,3,0,0,3
"cg17935390",0,1,0,0,1
"cg17936867",3,9,1,0,13
"cg17937812",0,0,1,0,1
"cg17938491",0,0,1,0,1
"cg17939116",0,1,0,0,1
"cg17939258",0,0,3,0,3
"cg17939569",14,5,11,0,30
"cg17940234",0,0,1,0,1
"cg17941454",2,0,0,0,2
"cg17942219",0,1,0,0,1
"cg17943922",4,3,1,0,8
"cg17943940",0,0,2,0,2
"cg17944263",0,1,0,0,1
"cg17944542",0,2,0,0,2
"cg17944561",3,0,0,0,3
"cg17945041",0,0,1,0,1
"cg17945731",0,1,2,0,3
"cg17946995",99,1,0,0,100
"cg17947058",1,0,0,0,1
"cg17947156",3,0,2,0,5
"cg17947225",281,49,0,0,330
"cg17948740",1,0,0,0,1
"cg17950186",14,1,0,0,15
"cg17950398",1,0,0,0,1
"cg17952549",0,1,0,0,1
"cg17953842",2,1,1,0,4
"cg17954191",1,3,4,0,8
"cg17956002",1,0,0,0,1
"cg17956132",0,1,0,0,1
"cg17956253",0,0,1,0,1
"cg17956259",72,4,7,0,83
"cg17956819",5,0,0,0,5
"cg17957183",0,2,0,0,2
"cg17958984",0,0,1,0,1
"cg17960268",0,0,4,0,4
"cg17960355",1,0,0,0,1
"cg17961200",0,0,1,0,1
"cg17962047",0,0,1,0,1
"cg17964779",1,0,0,0,1
"cg17965698",34,6,1,0,41
"cg17966489",782,76,1,0,859
"cg17967304",2,0,0,0,2
"cg17968836",1,1,0,0,2
"cg17970286",1,1,1,0,3
"cg17970482",1,1,0,0,2
"cg17971210",15,1,0,0,16
"cg17971330",1,0,0,0,1
"cg17972144",244,242,2,0,488
"cg17974575",490,64,3,0,557
"cg17974863",0,0,1,0,1
"cg17975007",1,0,0,0,1
"cg17975186",1,0,0,0,1
"cg17976157",6,1,0,0,7
"cg17977099",3,0,0,0,3
"cg17977173",0,0,1,0,1
"cg17977184",0,0,2,0,2
"cg17978092",0,1,0,0,1
"cg17978293",4,2,0,0,6
"cg17978367",1,0,0,0,1
"cg17978727",4,2,0,0,6
"cg17980184",0,0,2,0,2
"cg17980570",597,205,0,0,802
"cg17980666",0,1,0,0,1
"cg17981028",89,32,4,0,125
"cg17982165",0,0,2,0,2
"cg17982565",12,0,0,0,12
"cg17982671",0,1,0,0,1
"cg17982992",0,2,1,0,3
"cg17983053",3,0,0,0,3
"cg17983430",0,1,0,0,1
"cg17983571",1,1,0,0,2
"cg17983776",1,0,0,0,1
"cg17984400",1,0,0,0,1
"cg17984885",12,1,1,0,14
"cg17987636",128,176,17,0,321
"cg17989030",1,0,0,0,1
"cg17989243",2,0,0,0,2
"cg17989448",3,0,0,0,3
"cg17990365",0,0,1,0,1
"cg17990871",0,0,1,0,1
"cg17991049",0,2,2,0,4
"cg17991473",0,0,1,0,1
"cg17992564",4,3,19,0,26
"cg17992808",18,2,0,0,20
"cg17994441",9,12,0,0,21
"cg17995911",0,1,1,0,2
"cg17998375",1,1,0,0,2
"cg17998565",109,152,2,0,263
"cg18000800",1,1,0,0,2
"cg18001059",0,0,1,0,1
"cg18002437",0,1,4,0,5
"cg18002519",13,0,0,0,13
"cg18003135",21,13,2,0,36
"cg18003330",12,7,6,0,25
"cg18004371",2,3,0,0,5
"cg18004545",1,0,0,0,1
"cg18006480",99,41,1,0,141
"cg18007127",0,2,0,0,2
"cg18007177",1,3,1,0,5
"cg18007543",0,0,3,0,3
"cg18007565",1,0,0,0,1
"cg18007897",0,1,0,0,1
"cg18008576",0,0,1,0,1
"cg18010432",0,1,0,0,1
"cg18010669",0,0,2,0,2
"cg18011088",9,6,0,0,15
"cg18011230",0,1,0,0,1
"cg18011899",2,7,2,0,11
"cg18012082",0,1,0,0,1
"cg18012266",11,1,0,0,12
"cg18012383",1,0,0,0,1
"cg18013249",1,1,0,0,2
"cg18013730",0,0,1,0,1
"cg18013856",6,3,0,0,9
"cg18014260",18,2,0,0,20
"cg18015218",1,0,0,0,1
"cg18015913",0,2,2,0,4
"cg18016641",0,0,1,0,1
"cg18016963",11,5,3,0,19
"cg18018556",0,0,3,0,3
"cg18019717",1,0,0,0,1
"cg18019999",1,0,0,0,1
"cg18021100",1,0,0,0,1
"cg18022282",0,0,1,0,1
"cg18022907",0,0,1,0,1
"cg18023096",0,2,1,0,3
"cg18023652",45,2,0,0,47
"cg18023736",0,0,1,0,1
"cg18024113",0,0,1,0,1
"cg18024368",0,1,0,0,1
"cg18024856",2,2,2,1,7
"cg18025133",3,5,0,0,8
"cg18025438",0,0,15,0,15
"cg18025446",0,4,5,0,9
"cg18025447",129,88,4,0,221
"cg18026626",1,0,0,0,1
"cg18027529",0,0,1,0,1
"cg18027784",288,8,0,0,296
"cg18028379",1,0,0,0,1
"cg18028536",11,0,0,0,11
"cg18029228",1,0,0,0,1
"cg18030084",187,289,9,0,485
"cg18030732",224,82,22,0,328
"cg18031134",0,2,6,0,8
"cg18031861",0,1,0,0,1
"cg18032115",1,0,0,0,1
"cg18032289",0,1,0,0,1
"cg18032561",56,3,0,0,59
"cg18032575",1,0,0,0,1
"cg18032893",67,95,4,0,166
"cg18033041",1,0,0,0,1
"cg18033727",31,6,0,0,37
"cg18034030",1,1,0,0,2
"cg18034533",74,14,0,0,88
"cg18034538",12,13,0,0,25
"cg18034711",0,1,3,0,4
"cg18035399",0,0,1,0,1
"cg18037513",0,0,1,0,1
"cg18038779",60,66,21,0,147
"cg18039600",0,0,1,0,1
"cg18040125",0,0,2,0,2
"cg18041403",80,5,0,0,85
"cg18041893",2,0,0,0,2
"cg18044322",1,1,0,0,2
"cg18045172",2,0,0,0,2
"cg18045201",11,0,0,0,11
"cg18045316",0,0,2,0,2
"cg18046054",1,3,8,0,12
"cg18047375",1,1,0,0,2
"cg18047894",0,2,1,0,3
"cg18049644",1,1,0,0,2
"cg18050722",3,0,0,0,3
"cg18052546",1,0,0,0,1
"cg18052547",0,0,2,0,2
"cg18053492",344,29,1,0,374
"cg18054325",1,0,0,0,1
"cg18054523",16,6,0,0,22
"cg18055051",9,1,1,0,11
"cg18057469",0,0,1,0,1
"cg18057688",1,0,0,0,1
"cg18058077",0,0,1,0,1
"cg18058994",0,0,2,0,2
"cg18060480",2,1,0,0,3
"cg18062003",1,0,1,0,2
"cg18062458",0,0,1,0,1
"cg18063135",0,8,8,0,16
"cg18063591",0,0,2,0,2
"cg18064172",3,0,0,0,3
"cg18064538",0,0,4,0,4
"cg18065818",0,0,1,0,1
"cg18065904",0,0,1,0,1
"cg18066001",1,2,0,0,3
"cg18066181",0,1,0,0,1
"cg18066451",4,0,0,0,4
"cg18067163",0,0,1,0,1
"cg18067665",3,0,0,0,3
"cg18067856",1,0,0,0,1
"cg18070057",92,41,3,0,136
"cg18070724",1,1,1,0,3
"cg18071162",0,1,0,0,1
"cg18072412",0,0,1,0,1
"cg18072778",1,0,6,0,7
"cg18073423",10,5,0,0,15
"cg18073432",0,1,0,0,1
"cg18073986",2,0,0,0,2
"cg18074117",8,1,0,0,9
"cg18075801",2,0,0,0,2
"cg18076360",1,0,0,0,1
"cg18077249",0,2,5,0,7
"cg18078177",1,0,1,0,2
"cg18079995",7,0,2,0,9
"cg18081449",0,1,2,0,3
"cg18082337",2,0,0,0,2
"cg18082912",2,6,2,1,11
"cg18084491",3,0,0,0,3
"cg18087365",0,0,1,0,1
"cg18087694",0,0,1,0,1
"cg18088414",0,0,1,0,1
"cg18088578",0,0,1,0,1
"cg18088712",0,0,1,0,1
"cg18089051",343,200,8,0,551
"cg18091309",4,1,0,0,5
"cg18092388",1,0,0,0,1
"cg18092630",10,1,0,0,11
"cg18093559",0,0,1,0,1
"cg18093635",0,0,1,0,1
"cg18093770",2,0,0,0,2
"cg18095109",1,0,0,0,1
"cg18095404",1,0,0,0,1
"cg18095544",0,1,0,0,1
"cg18096127",0,1,0,0,1
"cg18096752",13,16,9,0,38
"cg18098335",0,0,1,0,1
"cg18099850",1,0,0,0,1
"cg18100385",0,0,1,0,1
"cg18101228",8,6,7,0,21
"cg18101285",0,0,1,0,1
"cg18101588",1,0,0,0,1
"cg18101764",16,3,0,0,19
"cg18102949",0,0,1,0,1
"cg18103236",0,1,0,0,1
"cg18103692",0,0,1,0,1
"cg18104135",0,1,1,0,2
"cg18106370",0,0,1,0,1
"cg18106971",0,2,0,0,2
"cg18107078",0,1,0,0,1
"cg18107603",0,1,1,0,2
"cg18107958",1,0,0,0,1
"cg18108329",1,0,0,0,1
"cg18108333",1,0,0,0,1
"cg18110015",0,2,1,0,3
"cg18110165",0,1,0,0,1
"cg18110349",23,18,30,0,71
"cg18110419",5,11,31,0,47
"cg18110661",0,0,1,0,1
"cg18111443",0,1,0,0,1
"cg18111667",1,0,0,0,1
"cg18112708",0,0,1,0,1
"cg18112794",2,0,1,2,5
"cg18112904",0,1,2,0,3
"cg18113560",1,0,0,0,1
"cg18113596",1,0,1,0,2
"cg18113637",1,0,0,0,1
"cg18114166",1,0,0,0,1
"cg18114901",1,1,1,0,3
"cg18114946",0,1,0,0,1
"cg18115481",0,1,0,0,1
"cg18115957",68,15,1,0,84
"cg18117046",2,1,3,0,6
"cg18117326",6,0,0,0,6
"cg18119394",0,0,1,0,1
"cg18120611",1,0,0,0,1
"cg18121171",1,1,0,0,2
"cg18122083",3,16,12,0,31
"cg18122708",0,0,1,0,1
"cg18123321",0,0,2,0,2
"cg18124015",1,0,1,0,2
"cg18124252",0,1,0,0,1
"cg18124852",0,2,0,0,2
"cg18124899",0,0,1,0,1
"cg18126084",0,0,1,0,1
"cg18126267",1,0,0,0,1
"cg18126732",6,1,0,0,7
"cg18126735",1,0,0,0,1
"cg18127682",47,17,0,0,64
"cg18127934",0,1,0,0,1
"cg18128806",0,1,1,0,2
"cg18128921",1,2,0,0,3
"cg18129996",0,0,1,0,1
"cg18130529",0,1,0,0,1
"cg18131545",0,0,2,0,2
"cg18132262",0,0,1,0,1
"cg18132624",0,1,0,0,1
"cg18132877",1,0,0,0,1
"cg18133263",1,0,0,0,1
"cg18134262",0,5,2,0,7
"cg18134676",4,0,0,0,4
"cg18135704",7,1,0,0,8
"cg18135782",0,0,1,0,1
"cg18137479",2,0,0,0,2
"cg18137618",0,0,1,0,1
"cg18138247",1,0,0,0,1
"cg18138400",0,0,1,0,1
"cg18139307",0,1,0,0,1
"cg18139575",0,1,0,0,1
"cg18139870",0,0,0,1,1
"cg18139900",0,0,0,1,1
"cg18140324",319,123,3,0,445
"cg18140710",0,1,0,0,1
"cg18141193",0,0,1,0,1
"cg18142037",0,0,2,0,2
"cg18142265",10,7,5,0,22
"cg18142892",0,0,1,0,1
"cg18143004",1,0,0,0,1
"cg18143098",1,1,0,0,2
"cg18143757",0,7,0,0,7
"cg18145652",1,6,12,0,19
"cg18145853",756,103,4,0,863
"cg18146001",18,15,6,0,39
"cg18147208",1,5,0,0,6
"cg18148530",0,0,1,0,1
"cg18148726",7,6,0,0,13
"cg18148735",0,0,1,0,1
"cg18148755",12,17,22,0,51
"cg18148997",0,0,1,0,1
"cg18149365",0,0,1,0,1
"cg18150362",0,0,1,0,1
"cg18150687",117,43,1,0,161
"cg18151950",1,0,0,0,1
"cg18152506",0,1,0,0,1
"cg18152985",1,0,0,0,1
"cg18153015",0,0,1,0,1
"cg18153593",1,0,0,0,1
"cg18154493",1,0,0,0,1
"cg18154639",2,0,0,0,2
"cg18154724",1,0,0,0,1
"cg18155289",3,0,0,0,3
"cg18156135",0,1,3,0,4
"cg18156417",0,1,0,0,1
"cg18156564",1,0,0,0,1
"cg18157248",1,0,0,0,1
"cg18157275",0,1,0,0,1
"cg18158460",11,0,0,0,11
"cg18158524",0,2,0,0,2
"cg18159323",1,0,0,0,1
"cg18159768",1,0,0,0,1
"cg18159819",0,1,1,0,2
"cg18159934",202,18,0,0,220
"cg18161679",0,0,1,0,1
"cg18163279",0,1,0,0,1
"cg18163671",0,1,0,0,1
"cg18163884",390,18,0,0,408
"cg18164362",0,0,4,0,4
"cg18165694",0,1,0,0,1
"cg18167790",1,1,0,0,2
"cg18167829",0,0,1,0,1
"cg18168431",4,0,0,0,4
"cg18170297",2,0,0,0,2
"cg18170934",90,535,37,0,662
"cg18172751",1,0,0,0,1
"cg18172802",1,0,0,0,1
"cg18173185",0,0,2,0,2
"cg18174178",0,1,0,0,1
"cg18174876",26,1,0,0,27
"cg18175103",0,0,1,0,1
"cg18175213",3,0,0,0,3
"cg18175395",6,0,0,0,6
"cg18175747",0,0,1,0,1
"cg18176117",0,0,1,0,1
"cg18176239",1,2,1,0,4
"cg18176567",105,220,91,0,416
"cg18176599",1,0,0,0,1
"cg18177920",2,1,0,0,3
"cg18178844",0,1,0,0,1
"cg18179145",0,1,0,0,1
"cg18181134",0,1,0,0,1
"cg18183019",307,49,2,0,358
"cg18183435",5,0,0,0,5
"cg18183706",1,0,0,0,1
"cg18184147",1,0,3,0,4
"cg18185596",1,0,0,0,1
"cg18187949",6,1,0,0,7
"cg18188062",10,3,0,0,13
"cg18189409",1,0,0,0,1
"cg18190323",0,1,0,0,1
"cg18190411",0,0,5,0,5
"cg18191116",1,0,0,0,1
"cg18191309",3,0,0,0,3
"cg18191335",374,11,0,0,385
"cg18191743",0,1,0,0,1
"cg18192200",0,4,0,0,4
"cg18193680",2,0,0,0,2
"cg18193950",1,3,0,0,4
"cg18194842",1,0,0,0,1
"cg18195328",1,5,3,0,9
"cg18195329",0,0,1,0,1
"cg18195986",2,0,0,0,2
"cg18196333",0,1,1,0,2
"cg18196811",7,1,0,0,8
"cg18200340",21,9,3,0,33
"cg18201679",0,2,2,0,4
"cg18204732",1,0,0,0,1
"cg18205081",6,1,0,0,7
"cg18205205",0,1,0,0,1
"cg18205244",9,0,0,0,9
"cg18205516",1,0,0,0,1
"cg18205636",0,1,1,0,2
"cg18207742",0,0,1,0,1
"cg18208799",226,65,9,0,300
"cg18209430",0,1,0,0,1
"cg18210722",0,4,0,0,4
"cg18211437",0,1,0,0,1
"cg18213385",38,1,1,0,40
"cg18218628",5,0,0,0,5
"cg18218652",0,1,0,0,1
"cg18219226",0,1,0,0,1
"cg18219930",1,1,2,0,4
"cg18220058",1,0,0,0,1
"cg18220103",0,2,3,0,5
"cg18221983",7,0,0,0,7
"cg18221988",364,229,17,0,610
"cg18222653",0,0,1,0,1
"cg18223446",8,0,0,0,8
"cg18224798",1,0,0,0,1
"cg18225515",6,1,0,0,7
"cg18226721",0,0,1,0,1
"cg18227237",1,0,1,0,2
"cg18227420",0,0,1,0,1
"cg18227608",0,0,2,0,2
"cg18227776",1,0,0,0,1
"cg18228834",18,6,0,0,24
"cg18229137",0,0,1,0,1
"cg18229313",0,2,0,0,2
"cg18229859",0,5,0,0,5
"cg18231162",3,4,0,0,7
"cg18231321",44,3,0,0,47
"cg18231517",7,14,20,0,41
"cg18231760",0,0,6,0,6
"cg18234544",1,3,1,0,5
"cg18234865",0,1,1,0,2
"cg18236358",2,0,0,0,2
"cg18236663",0,1,0,0,1
"cg18237106",0,0,1,0,1
"cg18237446",0,1,2,0,3
"cg18237594",0,3,0,0,3
"cg18238130",0,6,1,0,7
"cg18238531",0,0,1,1,2
"cg18239858",0,2,0,0,2
"cg18240043",0,3,1,0,4
"cg18241189",2,0,0,0,2
"cg18241291",1,0,0,0,1
"cg18241486",13,20,5,0,38
"cg18241823",0,1,0,0,1
"cg18242427",0,0,1,0,1
"cg18243346",1,0,0,0,1
"cg18243412",0,0,0,1,1
"cg18245976",1,4,0,0,5
"cg18247119",0,1,3,0,4
"cg18247700",1,2,0,0,3
"cg18247876",166,396,37,0,599
"cg18248994",83,6,0,0,89
"cg18249849",1,0,0,0,1
"cg18250340",0,0,3,0,3
"cg18250847",1,0,1,0,2
"cg18251234",0,0,1,0,1
"cg18251984",1,1,1,0,3
"cg18252037",2,0,0,0,2
"cg18252306",1,0,0,0,1
"cg18252654",2,1,0,0,3
"cg18253026",43,6,0,0,49
"cg18253679",1,0,0,0,1
"cg18255335",0,1,2,0,3
"cg18258393",0,0,1,0,1
"cg18258697",0,2,1,0,3
"cg18259442",0,0,1,0,1
"cg18260631",0,0,1,0,1
"cg18260823",226,52,1,0,279
"cg18262818",1,0,0,0,1
"cg18262937",0,3,0,1,4
"cg18263040",0,0,2,0,2
"cg18263059",1,0,1,0,2
"cg18263411",2,7,3,0,12
"cg18263665",0,0,1,0,1
"cg18263767",5,0,0,0,5
"cg18263841",25,29,11,0,65
"cg18265297",1,0,0,0,1
"cg18265426",0,0,1,0,1
"cg18265683",1,5,0,0,6
"cg18266479",0,0,1,0,1
"cg18266771",6,0,1,0,7
"cg18267079",10,0,0,0,10
"cg18268077",1,0,0,0,1
"cg18268267",2,1,1,0,4
"cg18268863",0,2,0,0,2
"cg18272889",1,0,1,0,2
"cg18273181",0,0,2,0,2
"cg18274732",302,13,0,0,315
"cg18274762",0,1,0,0,1
"cg18275339",135,369,67,0,571
"cg18275687",0,1,3,0,4
"cg18275733",4,0,0,0,4
"cg18275965",2,0,0,0,2
"cg18278817",0,2,1,0,3
"cg18279042",0,0,5,0,5
"cg18279625",1,0,0,0,1
"cg18280933",0,0,1,0,1
"cg18281955",0,1,1,0,2
"cg18282096",0,2,0,0,2
"cg18282617",0,0,1,0,1
"cg18283729",1,0,0,0,1
"cg18284590",1,0,0,0,1
"cg18285188",0,1,0,0,1
"cg18285810",2,0,0,0,2
"cg18286087",0,1,0,0,1
"cg18286304",1,0,0,0,1
"cg18286639",1,0,0,0,1
"cg18286997",0,0,1,0,1
"cg18287590",0,0,2,0,2
"cg18289514",0,1,0,0,1
"cg18292202",0,0,2,0,2
"cg18293664",1,0,0,0,1
"cg18294383",2,2,1,0,5
"cg18294707",0,1,1,0,2
"cg18297220",2,0,0,0,2
"cg18297369",188,461,56,0,705
"cg18297442",0,0,2,0,2
"cg18297751",2,1,2,0,5
"cg18298815",0,1,0,0,1
"cg18298897",1,0,0,0,1
"cg18298927",0,1,0,0,1
"cg18299157",2,2,0,0,4
"cg18299634",0,1,7,0,8
"cg18300655",0,1,0,0,1
"cg18301136",0,0,2,0,2
"cg18302963",3,2,0,0,5
"cg18303722",10,3,0,0,13
"cg18304242",499,17,0,0,516
"cg18304339",2,3,0,0,5
"cg18304969",0,0,1,0,1
"cg18305613",0,3,0,0,3
"cg18306406",1,0,0,0,1
"cg18307966",0,0,1,0,1
"cg18308585",16,0,0,0,16
"cg18309119",0,0,1,0,1
"cg18309251",7,4,3,0,14
"cg18309935",324,244,7,0,575
"cg18310447",0,1,0,0,1
"cg18311097",0,0,1,0,1
"cg18311400",0,0,6,0,6
"cg18313396",1,0,0,0,1
"cg18313641",0,1,0,0,1
"cg18313790",3,4,3,0,10
"cg18315159",0,0,1,0,1
"cg18315835",0,0,1,0,1
"cg18315975",18,6,20,0,44
"cg18316613",0,1,0,0,1
"cg18318661",2,0,2,0,4
"cg18320212",0,0,1,0,1
"cg18320336",0,0,1,0,1
"cg18320892",47,6,0,0,53
"cg18320917",1,2,2,0,5
"cg18321138",13,8,3,0,24
"cg18323674",1,0,0,0,1
"cg18323846",0,0,1,0,1
"cg18324079",0,0,1,0,1
"cg18324518",6,14,0,0,20
"cg18324782",69,30,1,0,100
"cg18325044",1,0,0,0,1
"cg18325278",1,0,0,0,1
"cg18325873",4,2,0,0,6
"cg18326825",7,0,0,0,7
"cg18327659",0,1,0,0,1
"cg18329423",0,1,0,0,1
"cg18329689",4,2,0,0,6
"cg18329839",1,0,0,0,1
"cg18331106",0,0,1,0,1
"cg18331135",40,3,0,0,43
"cg18331325",2,0,0,0,2
"cg18332943",0,0,1,0,1
"cg18333352",0,0,1,0,1
"cg18333566",1,3,0,0,4
"cg18333824",1,0,0,0,1
"cg18334332",1,0,0,0,1
"cg18334542",1,0,0,0,1
"cg18337170",0,1,0,0,1
"cg18338707",0,0,2,0,2
"cg18339788",0,0,1,0,1
"cg18340374",1,0,0,0,1
"cg18340953",5,3,0,0,8
"cg18343109",1,0,0,0,1
"cg18343527",19,3,0,0,22
"cg18345539",3,0,0,0,3
"cg18346038",1,0,0,0,1
"cg18346802",0,0,1,0,1
"cg18347153",1,2,1,0,4
"cg18347570",0,0,1,0,1
"cg18348303",128,189,22,0,339
"cg18349863",0,1,0,0,1
"cg18349937",0,2,3,0,5
"cg18350378",0,0,1,0,1
"cg18350497",4,1,0,0,5
"cg18350545",0,1,0,0,1
"cg18350786",8,0,0,0,8
"cg18351099",0,4,2,0,6
"cg18352888",0,1,0,0,1
"cg18353638",0,0,1,0,1
"cg18353675",2,0,0,0,2
"cg18353864",2,2,0,0,4
"cg18354393",20,26,16,0,62
"cg18354836",6,0,0,0,6
"cg18356634",8,1,0,0,9
"cg18357850",1,0,0,0,1
"cg18358023",0,0,1,0,1
"cg18359129",3,0,0,0,3
"cg18360166",0,5,1,0,6
"cg18360429",0,0,1,0,1
"cg18360585",135,269,28,0,432
"cg18361467",3,0,0,0,3
"cg18361730",0,0,5,0,5
"cg18361853",3,0,0,0,3
"cg18361940",0,0,1,0,1
"cg18362897",1,0,0,0,1
"cg18363144",1,1,0,0,2
"cg18363948",1,0,0,0,1
"cg18364180",0,2,0,0,2
"cg18365806",1,0,0,0,1
"cg18365865",6,10,3,0,19
"cg18369733",0,1,0,0,1
"cg18370902",0,1,0,0,1
"cg18371263",0,1,0,0,1
"cg18371265",0,1,0,0,1
"cg18371428",3,0,0,0,3
"cg18371539",1,0,0,0,1
"cg18371636",0,1,0,0,1
"cg18374013",0,1,1,0,2
"cg18374488",0,0,1,0,1
"cg18374977",130,93,13,0,236
"cg18376472",0,0,1,0,1
"cg18376750",1,0,0,0,1
"cg18377059",0,0,1,0,1
"cg18377903",0,2,0,0,2
"cg18379490",1,0,0,0,1
"cg18381729",109,48,0,0,157
"cg18382744",0,0,3,0,3
"cg18383079",1,6,5,0,12
"cg18384712",0,1,0,0,1
"cg18384990",0,0,1,0,1
"cg18385205",0,2,2,0,4
"cg18385624",0,0,0,1,1
"cg18386103",0,0,1,0,1
"cg18386796",13,0,0,0,13
"cg18387909",1,0,0,1,2
"cg18389546",0,0,1,0,1
"cg18390325",0,0,1,0,1
"cg18390494",326,71,1,0,398
"cg18391104",0,0,1,0,1
"cg18391203",0,0,1,0,1
"cg18391611",10,2,0,0,12
"cg18391747",3,2,2,0,7
"cg18391803",3,1,0,0,4
"cg18391929",1,2,0,0,3
"cg18392494",24,4,0,0,28
"cg18393044",1,1,0,0,2
"cg18393154",228,2,0,0,230
"cg18393493",0,1,0,0,1
"cg18393722",2,6,0,0,8
"cg18394062",2,0,0,0,2
"cg18394331",1,0,0,0,1
"cg18395189",1,4,3,0,8
"cg18395233",1,2,0,0,3
"cg18395637",2,0,0,0,2
"cg18395728",0,1,10,0,11
"cg18396793",0,0,3,0,3
"cg18397279",0,0,1,0,1
"cg18398175",0,0,1,0,1
"cg18398596",0,0,2,0,2
"cg18399459",74,17,3,0,94
"cg18399711",191,456,80,0,727
"cg18400324",0,0,1,0,1
"cg18401511",16,4,0,0,20
"cg18402189",0,1,0,0,1
"cg18402991",1,1,0,0,2
"cg18404366",0,0,1,0,1
"cg18405536",3,0,0,0,3
"cg18406492",1,0,0,0,1
"cg18406801",0,0,2,0,2
"cg18406924",0,0,1,0,1
"cg18406931",0,4,2,1,7
"cg18407309",2,0,0,0,2
"cg18408341",40,4,0,0,44
"cg18408422",1,2,6,0,9
"cg18410618",1,0,0,0,1
"cg18411009",0,0,3,0,3
"cg18411232",0,2,0,0,2
"cg18411806",0,0,1,0,1
"cg18412394",177,4,0,0,181
"cg18413025",0,1,0,0,1
"cg18413357",128,3,0,0,131
"cg18413502",1,0,0,0,1
"cg18414429",448,23,2,0,473
"cg18415147",0,1,0,0,1
"cg18415193",0,1,0,0,1
"cg18415268",0,1,0,0,1
"cg18415935",0,0,2,0,2
"cg18416251",1,0,0,0,1
"cg18416919",2,0,0,0,2
"cg18417408",1,0,0,0,1
"cg18417707",1,0,0,0,1
"cg18417864",0,0,1,0,1
"cg18418001",0,0,1,0,1
"cg18418479",0,0,2,0,2
"cg18418586",258,34,0,0,292
"cg18418872",0,0,1,0,1
"cg18419142",0,0,1,0,1
"cg18419833",0,0,1,0,1
"cg18421160",2,0,0,0,2
"cg18421839",3,7,2,1,13
"cg18422353",2,0,0,0,2
"cg18424101",18,5,1,0,24
"cg18425002",0,0,1,0,1
"cg18427594",1,0,0,0,1
"cg18427942",1,1,2,0,4
"cg18428104",0,0,1,0,1
"cg18428351",1,1,0,0,2
"cg18430411",0,1,0,0,1
"cg18430645",0,0,2,0,2
"cg18431579",0,1,0,0,1
"cg18431655",0,0,1,0,1
"cg18431765",3,3,0,0,6
"cg18432641",0,0,1,0,1
"cg18434674",0,0,1,0,1
"cg18436176",5,1,0,0,6
"cg18436395",1,0,0,0,1
"cg18436501",0,2,0,0,2
"cg18436714",2,0,0,0,2
"cg18437551",0,0,1,0,1
"cg18438442",1,0,0,0,1
"cg18438850",3,0,0,0,3
"cg18439419",0,0,4,0,4
"cg18439671",737,30,1,0,768
"cg18439861",2,0,0,0,2
"cg18440889",1,0,0,0,1
"cg18442002",0,0,1,0,1
"cg18442532",0,0,1,0,1
"cg18444254",424,193,2,0,619
"cg18444868",1,0,0,0,1
"cg18445710",1,0,0,0,1
"cg18446274",1,3,4,0,8
"cg18448865",0,0,2,0,2
"cg18448991",0,1,2,0,3
"cg18449345",0,1,0,0,1
"cg18449991",0,1,0,0,1
"cg18451982",2,0,0,0,2
"cg18452155",28,2,1,0,31
"cg18453188",1,0,0,0,1
"cg18453324",1,0,0,0,1
"cg18454218",26,1,0,0,27
"cg18454863",0,0,2,0,2
"cg18455490",0,1,0,0,1
"cg18456367",2,3,1,0,6
"cg18457375",0,0,2,0,2
"cg18457818",0,0,1,0,1
"cg18458116",285,204,32,0,521
"cg18459233",2,0,0,0,2
"cg18459590",1,0,0,0,1
"cg18461093",125,309,132,0,566
"cg18461458",9,6,6,0,21
"cg18461733",118,578,4,0,700
"cg18462141",0,4,0,0,4
"cg18462193",110,11,0,0,121
"cg18462506",1,1,1,0,3
"cg18463049",0,1,0,0,1
"cg18463595",0,1,1,0,2
"cg18463988",0,1,0,0,1
"cg18464039",6,5,4,0,15
"cg18464160",0,0,2,0,2
"cg18464244",4,0,0,0,4
"cg18464713",1,0,0,0,1
"cg18465615",0,1,0,0,1
"cg18466320",3,0,0,0,3
"cg18467503",1,0,0,0,1
"cg18468962",1,0,0,0,1
"cg18469506",3,0,0,0,3
"cg18470228",0,1,0,0,1
"cg18470350",47,18,0,0,65
"cg18470904",0,0,3,0,3
"cg18471235",1,0,0,0,1
"cg18471687",1,0,0,0,1
"cg18472239",9,7,16,0,32
"cg18472466",1,0,0,0,1
"cg18472549",0,1,0,0,1
"cg18472699",0,1,0,0,1
"cg18472762",0,0,1,0,1
"cg18473117",1,0,0,0,1
"cg18473153",0,0,1,0,1
"cg18473178",0,3,0,0,3
"cg18473381",0,0,1,0,1
"cg18473705",4,5,0,0,9
"cg18474186",1,0,0,0,1
"cg18474563",22,3,0,0,25
"cg18474718",84,212,47,0,343
"cg18475273",3,0,0,0,3
"cg18475958",0,2,9,0,11
"cg18478891",2,3,2,0,7
"cg18480033",0,1,0,0,1
"cg18480477",3,1,0,0,4
"cg18480627",0,2,0,0,2
"cg18481663",3,2,6,0,11
"cg18483599",0,2,5,0,7
"cg18484797",1,0,0,0,1
"cg18485070",0,0,1,0,1
"cg18485804",0,0,1,0,1
"cg18488075",0,1,0,0,1
"cg18489034",2,3,2,0,7
"cg18489607",0,0,1,0,1
"cg18489959",0,0,1,0,1
"cg18490211",1,1,0,0,2
"cg18490802",4,0,0,0,4
"cg18491464",1,0,0,0,1
"cg18493039",223,185,19,0,427
"cg18493160",0,0,1,0,1
"cg18493491",0,0,0,1,1
"cg18494563",204,13,0,0,217
"cg18494690",0,2,0,0,2
"cg18494742",0,2,0,0,2
"cg18495011",0,1,0,0,1
"cg18495341",0,0,1,0,1
"cg18495869",0,7,7,0,14
"cg18496568",1,1,0,0,2
"cg18496965",108,2,0,0,110
"cg18497291",1,0,0,0,1
"cg18497502",6,1,0,0,7
"cg18499432",1,1,0,0,2
"cg18499566",1,0,0,0,1
"cg18499831",0,0,1,0,1
"cg18499919",1,0,1,0,2
"cg18500360",0,1,0,0,1
"cg18500923",1,7,0,0,8
"cg18501140",5,7,1,0,13
"cg18501395",1,1,5,0,7
"cg18504511",10,6,0,0,16
"cg18507060",1,0,0,0,1
"cg18507153",1,0,0,0,1
"cg18507860",1,0,0,0,1
"cg18507871",2,1,0,0,3
"cg18508694",116,4,0,0,120
"cg18511212",0,1,0,0,1
"cg18511930",1,1,0,0,2
"cg18512780",1,0,0,0,1
"cg18512807",0,1,0,0,1
"cg18512890",0,0,3,0,3
"cg18514358",1,0,0,0,1
"cg18515400",1,1,9,0,11
"cg18515516",2,0,0,0,2
"cg18515820",0,2,0,0,2
"cg18515837",499,15,0,0,514
"cg18516228",314,3,0,0,317
"cg18516241",56,24,1,0,81
"cg18516879",0,0,1,0,1
"cg18520121",1,1,2,0,4
"cg18520446",3,0,0,0,3
"cg18520699",1,0,0,0,1
"cg18521137",0,0,2,0,2
"cg18521564",2,0,0,0,2
"cg18522822",230,338,5,0,573
"cg18524998",0,0,1,0,1
"cg18526140",1,1,0,0,2
"cg18526870",1,0,0,0,1
"cg18526884",1,0,0,0,1
"cg18527706",1,0,0,0,1
"cg18528124",234,34,1,0,269
"cg18528145",0,0,1,0,1
"cg18529294",0,1,0,0,1
"cg18529851",0,1,0,0,1
"cg18529857",0,0,1,0,1
"cg18530779",0,1,0,0,1
"cg18530840",26,2,0,0,28
"cg18531269",0,1,0,0,1
"cg18531401",5,3,1,0,9
"cg18531720",40,1277,58,0,1375
"cg18532089",0,0,1,0,1
"cg18532316",0,1,0,0,1
"cg18532515",0,0,1,0,1
"cg18534061",0,1,0,0,1
"cg18534176",0,0,1,0,1
"cg18536198",0,1,0,0,1
"cg18536496",0,1,0,0,1
"cg18536843",17,0,0,0,17
"cg18537040",0,1,0,0,1
"cg18538276",1,0,1,0,2
"cg18538644",687,239,3,0,929
"cg18538918",1,0,0,0,1
"cg18539988",0,0,2,0,2
"cg18540255",71,420,37,0,528
"cg18540361",1,0,0,0,1
"cg18540939",1,0,0,0,1
"cg18541006",0,30,1,0,31
"cg18544172",1,0,0,0,1
"cg18544740",1,0,2,0,3
"cg18545076",0,0,1,0,1
"cg18545253",29,0,0,0,29
"cg18545992",1,0,0,0,1
"cg18547333",0,0,1,0,1
"cg18547391",9,1,0,0,10
"cg18547505",16,0,0,0,16
"cg18547667",26,17,3,0,46
"cg18547838",1,0,0,0,1
"cg18547980",0,0,0,1,1
"cg18548058",2,0,0,0,2
"cg18548762",5,1,0,0,6
"cg18551129",1,0,0,0,1
"cg18551247",1,0,0,0,1
"cg18552520",0,0,1,0,1
"cg18552521",0,0,1,0,1
"cg18552577",0,0,1,0,1
"cg18553976",0,0,1,0,1
"cg18554430",1,0,0,0,1
"cg18555245",1,0,0,0,1
"cg18556408",0,0,2,0,2
"cg18556734",2,0,0,0,2
"cg18556777",0,0,2,0,2
"cg18556853",1,1,0,0,2
"cg18557707",2,2,4,0,8
"cg18558237",0,1,0,0,1
"cg18558396",1,0,0,0,1
"cg18558770",0,0,1,0,1
"cg18558811",0,5,2,0,7
"cg18559697",4,3,4,0,11
"cg18560502",0,0,1,0,1
"cg18560778",605,27,1,0,633
"cg18561230",0,0,1,0,1
"cg18561871",900,161,6,0,1067
"cg18564458",0,0,1,0,1
"cg18564898",2,0,0,0,2
"cg18565206",1,0,0,0,1
"cg18565899",257,14,1,0,272
"cg18566144",0,0,1,0,1
"cg18566727",0,1,2,0,3
"cg18567941",1,0,0,0,1
"cg18568714",1,0,0,0,1
"cg18569952",241,56,0,0,297
"cg18569988",0,1,2,0,3
"cg18570369",35,12,1,0,48
"cg18570383",1,0,0,0,1
"cg18571789",0,0,1,0,1
"cg18571935",0,1,0,0,1
"cg18572084",0,1,0,0,1
"cg18572127",3,0,0,0,3
"cg18573745",0,1,4,0,5
"cg18574821",1,1,0,0,2
"cg18576230",0,1,1,0,2
"cg18576973",2,0,0,0,2
"cg18577533",1,0,0,0,1
"cg18577618",0,0,1,0,1
"cg18578876",0,0,1,0,1
"cg18579631",0,9,0,0,9
"cg18579688",0,1,0,0,1
"cg18579752",614,621,13,0,1248
"cg18579761",1,2,0,0,3
"cg18580509",0,0,1,0,1
"cg18580697",50,24,1,0,75
"cg18581708",8,2,0,0,10
"cg18582211",0,1,3,0,4
"cg18582216",2,0,0,0,2
"cg18582721",0,0,1,0,1
"cg18582979",0,1,0,0,1
"cg18583094",2,0,0,0,2
"cg18583910",0,0,1,0,1
"cg18584364",0,0,1,0,1
"cg18585975",0,0,1,0,1
"cg18586348",36,0,0,0,36
"cg18586515",21,2,0,0,23
"cg18586758",0,1,1,0,2
"cg18587231",18,4,0,0,22
"cg18587526",2,0,0,0,2
"cg18588206",0,0,6,0,6
"cg18588281",30,2,0,0,32
"cg18588454",1,0,0,0,1
"cg18590611",6,4,0,0,10
"cg18591830",3,3,0,0,6
"cg18592538",32,16,5,0,53
"cg18592680",0,0,1,0,1
"cg18592742",630,355,29,0,1014
"cg18593660",3,0,0,0,3
"cg18594724",0,1,0,0,1
"cg18596010",0,0,1,0,1
"cg18596626",12,3,0,0,15
"cg18596650",9,0,0,0,9
"cg18598057",1,9,8,0,18
"cg18598249",1,0,0,0,1
"cg18598376",0,0,4,0,4
"cg18599206",0,1,0,0,1
"cg18599231",5,2,0,0,7
"cg18599322",3,3,0,0,6
"cg18599790",2,0,0,0,2
"cg18602301",0,0,1,0,1
"cg18602919",1,0,0,0,1
"cg18603692",0,0,1,0,1
"cg18605377",1,0,0,0,1
"cg18605729",1,0,0,0,1
"cg18606115",2,0,0,0,2
"cg18608440",2,0,8,0,10
"cg18609230",1,0,0,0,1
"cg18609490",8,0,0,0,8
"cg18610493",3,0,0,0,3
"cg18611963",1332,430,9,0,1771
"cg18613491",3,2,0,0,5
"cg18613789",1,3,4,0,8
"cg18614139",2,0,0,0,2
"cg18615222",0,1,0,0,1
"cg18615523",1,0,0,0,1
"cg18615970",0,4,1,0,5
"cg18616228",11,6,5,0,22
"cg18616655",4,2,2,0,8
"cg18617276",467,63,0,0,530
"cg18617318",1,0,1,0,2
"cg18617958",1,0,0,0,1
"cg18618194",2,0,0,0,2
"cg18619880",3,1,0,0,4
"cg18620073",0,0,1,0,1
"cg18620225",1,6,0,0,7
"cg18621538",2,1,0,0,3
"cg18621755",1,2,6,0,9
"cg18622413",1,1,0,0,2
"cg18623351",246,295,8,0,549
"cg18624241",0,1,0,0,1
"cg18624562",1,1,0,0,2
"cg18624660",1,0,0,0,1
"cg18625006",0,0,3,0,3
"cg18625258",139,1,1,0,141
"cg18626098",0,1,0,0,1
"cg18627328",0,0,1,0,1
"cg18627389",0,1,0,0,1
"cg18628297",0,0,1,0,1
"cg18628497",0,0,0,1,1
"cg18628962",2,4,2,0,8
"cg18630243",2,0,0,0,2
"cg18631513",288,128,2,0,418
"cg18632100",0,0,2,0,2
"cg18632724",1,0,0,0,1
"cg18634398",1,0,0,0,1
"cg18634443",0,0,1,0,1
"cg18636679",0,0,1,0,1
"cg18636728",237,7,1,0,245
"cg18637291",165,67,10,0,242
"cg18638763",1,0,0,0,1
"cg18639097",0,1,0,0,1
"cg18640302",1,0,0,0,1
"cg18640314",0,0,1,0,1
"cg18640744",0,0,1,0,1
"cg18641056",1,0,0,0,1
"cg18641876",44,5,0,0,49
"cg18642942",0,0,1,0,1
"cg18643132",0,0,1,0,1
"cg18643563",22,15,2,0,39
"cg18643977",1,0,0,0,1
"cg18644525",1123,131,1,0,1255
"cg18644892",0,0,2,0,2
"cg18645438",1,0,0,0,1
"cg18646036",0,0,3,0,3
"cg18646347",1,1,0,0,2
"cg18647048",1,3,6,0,10
"cg18648932",0,0,1,0,1
"cg18649582",0,0,1,0,1
"cg18650518",0,0,1,0,1
"cg18650659",2,0,0,0,2
"cg18650693",3,0,0,0,3
"cg18651515",0,0,1,0,1
"cg18651544",5,2,0,0,7
"cg18652076",0,1,0,0,1
"cg18652248",1,0,1,0,2
"cg18654622",1,0,2,0,3
"cg18656195",0,0,2,0,2
"cg18656267",2,0,0,0,2
"cg18657321",2,1,0,0,3
"cg18657360",0,1,0,0,1
"cg18659398",0,0,1,0,1
"cg18660087",2,2,0,0,4
"cg18660689",10,2,0,0,12
"cg18660980",110,16,0,0,126
"cg18664595",1,1,0,0,2
"cg18665816",1,1,0,0,2
"cg18667757",4,0,1,0,5
"cg18668183",233,100,2,0,335
"cg18669135",0,2,0,0,2
"cg18669948",0,0,1,0,1
"cg18671318",0,1,2,0,3
"cg18671984",1,2,0,0,3
"cg18672324",6,11,14,0,31
"cg18672602",1,1,1,0,3
"cg18674446",1,1,0,0,2
"cg18675361",47,6,0,0,53
"cg18675922",1,0,1,0,2
"cg18676082",7,8,6,1,22
"cg18676488",333,413,43,0,789
"cg18677862",14,32,35,0,81
"cg18677996",8,27,17,0,52
"cg18678716",96,12,0,0,108
"cg18680860",0,1,0,0,1
"cg18681837",0,1,0,0,1
"cg18683691",9,1,3,0,13
"cg18684998",0,0,1,0,1
"cg18685836",0,0,1,0,1
"cg18686866",91,2,0,0,93
"cg18687914",5,0,0,0,5
"cg18688336",0,0,1,0,1
"cg18689223",0,1,0,0,1
"cg18689503",1,1,0,0,2
"cg18689925",1,0,0,0,1
"cg18690712",312,135,23,0,470
"cg18692705",6,6,0,0,12
"cg18692817",3,0,0,0,3
"cg18693346",1,1,2,0,4
"cg18693474",2,5,2,0,9
"cg18694631",2,0,0,0,2
"cg18694758",52,567,105,0,724
"cg18696361",1,1,2,0,4
"cg18696805",937,69,0,0,1006
"cg18697634",24,33,8,0,65
"cg18698399",0,0,1,0,1
"cg18699330",4,0,0,0,4
"cg18700146",10,1,0,0,11
"cg18701126",1,0,0,0,1
"cg18701218",2,1,3,0,6
"cg18702166",0,0,1,0,1
"cg18702463",16,5,1,0,22
"cg18703875",0,0,1,0,1
"cg18703910",0,1,0,0,1
"cg18703935",1,2,2,0,5
"cg18704057",2,0,1,0,3
"cg18704218",3,2,0,0,5
"cg18704443",0,0,1,0,1
"cg18705643",66,18,2,0,86
"cg18705909",2,0,1,0,3
"cg18706228",0,0,4,0,4
"cg18706881",94,6,0,0,100
"cg18707575",2,2,0,0,4
"cg18707706",0,0,1,0,1
"cg18707845",1,0,0,0,1
"cg18708627",0,1,0,0,1
"cg18710738",1,0,0,0,1
"cg18711081",0,1,0,0,1
"cg18711246",0,2,2,0,4
"cg18711921",2,0,3,0,5
"cg18713646",1,0,0,0,1
"cg18714358",0,0,1,0,1
"cg18714767",0,0,1,0,1
"cg18715693",2,0,0,0,2
"cg18715854",1,0,0,0,1
"cg18716194",0,3,1,0,4
"cg18716831",15,3,0,0,18
"cg18717124",2,0,0,0,2
"cg18719301",2,0,1,0,3
"cg18720736",0,0,1,0,1
"cg18721544",0,2,2,0,4
"cg18721956",1,0,0,0,1
"cg18722304",0,0,1,0,1
"cg18722631",0,1,0,0,1
"cg18723432",1,0,0,0,1
"cg18724061",3,0,0,0,3
"cg18724072",55,8,2,0,65
"cg18724565",0,1,0,0,1
"cg18724652",1,0,0,0,1
"cg18725195",1,2,0,0,3
"cg18726360",41,113,3,0,157
"cg18727270",4,1,0,0,5
"cg18727788",0,0,2,0,2
"cg18729133",1,0,0,0,1
"cg18729357",2,1,0,0,3
"cg18730242",570,49,1,0,620
"cg18730307",13,1,0,0,14
"cg18736266",4,0,0,0,4
"cg18736496",1,0,1,0,2
"cg18737075",36,1,0,0,37
"cg18737971",1,0,0,0,1
"cg18738114",82,5,0,0,87
"cg18738391",0,1,0,0,1
"cg18738545",1,1,0,0,2
"cg18738630",7,15,1,0,23
"cg18739103",2,0,0,0,2
"cg18739602",1,0,0,0,1
"cg18740872",1,0,0,0,1
"cg18741744",0,1,2,0,3
"cg18741815",0,0,1,0,1
"cg18742045",1,0,0,0,1
"cg18742207",1,0,0,0,1
"cg18742559",1,0,0,0,1
"cg18744145",1,0,0,0,1
"cg18746263",758,43,0,0,801
"cg18750306",1,0,1,0,2
"cg18751657",1,0,2,0,3
"cg18752867",3,0,0,0,3
"cg18753516",1,0,0,0,1
"cg18754747",0,0,0,1,1
"cg18755798",1,0,0,0,1
"cg18757146",0,0,1,0,1
"cg18757828",0,0,1,0,1
"cg18759260",14,0,0,0,14
"cg18760222",112,163,15,0,290
"cg18760594",1,3,23,0,27
"cg18760933",1,5,0,0,6
"cg18761057",1,0,0,0,1
"cg18761118",480,32,1,0,513
"cg18761221",1,0,22,0,23
"cg18761773",0,1,1,0,2
"cg18761878",0,1,1,0,2
"cg18762488",266,638,10,0,914
"cg18762849",0,1,0,0,1
"cg18763747",1,0,0,0,1
"cg18765637",6,4,0,0,10
"cg18765712",0,0,1,0,1
"cg18766111",177,185,7,0,369
"cg18766483",2,0,0,0,2
"cg18766755",1,1,0,0,2
"cg18766791",3,7,2,0,12
"cg18767287",21,0,0,0,21
"cg18768299",0,2,0,0,2
"cg18768582",0,0,1,0,1
"cg18769125",6,12,7,0,25
"cg18769420",0,1,0,0,1
"cg18770284",2,1,0,0,3
"cg18771118",257,28,4,0,289
"cg18772152",173,347,119,0,639
"cg18773308",0,2,1,0,3
"cg18773354",3,0,0,0,3
"cg18774511",0,2,3,0,5
"cg18775145",0,1,0,0,1
"cg18775465",1,1,0,0,2
"cg18775539",0,0,2,0,2
"cg18775566",237,114,7,0,358
"cg18776840",1,0,0,0,1
"cg18778218",0,1,0,0,1
"cg18778857",0,0,2,0,2
"cg18779314",0,1,0,0,1
"cg18779556",0,0,1,0,1
"cg18780627",0,0,1,0,1
"cg18780653",0,1,2,0,3
"cg18780796",0,0,1,0,1
"cg18782447",0,2,0,0,2
"cg18783135",2,0,0,0,2
"cg18783410",3,5,0,0,8
"cg18783467",1,2,2,0,5
"cg18784929",0,1,1,0,2
"cg18787267",1,0,0,0,1
"cg18788413",1,23,0,0,24
"cg18789636",2,4,0,0,6
"cg18790372",3,0,0,0,3
"cg18790774",1,0,0,0,1
"cg18791672",0,0,1,0,1
"cg18793886",70,13,1,0,84
"cg18794058",0,0,1,0,1
"cg18794878",14,3,0,0,17
"cg18795277",3,0,0,0,3
"cg18795825",0,1,0,0,1
"cg18796919",128,18,1,0,147
"cg18796948",0,0,1,0,1
"cg18798344",0,0,1,0,1
"cg18798412",1,0,0,0,1
"cg18798622",0,1,1,0,2
"cg18798702",0,0,1,0,1
"cg18799102",1,0,0,0,1
"cg18801480",0,0,1,0,1
"cg18801713",0,0,1,0,1
"cg18803079",1,0,0,0,1
"cg18803850",33,30,5,0,68
"cg18805950",0,0,3,0,3
"cg18805978",0,1,1,0,2
"cg18809856",1,0,0,0,1
"cg18809873",1,0,0,0,1
"cg18809991",1,0,0,0,1
"cg18810244",1,0,0,0,1
"cg18810737",1,0,1,0,2
"cg18811597",3,0,1,0,4
"cg18812253",1,1,0,0,2
"cg18813182",0,1,0,0,1
"cg18813867",243,215,21,0,479
"cg18813928",1,0,0,0,1
"cg18814748",0,0,2,0,2
"cg18814929",0,0,2,0,2
"cg18816074",0,0,1,0,1
"cg18816257",0,1,0,0,1
"cg18816800",0,0,1,0,1
"cg18817246",86,49,4,0,139
"cg18817616",0,3,0,0,3
"cg18818280",0,0,3,0,3
"cg18819091",1,0,0,0,1
"cg18819574",1,0,0,0,1
"cg18821867",0,1,0,0,1
"cg18823189",1,0,0,0,1
"cg18824501",148,24,0,0,172
"cg18824596",1,0,0,0,1
"cg18826070",8,1,0,0,9
"cg18826167",10,1,0,0,11
"cg18827566",2,1,0,0,3
"cg18827763",0,1,0,0,1
"cg18828681",4,0,0,0,4
"cg18828762",19,1,0,0,20
"cg18830042",0,0,1,0,1
"cg18830273",52,19,5,0,76
"cg18831604",1,1,0,0,2
"cg18831910",0,1,2,0,3
"cg18833643",2,0,0,0,2
"cg18833896",55,35,20,0,110
"cg18833907",0,0,1,0,1
"cg18834416",1,0,0,0,1
"cg18834837",8,1,0,0,9
"cg18835078",0,0,3,0,3
"cg18835586",0,0,1,1,2
"cg18836583",1,0,0,0,1
"cg18838133",0,0,1,0,1
"cg18838257",0,1,2,0,3
"cg18838694",5,0,0,0,5
"cg18841062",1,0,0,0,1
"cg18841579",0,0,1,0,1
"cg18842080",0,0,1,0,1
"cg18843192",109,17,0,0,126
"cg18843612",7,1,0,0,8
"cg18844314",0,9,0,0,9
"cg18845566",0,0,1,0,1
"cg18846557",0,3,2,0,5
"cg18846877",1,1,0,0,2
"cg18846998",80,11,0,0,91
"cg18847160",88,1,0,0,89
"cg18847474",1,0,0,0,1
"cg18851319",2,1,1,0,4
"cg18851673",0,0,1,0,1
"cg18853312",6,4,0,0,10
"cg18854398",1,0,0,0,1
"cg18857726",2,0,0,0,2
"cg18860136",0,1,1,0,2
"cg18860954",1,0,0,0,1
"cg18861917",0,3,0,0,3
"cg18862836",122,26,1,0,149
"cg18862888",0,1,0,0,1
"cg18864706",2,0,24,0,26
"cg18865257",0,1,0,0,1
"cg18865708",0,0,1,0,1
"cg18865733",15,4,0,0,19
"cg18866013",0,0,1,0,1
"cg18867390",0,0,2,0,2
"cg18867491",1,0,0,0,1
"cg18867708",4,28,7,0,39
"cg18867970",68,8,2,0,78
"cg18869304",0,0,3,0,3
"cg18870230",1,0,0,0,1
"cg18870720",0,2,1,0,3
"cg18871813",1,0,0,0,1
"cg18872781",2,0,0,0,2
"cg18873674",227,76,4,0,307
"cg18873792",13,1,0,0,14
"cg18873909",0,2,7,0,9
"cg18874143",0,1,0,0,1
"cg18874483",2,0,0,0,2
"cg18874502",0,0,0,1,1
"cg18874533",3,0,0,0,3
"cg18874953",83,19,0,0,102
"cg18876405",2,0,1,0,3
"cg18876438",3,1,1,0,5
"cg18877213",2,4,0,0,6
"cg18877558",1,0,0,0,1
"cg18879991",3,4,0,0,7
"cg18880465",0,1,1,0,2
"cg18883217",0,1,0,0,1
"cg18883538",0,4,2,0,6
"cg18883976",32,2,0,0,34
"cg18884869",0,1,2,0,3
"cg18885708",148,348,113,0,609
"cg18885872",0,1,0,0,1
"cg18886814",10,1,0,0,11
"cg18887024",0,1,0,0,1
"cg18887165",0,1,0,0,1
"cg18887962",0,0,0,1,1
"cg18890249",0,0,1,0,1
"cg18890876",11,15,12,0,38
"cg18891485",0,0,1,0,1
"cg18891762",3,2,0,0,5
"cg18892624",0,0,1,0,1
"cg18892891",0,1,0,0,1
"cg18893641",1,0,0,0,1
"cg18893792",1,0,0,0,1
"cg18894138",104,4,0,0,108
"cg18895859",3,0,0,0,3
"cg18896026",2,0,0,0,2
"cg18896967",0,1,0,0,1
"cg18897962",1,0,0,0,1
"cg18899802",127,469,23,0,619
"cg18900477",2,0,0,0,2
"cg18900535",0,1,0,0,1
"cg18901045",16,10,5,0,31
"cg18902440",1,0,0,0,1
"cg18903150",4,2,0,0,6
"cg18903373",3,1,0,0,4
"cg18904554",121,530,35,0,686
"cg18905174",0,1,0,0,1
"cg18905813",20,0,0,0,20
"cg18906043",0,0,2,0,2
"cg18906283",0,0,1,0,1
"cg18906478",5,0,0,0,5
"cg18907254",0,4,5,0,9
"cg18907975",0,0,1,0,1
"cg18908071",3,5,0,0,8
"cg18908681",0,0,1,0,1
"cg18908811",1,0,0,0,1
"cg18909982",6,3,0,0,9
"cg18910548",0,1,0,0,1
"cg18910882",33,3,0,0,36
"cg18911455",0,1,0,0,1
"cg18912001",0,1,0,0,1
"cg18912560",1,2,12,0,15
"cg18913310",0,0,1,0,1
"cg18913464",0,0,0,1,1
"cg18913869",2,0,0,0,2
"cg18913951",0,1,0,0,1
"cg18914211",1,1,0,0,2
"cg18914389",0,0,1,0,1
"cg18914892",0,0,2,0,2
"cg18915009",0,1,0,0,1
"cg18915913",1,0,0,0,1
"cg18915994",0,3,9,0,12
"cg18916922",1,0,0,0,1
"cg18918083",3,46,0,0,49
"cg18918365",191,333,8,0,532
"cg18918396",2,0,0,0,2
"cg18919024",0,1,2,0,3
"cg18920490",0,0,1,0,1
"cg18922652",0,0,1,0,1
"cg18922792",0,1,0,0,1
"cg18923388",48,0,0,0,48
"cg18923912",0,1,0,0,1
"cg18924405",0,0,2,0,2
"cg18925560",0,1,0,0,1
"cg18926108",0,0,1,0,1
"cg18926286",1,1,0,0,2
"cg18926508",0,0,2,0,2
"cg18927521",0,0,1,0,1
"cg18927527",0,0,1,0,1
"cg18928359",1,0,0,0,1
"cg18929663",2,1,0,0,3
"cg18930448",1,0,0,0,1
"cg18931036",1,1,2,0,4
"cg18931273",3,6,0,0,9
"cg18932121",28,1,0,0,29
"cg18932417",0,0,1,0,1
"cg18934490",1,0,1,0,2
"cg18934641",0,0,4,0,4
"cg18934713",1,0,4,0,5
"cg18935014",0,2,0,0,2
"cg18935108",0,1,0,0,1
"cg18935740",16,0,0,0,16
"cg18936997",0,1,0,0,1
"cg18937265",1211,383,7,0,1601
"cg18937897",3,0,0,0,3
"cg18938328",0,1,0,0,1
"cg18938488",0,1,0,0,1
"cg18938933",0,0,1,0,1
"cg18938977",2,0,0,0,2
"cg18940047",0,0,1,0,1
"cg18941085",12,6,0,0,18
"cg18942090",0,0,1,0,1
"cg18942748",0,0,1,0,1
"cg18943014",0,0,0,1,1
"cg18943033",12,3,2,0,17
"cg18943317",10,1,0,0,11
"cg18943411",1,0,0,0,1
"cg18944558",0,1,0,0,1
"cg18945086",0,1,0,0,1
"cg18946489",0,0,1,0,1
"cg18946932",0,0,1,0,1
"cg18947305",115,12,0,0,127
"cg18948941",5,0,0,0,5
"cg18949886",1,0,0,0,1
"cg18952683",181,148,2,0,331
"cg18953747",0,0,1,0,1
"cg18953829",0,2,3,0,5
"cg18954636",1,0,0,0,1
"cg18954825",83,4,0,0,87
"cg18954865",1,0,0,0,1
"cg18955836",0,1,0,0,1
"cg18957037",1,1,1,0,3
"cg18958451",2,2,0,0,4
"cg18958591",12,1,0,0,13
"cg18960741",1,0,0,0,1
"cg18961773",0,1,2,0,3
"cg18962702",66,37,6,0,109
"cg18963021",6,0,0,0,6
"cg18963800",0,0,1,0,1
"cg18964422",2,17,8,0,27
"cg18964454",24,5,0,0,29
"cg18964913",0,9,2,0,11
"cg18964985",0,1,0,0,1
"cg18967208",0,1,0,0,1
"cg18968278",0,0,1,0,1
"cg18968670",6,0,0,0,6
"cg18970434",1,0,1,0,2
"cg18970800",2,7,1,0,10
"cg18971492",5,0,0,0,5
"cg18972467",0,1,0,0,1
"cg18972517",0,0,1,0,1
"cg18976797",2,32,0,0,34
"cg18979623",0,0,1,0,1
"cg18980210",0,1,0,0,1
"cg18980548",2,0,0,0,2
"cg18982003",0,1,0,0,1
"cg18982238",970,386,10,0,1366
"cg18983011",0,0,1,0,1
"cg18983259",1,1,1,0,3
"cg18986749",0,0,1,0,1
"cg18987284",0,1,0,0,1
"cg18987491",0,1,2,0,3
"cg18988861",2,2,6,0,10
"cg18989477",0,2,0,0,2
"cg18989499",20,1,0,0,21
"cg18991375",1,0,0,0,1
"cg18993626",1,0,0,0,1
"cg18993641",0,3,1,0,4
"cg18994377",1,4,0,0,5
"cg18995027",0,0,1,0,1
"cg18995097",195,492,46,0,733
"cg18995253",0,0,1,0,1
"cg18999641",5,0,0,0,5
"cg19001522",1,0,0,0,1
"cg19002680",4,0,0,0,4
"cg19002784",6,1,0,0,7
"cg19004718",3,2,0,0,5
"cg19005519",0,3,1,0,4
"cg19007031",1,2,11,0,14
"cg19007523",361,187,8,0,556
"cg19008475",21,1,0,0,22
"cg19008523",610,513,18,0,1141
"cg19008921",204,36,0,0,240
"cg19009677",1,1,0,0,2
"cg19009975",0,0,1,0,1
"cg19010493",0,0,2,0,2
"cg19010528",2,3,12,0,17
"cg19010850",0,2,0,0,2
"cg19010858",0,0,3,0,3
"cg19011226",15,0,0,0,15
"cg19011552",0,2,0,0,2
"cg19013417",0,1,0,0,1
"cg19015686",5,2,0,0,7
"cg19015955",0,1,4,0,5
"cg19016264",1,2,0,0,3
"cg19016444",0,1,0,0,1
"cg19017206",1,0,0,0,1
"cg19019800",0,0,1,0,1
"cg19020103",2,0,3,0,5
"cg19021496",23,7,3,0,33
"cg19023300",0,1,0,0,1
"cg19024126",3,0,0,0,3
"cg19025396",1,1,0,0,2
"cg19026724",1,0,0,0,1
"cg19027234",0,2,0,0,2
"cg19027884",1,0,0,0,1
"cg19030310",0,0,1,0,1
"cg19032326",0,1,0,0,1
"cg19033271",123,6,0,0,129
"cg19033502",0,0,1,0,1
"cg19033690",1,2,0,0,3
"cg19033900",0,1,0,0,1
"cg19034149",8,3,3,0,14
"cg19034553",1,0,0,0,1
"cg19035031",0,2,4,0,6
"cg19035107",0,0,3,0,3
"cg19035348",0,0,1,0,1
"cg19036323",0,1,0,0,1
"cg19037467",20,9,0,0,29
"cg19038327",0,2,0,0,2
"cg19038909",1,0,0,0,1
"cg19039769",1,0,0,0,1
"cg19039841",79,0,0,0,79
"cg19040657",172,9,0,0,181
"cg19040702",6,6,2,0,14
"cg19040813",3,0,0,0,3
"cg19041462",1,0,0,0,1
"cg19042070",0,1,0,0,1
"cg19042950",0,1,0,0,1
"cg19043665",0,1,1,0,2
"cg19044462",1,0,0,0,1
"cg19045284",38,2,0,0,40
"cg19045983",0,0,1,0,1
"cg19046783",0,1,0,0,1
"cg19047942",0,4,2,0,6
"cg19048811",10,19,0,1,30
"cg19050514",0,1,0,0,1
"cg19050765",0,12,17,1,30
"cg19051431",0,2,0,0,2
"cg19051912",0,0,1,0,1
"cg19052036",2,2,1,0,5
"cg19052952",1,2,0,0,3
"cg19053287",7,1,0,0,8
"cg19054140",1,0,0,0,1
"cg19055390",1,0,0,0,1
"cg19055869",0,0,1,0,1
"cg19056537",0,6,0,0,6
"cg19057994",0,2,0,0,2
"cg19058138",0,1,0,0,1
"cg19059344",1,1,0,0,2
"cg19059907",7,3,0,0,10
"cg19060929",0,1,0,0,1
"cg19061000",0,0,1,0,1
"cg19061089",44,3,2,0,49
"cg19062689",0,1,0,0,1
"cg19062878",0,0,1,0,1
"cg19066691",43,56,1,0,100
"cg19066999",54,2,0,0,56
"cg19069283",8,0,0,0,8
"cg19071002",1,1,5,0,7
"cg19071398",33,29,3,0,65
"cg19071460",64,130,205,0,399
"cg19071884",1,0,0,0,1
"cg19072080",0,0,1,0,1
"cg19073701",0,0,8,0,8
"cg19074105",1,0,0,0,1
"cg19074300",2,2,0,0,4
"cg19074474",104,114,16,0,234
"cg19075213",1,0,0,0,1
"cg19075777",0,0,2,0,2
"cg19077165",0,0,1,0,1
"cg19078226",1125,256,0,0,1381
"cg19078789",0,0,1,0,1
"cg19079227",1,0,0,0,1
"cg19080925",74,15,0,0,89
"cg19081358",7,4,0,0,11
"cg19081662",1,4,16,0,21
"cg19081751",48,0,0,0,48
"cg19082600",5,8,1,0,14
"cg19082888",3,4,0,0,7
"cg19082970",0,0,0,2,2
"cg19083252",0,1,2,0,3
"cg19084963",0,0,1,0,1
"cg19085554",180,442,11,0,633
"cg19085589",3,0,0,0,3
"cg19085703",3,0,0,0,3
"cg19086570",2,0,0,0,2
"cg19087104",50,1,0,0,51
"cg19087790",0,0,1,0,1
"cg19088104",1,0,0,0,1
"cg19088856",2,0,0,0,2
"cg19089102",0,0,1,0,1
"cg19089649",1,0,0,0,1
"cg19090157",0,0,1,0,1
"cg19090533",0,0,0,1,1
"cg19091162",1,0,0,0,1
"cg19092045",2,0,0,0,2
"cg19094271",4,1,0,0,5
"cg19094358",1,0,0,0,1
"cg19096357",8,3,2,0,13
"cg19096791",0,1,0,0,1
"cg19096812",12,0,0,0,12
"cg19096967",1,0,0,0,1
"cg19097082",0,3,0,0,3
"cg19097551",46,688,65,0,799
"cg19100766",0,0,1,0,1
"cg19101665",1,0,0,0,1
"cg19101998",0,1,0,0,1
"cg19102272",0,0,1,0,1
"cg19104026",14,0,0,0,14
"cg19104045",0,1,0,0,1
"cg19105245",0,0,1,0,1
"cg19105504",1,0,0,0,1
"cg19106478",3,0,0,0,3
"cg19106775",0,0,2,0,2
"cg19107429",0,0,3,0,3
"cg19108904",1,0,0,0,1
"cg19109244",4,0,0,0,4
"cg19109583",1,0,0,0,1
"cg19109729",1,0,0,0,1
"cg19111030",7,0,0,0,7
"cg19112290",1,0,0,0,1
"cg19112424",0,1,6,0,7
"cg19113169",0,0,1,0,1
"cg19113717",380,208,17,0,605
"cg19114779",2,0,0,0,2
"cg19114949",0,0,1,0,1
"cg19116197",0,1,0,0,1
"cg19117517",0,1,0,0,1
"cg19117904",53,1,0,0,54
"cg19118539",1,0,0,0,1
"cg19118569",3,1,0,0,4
"cg19119072",13,0,0,0,13
"cg19119382",0,3,1,0,4
"cg19119716",0,0,1,0,1
"cg19120046",1,0,0,0,1
"cg19120749",0,0,1,0,1
"cg19121055",0,0,1,0,1
"cg19121462",1,2,0,0,3
"cg19123251",203,32,3,0,238
"cg19124300",18,0,0,0,18
"cg19125660",2,0,0,0,2
"cg19126254",0,1,0,0,1
"cg19127208",0,3,5,0,8
"cg19127541",0,3,0,0,3
"cg19127909",0,1,0,0,1
"cg19129184",0,1,0,0,1
"cg19129325",7,4,0,0,11
"cg19129747",1,0,0,0,1
"cg19129795",0,0,2,0,2
"cg19129985",2,0,0,0,2
"cg19130188",0,0,2,0,2
"cg19130645",0,0,1,0,1
"cg19132803",0,0,1,0,1
"cg19132994",0,1,1,0,2
"cg19133466",0,0,1,0,1
"cg19133629",4,0,0,0,4
"cg19133956",3,1,3,0,7
"cg19134765",1,0,0,0,1
"cg19135860",1,0,0,0,1
"cg19138325",1,0,0,0,1
"cg19138957",1,0,0,0,1
"cg19139448",0,1,0,0,1
"cg19141973",1,0,0,0,1
"cg19142319",1,0,0,0,1
"cg19143671",1,0,0,0,1
"cg19144531",8,2,0,0,10
"cg19144658",0,1,0,0,1
"cg19145136",0,1,0,0,1
"cg19145331",0,0,6,0,6
"cg19146119",1,0,0,0,1
"cg19146749",0,0,1,0,1
"cg19148305",0,1,0,0,1
"cg19148395",1,0,0,0,1
"cg19148640",2,0,0,0,2
"cg19149272",2,0,0,0,2
"cg19149936",10,4,0,0,14
"cg19150086",112,12,0,0,124
"cg19151387",0,0,1,0,1
"cg19151612",93,31,0,0,124
"cg19153233",0,0,0,1,1
"cg19153883",4,5,1,0,10
"cg19154754",80,66,4,0,150
"cg19154857",0,1,1,0,2
"cg19158707",0,0,1,0,1
"cg19159407",0,0,1,0,1
"cg19160264",0,0,1,0,1
"cg19161017",1,0,2,0,3
"cg19164096",1,0,0,0,1
"cg19164833",4,0,0,0,4
"cg19165105",0,1,0,0,1
"cg19166401",0,0,0,1,1
"cg19167854",1,0,0,0,1
"cg19168804",8,4,1,0,13
"cg19170036",0,1,2,0,3
"cg19170208",1,0,0,0,1
"cg19170982",0,1,0,0,1
"cg19171175",0,0,1,0,1
"cg19172662",8,0,0,0,8
"cg19173487",0,1,0,0,1
"cg19173554",0,0,1,0,1
"cg19175993",1,0,0,0,1
"cg19178441",0,1,0,0,1
"cg19178561",4,5,1,0,10
"cg19179150",0,3,1,0,4
"cg19179237",12,3,1,0,16
"cg19180492",2,0,0,0,2
"cg19181244",0,1,0,0,1
"cg19182928",5,1,0,0,6
"cg19183932",0,0,1,0,1
"cg19185641",1,0,0,0,1
"cg19185958",2,2,0,0,4
"cg19186089",1,2,0,0,3
"cg19186136",115,2,0,0,117
"cg19187043",4,0,0,0,4
"cg19187798",1,0,0,0,1
"cg19188207",12,9,1,0,22
"cg19188893",1,0,0,0,1
"cg19189213",0,0,1,0,1
"cg19193943",110,4,0,0,114
"cg19194098",0,0,1,0,1
"cg19195760",11,10,1,0,22
"cg19195935",0,0,1,0,1
"cg19196258",0,2,0,0,2
"cg19196609",0,3,2,0,5
"cg19197082",851,833,39,0,1723
"cg19197888",0,0,1,0,1
"cg19198054",58,24,3,0,85
"cg19198178",1,0,0,0,1
"cg19199932",1,0,0,0,1
"cg19200561",6,1,0,0,7
"cg19200814",0,0,1,0,1
"cg19201533",0,0,1,0,1
"cg19201725",14,2,0,0,16
"cg19202986",0,0,1,0,1
"cg19203504",0,1,0,0,1
"cg19203575",1,1,0,0,2
"cg19204924",0,0,1,0,1
"cg19207361",1,0,0,0,1
"cg19207383",8,3,1,0,12
"cg19207393",0,1,0,0,1
"cg19207486",1,0,0,0,1
"cg19207487",0,0,5,0,5
"cg19210699",0,1,0,0,1
"cg19210808",0,1,3,0,4
"cg19212828",10,5,0,0,15
"cg19214126",1,0,0,0,1
"cg19214658",1,0,0,0,1
"cg19216204",23,3,0,0,26
"cg19216286",188,540,3,0,731
"cg19217463",0,0,1,0,1
"cg19217918",1,0,0,0,1
"cg19219834",0,1,0,0,1
"cg19220091",0,0,5,0,5
"cg19222366",1,30,10,0,41
"cg19224280",1,1,0,0,2
"cg19225178",153,582,16,0,751
"cg19225868",0,1,0,0,1
"cg19226007",0,1,0,0,1
"cg19226203",0,0,1,0,1
"cg19226370",145,46,6,0,197
"cg19228966",18,3,0,0,21
"cg19229309",0,1,0,0,1
"cg19229402",0,0,1,0,1
"cg19230048",1,0,0,0,1
"cg19231165",18,0,0,0,18
"cg19231697",0,1,3,0,4
"cg19231742",7,3,0,0,10
"cg19232815",1,0,0,0,1
"cg19233088",3,0,0,0,3
"cg19234439",0,0,1,0,1
"cg19236158",8,0,1,0,9
"cg19236263",0,1,0,0,1
"cg19236708",0,0,1,0,1
"cg19236768",0,1,0,0,1
"cg19237825",1,0,0,0,1
"cg19239930",175,58,0,0,233
"cg19240039",0,1,0,0,1
"cg19240319",0,0,4,0,4
"cg19241305",3,15,0,0,18
"cg19241542",25,32,3,0,60
"cg19241670",0,1,0,0,1
"cg19243585",0,2,1,0,3
"cg19244200",0,1,0,0,1
"cg19244342",90,107,25,0,222
"cg19244834",17,1,1,0,19
"cg19244928",2,0,0,0,2
"cg19245631",0,3,0,0,3
"cg19245664",0,0,1,0,1
"cg19245773",0,0,0,1,1
"cg19246080",0,0,1,0,1
"cg19246873",0,2,2,0,4
"cg19247398",9,1,0,0,10
"cg19248041",0,0,3,0,3
"cg19248797",26,641,72,0,739
"cg19249583",443,13,1,0,457
"cg19250002",0,0,2,0,2
"cg19250579",2,4,3,0,9
"cg19250989",0,1,0,0,1
"cg19251738",1,0,2,0,3
"cg19252515",1,0,0,0,1
"cg19252891",12,1,0,0,13
"cg19255053",1,0,0,0,1
"cg19255278",0,0,1,1,2
"cg19255660",9,7,13,0,29
"cg19256675",0,1,2,0,3
"cg19257462",0,0,1,0,1
"cg19257942",5,0,1,0,6
"cg19258508",1,0,0,0,1
"cg19258565",0,0,2,0,2
"cg19258595",17,6,0,0,23
"cg19258873",0,0,1,0,1
"cg19259127",0,3,1,0,4
"cg19259415",1,0,0,0,1
"cg19259829",150,217,65,0,432
"cg19260144",13,0,1,0,14
"cg19261068",0,1,0,0,1
"cg19261864",12,2,0,0,14
"cg19262382",0,1,1,0,2
"cg19262679",3,0,0,0,3
"cg19263575",218,354,29,0,601
"cg19263761",0,2,3,0,5
"cg19265641",9,0,0,0,9
"cg19265948",3,0,1,0,4
"cg19266945",2,0,0,0,2
"cg19267742",47,48,9,0,104
"cg19267849",1,0,0,0,1
"cg19268083",0,0,1,0,1
"cg19268477",0,1,2,0,3
"cg19268509",0,0,1,0,1
"cg19269612",0,0,2,0,2
"cg19270557",1,2,1,0,4
"cg19272606",1,0,0,0,1
"cg19272695",1,0,1,0,2
"cg19273129",0,1,0,0,1
"cg19273422",0,1,0,0,1
"cg19273495",0,4,1,0,5
"cg19274680",1,0,0,0,1
"cg19275995",0,1,0,0,1
"cg19275999",1,0,0,0,1
"cg19276736",20,2,0,0,22
"cg19277159",0,0,1,0,1
"cg19277401",0,1,0,0,1
"cg19278232",1,0,0,0,1
"cg19278827",0,1,0,0,1
"cg19278884",1,0,0,0,1
"cg19279464",1,0,2,0,3
"cg19280196",0,0,1,0,1
"cg19282068",7,21,8,0,36
"cg19282219",0,0,1,0,1
"cg19282411",0,1,0,0,1
"cg19283110",0,0,1,0,1
"cg19283595",0,0,1,0,1
"cg19284548",0,0,3,0,3
"cg19287121",0,0,2,0,2
"cg19287220",2,0,0,0,2
"cg19287961",2,1,0,0,3
"cg19291303",1,0,0,0,1
"cg19292611",1,0,1,0,2
"cg19293784",0,1,2,0,3
"cg19294953",1,0,1,0,2
"cg19296958",0,1,0,0,1
"cg19296997",0,1,0,0,1
"cg19297065",0,0,1,0,1
"cg19297164",56,0,0,0,56
"cg19299965",0,4,0,0,4
"cg19300489",8,0,0,0,8
"cg19302210",0,0,1,0,1
"cg19303076",1,0,0,0,1
"cg19303103",13,6,13,0,32
"cg19304273",0,0,2,0,2
"cg19304346",0,0,1,0,1
"cg19304600",1,0,0,0,1
"cg19305604",0,0,1,0,1
"cg19305879",2,5,0,0,7
"cg19306761",1,0,0,0,1
"cg19306990",2,0,0,0,2
"cg19307090",26,0,0,0,26
"cg19308316",1,0,0,0,1
"cg19309043",19,14,0,0,33
"cg19309149",0,0,1,0,1
"cg19309507",4,0,0,0,4
"cg19310612",1,0,0,0,1
"cg19312971",0,1,0,0,1
"cg19313143",9,1,0,0,10
"cg19315730",3,4,3,0,10
"cg19316489",21,5,1,0,27
"cg19316897",140,450,0,0,590
"cg19317433",0,1,0,0,1
"cg19317869",0,0,1,0,1
"cg19318364",1,0,0,0,1
"cg19318695",0,0,3,0,3
"cg19318722",1,0,0,0,1
"cg19318815",0,5,1,0,6
"cg19319389",549,468,12,0,1029
"cg19320776",30,15,5,0,50
"cg19321016",0,0,2,0,2
"cg19321603",0,1,0,0,1
"cg19323121",1,0,0,0,1
"cg19323813",3,2,0,0,5
"cg19323830",20,15,13,0,48
"cg19325508",1,0,0,0,1
"cg19326179",1,0,0,0,1
"cg19327781",0,0,1,0,1
"cg19328630",1,1,0,0,2
"cg19328814",0,0,1,0,1
"cg19329696",1,0,0,0,1
"cg19331876",0,1,0,0,1
"cg19333255",0,0,1,0,1
"cg19333614",1,0,0,0,1
"cg19333739",0,0,15,0,15
"cg19334224",0,1,0,0,1
"cg19334619",0,0,1,0,1
"cg19337732",0,3,0,0,3
"cg19338721",12,1,0,0,13
"cg19339580",1,0,0,0,1
"cg19339916",22,1,0,0,23
"cg19341945",2,1,0,0,3
"cg19342764",1,0,0,0,1
"cg19343072",1,0,0,0,1
"cg19343600",0,2,0,0,2
"cg19343630",0,2,1,0,3
"cg19343842",31,9,0,0,40
"cg19346729",0,1,0,0,1
"cg19348216",0,0,1,0,1
"cg19349217",2,1,0,0,3
"cg19349555",0,0,2,0,2
"cg19350479",3,1,0,0,4
"cg19352507",1,0,0,0,1
"cg19354886",1,0,0,0,1
"cg19355186",2,0,0,0,2
"cg19356105",1,0,0,0,1
"cg19356324",10,1,0,0,11
"cg19359313",1,0,0,0,1
"cg19359316",1,0,0,0,1
"cg19361456",2,0,0,0,2
"cg19362130",0,1,0,0,1
"cg19362210",0,0,2,0,2
"cg19363097",0,0,2,1,3
"cg19364276",3,0,0,0,3
"cg19364880",0,6,0,0,6
"cg19367047",0,4,0,0,4
"cg19367392",0,0,2,0,2
"cg19367951",1,0,0,0,1
"cg19369616",1,0,0,0,1
"cg19371097",0,1,0,0,1
"cg19371555",0,1,0,0,1
"cg19372327",0,0,5,0,5
"cg19373635",0,3,0,0,3
"cg19374379",0,2,2,0,4
"cg19375114",21,11,2,0,34
"cg19375933",6,3,0,0,9
"cg19376379",1,1,0,0,2
"cg19376664",0,0,1,0,1
"cg19376858",0,0,1,0,1
"cg19377234",6,8,4,0,18
"cg19377363",1,0,0,0,1
"cg19378593",1,0,1,0,2
"cg19379541",1,3,0,0,4
"cg19380371",0,0,1,0,1
"cg19381810",6,2,0,0,8
"cg19382404",0,0,1,0,1
"cg19382572",0,0,1,0,1
"cg19384373",0,0,1,0,1
"cg19386219",0,1,0,0,1
"cg19387750",0,1,0,0,1
"cg19389077",48,0,0,0,48
"cg19389162",7,6,3,0,16
"cg19389308",0,1,0,0,1
"cg19389356",156,285,215,0,656
"cg19390357",0,1,2,0,3
"cg19390724",0,1,0,0,1
"cg19391974",116,535,13,0,664
"cg19392805",15,1,0,0,16
"cg19393160",0,3,0,0,3
"cg19393233",1,0,0,0,1
"cg19393314",0,2,0,0,2
"cg19394390",0,0,1,0,1
"cg19394510",2,5,2,0,9
"cg19394756",0,0,3,0,3
"cg19394782",3,1,0,0,4
"cg19395388",1,0,0,0,1
"cg19395776",1,0,3,0,4
"cg19397969",5,0,0,0,5
"cg19398748",0,0,1,0,1
"cg19399817",0,0,1,0,1
"cg19402413",8,0,0,0,8
"cg19402455",1,0,0,0,1
"cg19403429",1,0,0,0,1
"cg19404184",0,0,1,0,1
"cg19404813",0,1,1,0,2
"cg19405779",0,0,1,0,1
"cg19405941",5,0,0,0,5
"cg19406956",1,0,0,0,1
"cg19407236",1,1,0,0,2
"cg19407545",31,24,1,0,56
"cg19408263",0,0,1,0,1
"cg19409217",0,1,0,0,1
"cg19410265",0,0,1,0,1
"cg19411459",0,1,0,0,1
"cg19411919",1,2,6,0,9
"cg19411932",0,0,2,0,2
"cg19411989",0,0,1,0,1
"cg19413705",3,2,6,0,11
"cg19413766",2,0,0,0,2
"cg19414481",427,16,0,0,443
"cg19415003",5,8,2,0,15
"cg19415091",1,1,1,0,3
"cg19415130",0,2,0,0,2
"cg19416073",0,1,0,0,1
"cg19416911",1,1,0,0,2
"cg19417180",0,1,0,0,1
"cg19417482",0,2,0,0,2
"cg19417549",0,1,0,0,1
"cg19418123",3,0,0,0,3
"cg19418648",0,0,1,0,1
"cg19419051",0,0,1,0,1
"cg19420415",0,1,0,0,1
"cg19420465",16,0,0,0,16
"cg19421346",0,0,6,0,6
"cg19421794",0,0,1,0,1
"cg19422218",1,0,0,0,1
"cg19422253",0,1,0,0,1
"cg19422294",0,0,1,0,1
"cg19427472",1,0,0,0,1
"cg19427589",0,1,0,0,1
"cg19428582",0,1,0,0,1
"cg19428976",0,0,2,0,2
"cg19429325",0,1,0,0,1
"cg19431360",2,1,0,0,3
"cg19433902",0,1,0,0,1
"cg19434065",2,0,0,0,2
"cg19434247",0,0,1,0,1
"cg19434640",4,2,0,0,6
"cg19435453",1,0,0,0,1
"cg19435761",2,1,0,0,3
"cg19437156",0,1,0,0,1
"cg19438261",5,12,0,0,17
"cg19438583",11,1,0,0,12
"cg19439835",0,1,0,0,1
"cg19439894",5,9,2,0,16
"cg19440205",2,0,1,0,3
"cg19440928",2,2,0,0,4
"cg19441028",1,0,0,0,1
"cg19441872",1,0,0,0,1
"cg19442004",0,1,0,0,1
"cg19442659",0,1,0,0,1
"cg19443198",4,0,0,0,4
"cg19444153",14,0,0,0,14
"cg19445072",1,0,0,0,1
"cg19445207",1,0,0,0,1
"cg19445457",0,1,0,0,1
"cg19445651",1,0,0,0,1
"cg19445664",1,0,0,0,1
"cg19446264",1,0,0,0,1
"cg19446621",1,0,0,0,1
"cg19446886",0,1,0,0,1
"cg19447593",10,0,0,0,10
"cg19447629",26,15,0,0,41
"cg19450025",0,0,1,0,1
"cg19452916",1,0,0,0,1
"cg19453353",3,0,0,0,3
"cg19453498",1,0,0,0,1
"cg19453665",0,0,1,0,1
"cg19453726",1,0,0,0,1
"cg19454999",0,1,0,0,1
"cg19457121",195,448,8,0,651
"cg19457908",17,2,0,0,19
"cg19458088",0,0,1,0,1
"cg19458608",0,1,1,0,2
"cg19459349",0,0,2,0,2
"cg19462118",1,1,0,0,2
"cg19462712",11,1,0,0,12
"cg19462976",1,0,0,0,1
"cg19463619",0,0,1,0,1
"cg19463703",78,21,1,0,100
"cg19463892",1,0,0,0,1
"cg19465033",0,0,1,0,1
"cg19466922",1,1,0,1,3
"cg19470692",0,1,0,0,1
"cg19470840",13,0,0,0,13
"cg19471334",0,0,3,1,4
"cg19472098",0,0,1,0,1
"cg19472772",0,0,1,0,1
"cg19473834",2,0,0,0,2
"cg19474983",1,0,0,0,1
"cg19475018",0,0,1,0,1
"cg19475067",0,0,2,0,2
"cg19476021",0,1,0,0,1
"cg19476573",0,0,1,0,1
"cg19477192",15,9,1,0,25
"cg19477408",0,3,0,0,3
"cg19479140",0,0,2,0,2
"cg19479330",0,0,4,0,4
"cg19479722",2,5,7,0,14
"cg19480682",1,0,0,0,1
"cg19481811",0,4,0,0,4
"cg19481964",0,1,0,0,1
"cg19483003",0,0,2,0,2
"cg19484093",1,0,0,0,1
"cg19484299",0,1,0,0,1
"cg19485028",0,2,0,0,2
"cg19486433",1,0,0,0,1
"cg19487414",17,1,0,0,18
"cg19487455",1,1,0,0,2
"cg19488431",1,0,0,0,1
"cg19491207",0,1,4,0,5
"cg19493034",0,0,1,0,1
"cg19493134",1,0,0,0,1
"cg19493162",161,24,0,0,185
"cg19493323",203,27,2,0,232
"cg19493665",1,0,0,0,1
"cg19493980",78,4,1,0,83
"cg19494453",0,0,3,0,3
"cg19494760",1,0,0,0,1
"cg19494806",0,0,1,0,1
"cg19494946",0,1,0,0,1
"cg19496566",0,0,1,0,1
"cg19497259",753,493,8,0,1254
"cg19497424",176,174,37,0,387
"cg19497646",966,155,5,0,1126
"cg19497890",0,0,2,0,2
"cg19497939",107,5,1,0,113
"cg19498156",5,3,0,0,8
"cg19498600",1,0,0,0,1
"cg19498752",1,0,0,0,1
"cg19498946",0,0,1,0,1
"cg19499343",0,0,1,0,1
"cg19499804",1,0,0,0,1
"cg19501368",0,0,1,0,1
"cg19501543",2,0,0,0,2
"cg19501982",0,0,0,1,1
"cg19503030",1,8,3,0,12
"cg19503341",1,0,0,0,1
"cg19503359",1,0,0,0,1
"cg19503780",0,2,0,0,2
"cg19504089",1,1,2,0,4
"cg19504308",0,4,0,0,4
"cg19504781",553,42,0,0,595
"cg19505032",9,1,0,0,10
"cg19505194",0,0,1,0,1
"cg19505760",202,40,0,0,242
"cg19506309",8,2,0,0,10
"cg19506407",0,0,1,0,1
"cg19507078",12,0,0,0,12
"cg19507893",126,3,2,0,131
"cg19508555",2,0,2,0,4
"cg19509889",1,0,0,0,1
"cg19510820",2,2,0,0,4
"cg19513514",118,337,63,0,518
"cg19513591",1,6,1,0,8
"cg19513890",0,0,2,0,2
"cg19513903",0,0,1,0,1
"cg19515468",170,154,47,0,371
"cg19515510",2,0,0,0,2
"cg19515605",0,1,0,0,1
"cg19515612",0,0,0,1,1
"cg19515760",2,2,2,0,6
"cg19517623",0,0,1,0,1
"cg19518186",0,1,0,0,1
"cg19518503",0,0,1,0,1
"cg19519899",1,0,0,0,1
"cg19520119",1,0,0,0,1
"cg19521075",0,0,2,0,2
"cg19521438",9,3,1,0,13
"cg19521511",0,3,2,0,5
"cg19521572",0,0,1,0,1
"cg19521912",624,538,7,0,1169
"cg19524497",307,5,1,0,313
"cg19524681",0,0,1,0,1
"cg19525912",218,22,0,0,240
"cg19527409",0,1,0,0,1
"cg19528621",1,0,1,0,2
"cg19528770",5,0,0,0,5
"cg19529155",0,0,1,0,1
"cg19529333",0,1,0,0,1
"cg19530924",0,0,1,0,1
"cg19532028",0,1,0,0,1
"cg19532617",143,347,85,0,575
"cg19532731",0,0,1,0,1
"cg19533658",7,0,0,0,7
"cg19533990",0,0,2,0,2
"cg19534347",1,0,0,0,1
"cg19535375",146,7,0,0,153
"cg19535719",0,0,1,0,1
"cg19535872",347,257,3,0,607
"cg19536104",0,1,0,0,1
"cg19536227",2,1,2,0,5
"cg19536713",1,1,0,0,2
"cg19537741",6,0,0,0,6
"cg19538917",0,0,2,0,2
"cg19539224",2,1,2,0,5
"cg19540430",5,0,0,0,5
"cg19540895",11,0,0,0,11
"cg19541697",1,0,0,0,1
"cg19542548",99,3,0,0,102
"cg19543348",0,15,2,0,17
"cg19544510",7,0,0,0,7
"cg19545490",0,2,1,0,3
"cg19546108",5,1,0,0,6
"cg19546536",0,1,0,0,1
"cg19546583",0,1,0,0,1
"cg19546613",0,0,1,0,1
"cg19547547",3,0,0,0,3
"cg19548119",1,0,2,0,3
"cg19548277",9,6,0,0,15
"cg19548427",11,3,0,0,14
"cg19548667",3,0,0,0,3
"cg19548669",1,3,0,0,4
"cg19548973",7,2,0,0,9
"cg19549232",0,1,0,0,1
"cg19549465",0,2,0,0,2
"cg19549593",0,0,1,0,1
"cg19550126",1,0,0,0,1
"cg19550439",12,1,0,0,13
"cg19551037",105,2,0,0,107
"cg19552414",0,0,1,0,1
"cg19553002",4,1,0,0,5
"cg19553041",5,2,0,0,7
"cg19553459",3,1,0,0,4
"cg19553698",0,2,1,0,3
"cg19553721",1,0,2,0,3
"cg19554083",8,0,0,0,8
"cg19554868",13,6,1,0,20
"cg19554917",35,5,0,0,40
"cg19555833",2,0,0,0,2
"cg19556073",0,1,0,0,1
"cg19556341",2,1,0,0,3
"cg19556774",0,0,1,0,1
"cg19557025",2,0,0,0,2
"cg19557444",0,1,0,0,1
"cg19557860",1,0,0,0,1
"cg19558214",0,0,1,0,1
"cg19558721",0,0,1,0,1
"cg19560503",0,1,0,0,1
"cg19561726",16,1,0,0,17
"cg19563346",151,58,33,0,242
"cg19563410",388,213,5,0,606
"cg19563686",0,0,1,0,1
"cg19563796",1,0,0,0,1
"cg19565241",163,27,0,0,190
"cg19565920",0,1,0,0,1
"cg19566506",0,6,3,0,9
"cg19566962",271,335,79,0,685
"cg19567623",0,0,15,0,15
"cg19569013",1,0,0,0,1
"cg19569340",0,0,1,0,1
"cg19570775",0,1,0,0,1
"cg19571052",1,0,0,0,1
"cg19572264",3,1,0,0,4
"cg19572849",1,0,0,0,1
"cg19572890",2,0,1,0,3
"cg19573198",5,0,0,0,5
"cg19573644",0,0,2,0,2
"cg19573802",0,0,1,0,1
"cg19574017",0,1,0,0,1
"cg19574188",0,0,1,0,1
"cg19574193",1,0,2,0,3
"cg19575208",0,1,0,0,1
"cg19575329",1,0,0,0,1
"cg19575883",4,17,7,0,28
"cg19576125",18,1,0,0,19
"cg19576313",14,2,0,0,16
"cg19578030",4,0,0,0,4
"cg19578113",5,3,0,0,8
"cg19578541",1,0,0,0,1
"cg19580944",7,6,2,0,15
"cg19581275",0,0,1,0,1
"cg19582069",1,3,1,0,5
"cg19583722",1,6,10,0,17
"cg19585433",0,0,0,1,1
"cg19585676",0,1,0,0,1
"cg19585882",0,1,1,0,2
"cg19586027",1,0,0,0,1
"cg19586889",0,0,0,1,1
"cg19587654",0,3,1,0,4
"cg19587779",0,1,0,0,1
"cg19588022",1,0,0,0,1
"cg19588234",0,2,0,0,2
"cg19588570",0,0,1,0,1
"cg19589795",1,0,0,0,1
"cg19590470",0,0,4,0,4
"cg19590892",1,0,0,0,1
"cg19591612",0,0,1,0,1
"cg19592350",17,1,0,0,18
"cg19592671",1,0,0,0,1
"cg19592732",1,0,0,0,1
"cg19592942",0,3,3,0,6
"cg19592945",0,1,0,0,1
"cg19593229",2,0,0,0,2
"cg19593285",1,0,0,0,1
"cg19593809",1,0,5,0,6
"cg19597960",343,156,12,0,511
"cg19598605",0,0,1,0,1
"cg19599002",7,1,0,0,8
"cg19600442",0,2,2,0,4
"cg19600586",0,0,1,0,1
"cg19601016",1,0,0,0,1
"cg19601126",0,1,0,0,1
"cg19604133",5,0,0,0,5
"cg19605915",8,0,0,0,8
"cg19606290",5,0,0,0,5
"cg19608824",0,1,0,0,1
"cg19610253",0,0,1,0,1
"cg19610848",164,75,4,0,243
"cg19611612",2,1,0,0,3
"cg19611968",0,1,0,0,1
"cg19612285",28,10,3,0,41
"cg19612827",0,2,0,0,2
"cg19613858",21,5,0,0,26
"cg19613925",0,1,0,0,1
"cg19614694",3,0,0,0,3
"cg19615102",0,1,0,0,1
"cg19616121",206,30,2,0,238
"cg19616554",1,0,4,1,6
"cg19617396",0,2,0,0,2
"cg19617504",0,0,1,0,1
"cg19618570",0,0,3,0,3
"cg19618978",0,1,0,0,1
"cg19619036",0,1,0,0,1
"cg19620016",1,2,0,0,3
"cg19620975",94,114,41,0,249
"cg19621710",0,1,0,0,1
"cg19622253",0,0,2,0,2
"cg19622940",1,0,0,0,1
"cg19623050",2,0,0,0,2
"cg19623429",0,2,4,0,6
"cg19624304",5,2,0,0,7
"cg19625507",0,0,2,0,2
"cg19625802",19,1,0,0,20
"cg19625866",103,3,0,0,106
"cg19626044",1,0,3,0,4
"cg19626158",0,2,1,0,3
"cg19628012",95,6,1,0,102
"cg19628277",0,0,1,0,1
"cg19629216",2,0,0,0,2
"cg19629289",1,0,0,0,1
"cg19629543",86,0,0,0,86
"cg19629891",1,3,0,0,4
"cg19630376",2,0,0,0,2
"cg19630878",1,0,0,0,1
"cg19631585",0,0,15,0,15
"cg19631845",1,0,0,0,1
"cg19632366",1070,578,14,0,1662
"cg19632427",1,0,0,0,1
"cg19633822",0,10,2,0,12
"cg19634693",0,0,1,0,1
"cg19635188",1,2,1,0,4
"cg19635902",0,1,1,0,2
"cg19635926",0,1,0,0,1
"cg19636411",0,1,0,0,1
"cg19637372",0,1,0,0,1
"cg19637686",0,0,1,0,1
"cg19637814",2,0,4,0,6
"cg19638510",0,1,0,0,1
"cg19638556",314,151,13,0,478
"cg19638630",0,0,1,0,1
"cg19638881",0,2,0,0,2
"cg19639135",2,1,0,0,3
"cg19639831",0,3,0,0,3
"cg19639898",0,1,2,0,3
"cg19639919",6,0,6,0,12
"cg19640250",3,0,0,0,3
"cg19641369",2,0,0,0,2
"cg19641768",0,0,1,0,1
"cg19641958",0,0,1,0,1
"cg19642920",31,0,0,0,31
"cg19643901",16,0,0,0,16
"cg19644525",7,0,0,0,7
"cg19645066",0,1,1,0,2
"cg19647114",73,4,0,0,77
"cg19648192",0,0,1,0,1
"cg19648694",0,1,0,0,1
"cg19650706",0,0,1,0,1
"cg19651115",86,6,0,0,92
"cg19651268",26,2,0,0,28
"cg19652433",1,5,5,0,11
"cg19653951",0,2,10,0,12
"cg19654591",0,0,2,0,2
"cg19654781",0,1,0,0,1
"cg19654905",1,1,0,0,2
"cg19655583",0,5,0,0,5
"cg19656799",3,15,22,0,40
"cg19656808",1174,188,2,0,1364
"cg19658444",0,0,2,0,2
"cg19658487",0,1,0,0,1
"cg19659432",0,1,0,0,1
"cg19660591",0,0,4,0,4
"cg19660720",0,1,1,0,2
"cg19661819",1,1,0,0,2
"cg19663008",5,1,3,0,9
"cg19663224",2,0,0,0,2
"cg19664550",6,2,0,0,8
"cg19665365",0,1,0,0,1
"cg19665535",8,4,3,0,15
"cg19665882",136,290,133,0,559
"cg19666523",1,1,1,0,3
"cg19667082",0,0,1,0,1
"cg19667559",7,3,2,0,12
"cg19668538",0,1,0,0,1
"cg19671247",159,104,1,0,264
"cg19672384",7,1,0,0,8
"cg19674345",0,2,1,0,3
"cg19674688",381,189,6,0,576
"cg19675976",0,0,1,0,1
"cg19676333",1,0,0,0,1
"cg19677008",1,1,0,0,2
"cg19677184",99,33,3,0,135
"cg19677326",6,2,0,0,8
"cg19677720",5,0,2,0,7
"cg19678315",19,3,0,0,22
"cg19678538",0,4,12,0,16
"cg19679210",0,0,2,0,2
"cg19680131",0,0,1,0,1
"cg19680413",11,1,0,0,12
"cg19681027",1,0,0,0,1
"cg19681029",0,1,0,0,1
"cg19682024",0,0,1,0,1
"cg19682559",0,0,1,0,1
"cg19683188",0,1,0,0,1
"cg19683578",13,6,1,0,20
"cg19684990",0,2,2,0,4
"cg19685053",0,0,1,0,1
"cg19685601",0,1,0,0,1
"cg19685916",0,1,0,0,1
"cg19686192",0,0,1,0,1
"cg19688222",0,1,0,0,1
"cg19689672",12,0,0,0,12
"cg19689800",0,1,5,0,6
"cg19689876",0,1,0,0,1
"cg19689922",6,0,0,0,6
"cg19690846",0,1,9,0,10
"cg19690918",1,3,2,0,6
"cg19691809",1,0,0,0,1
"cg19693127",1,0,0,0,1
"cg19693446",0,0,1,0,1
"cg19694398",2,0,0,0,2
"cg19694460",0,0,1,0,1
"cg19694781",0,1,0,0,1
"cg19694798",0,0,1,0,1
"cg19697109",1,0,0,0,1
"cg19697359",0,1,0,0,1
"cg19697439",0,1,0,0,1
"cg19698416",0,0,1,0,1
"cg19699291",0,0,1,0,1
"cg19700006",0,0,1,0,1
"cg19700328",0,0,1,0,1
"cg19700465",3,1,0,0,4
"cg19700958",8,2,0,0,10
"cg19701205",0,0,1,0,1
"cg19701691",0,0,2,0,2
"cg19702937",21,23,7,0,51
"cg19702979",0,1,0,0,1
"cg19703259",12,2,0,0,14
"cg19703511",0,0,1,0,1
"cg19705215",1,0,0,0,1
"cg19706175",149,16,3,0,168
"cg19706804",0,0,0,2,2
"cg19707358",0,6,1,0,7
"cg19707638",15,2,0,0,17
"cg19708213",0,1,0,0,1
"cg19708541",0,1,0,0,1
"cg19709670",0,4,0,0,4
"cg19709928",7,3,0,0,10
"cg19710691",1,2,1,0,4
"cg19710814",1,0,0,0,1
"cg19711013",0,0,1,0,1
"cg19712082",0,0,1,0,1
"cg19712370",1,0,0,0,1
"cg19712444",0,0,1,0,1
"cg19712499",0,0,6,0,6
"cg19713303",1,0,0,0,1
"cg19713851",0,1,0,0,1
"cg19714436",13,0,0,0,13
"cg19715314",1,1,0,0,2
"cg19716004",0,1,0,0,1
"cg19716414",1,3,1,0,5
"cg19717943",9,4,0,0,13
"cg19719049",0,0,1,0,1
"cg19720414",0,1,0,0,1
"cg19720712",16,7,0,0,23
"cg19721534",329,11,4,0,344
"cg19721730",0,0,1,0,1
"cg19723208",1,0,0,0,1
"cg19723275",2,0,2,0,4
"cg19723402",1,1,0,0,2
"cg19723998",322,110,3,0,435
"cg19724043",0,0,1,0,1
"cg19724485",0,1,0,0,1
"cg19725516",0,0,1,0,1
"cg19726460",0,6,9,0,15
"cg19727059",1,0,1,0,2
"cg19727175",0,1,0,0,1
"cg19727492",0,0,1,0,1
"cg19728601",1,0,0,0,1
"cg19729338",3,0,0,0,3
"cg19729479",2,4,0,0,6
"cg19729503",1,0,0,0,1
"cg19731233",266,55,2,0,323
"cg19731845",0,0,1,0,1
"cg19732599",13,1,0,0,14
"cg19732831",7,0,0,0,7
"cg19733309",1,0,0,0,1
"cg19733514",89,7,0,0,96
"cg19733894",7,2,3,0,12
"cg19734257",1,2,2,0,5
"cg19734465",0,0,1,0,1
"cg19734937",2,0,0,0,2
"cg19735097",2,0,0,0,2
"cg19735238",1,0,0,0,1
"cg19735637",4,7,5,0,16
"cg19735739",1,0,0,0,1
"cg19736968",2,0,0,0,2
"cg19737036",2,0,0,0,2
"cg19737334",0,1,0,0,1
"cg19739139",2,0,0,0,2
"cg19741077",0,3,0,0,3
"cg19742064",4,1,0,0,5
"cg19742462",1,0,0,0,1
"cg19743153",1,0,0,0,1
"cg19745314",3,0,0,0,3
"cg19745934",0,1,0,0,1
"cg19747968",0,0,2,0,2
"cg19748516",3,4,0,0,7
"cg19749445",1,2,4,0,7
"cg19751124",0,1,0,0,1
"cg19751754",6,4,0,0,10
"cg19751869",0,33,5,0,38
"cg19752270",2,0,0,0,2
"cg19752602",0,0,1,0,1
"cg19753783",132,10,0,0,142
"cg19754246",10,2,0,0,12
"cg19755038",1,0,0,0,1
"cg19755382",1,0,0,0,1
"cg19755583",1,4,0,0,5
"cg19756068",0,1,0,0,1
"cg19757330",2,0,3,0,5
"cg19757526",2,0,0,0,2
"cg19759398",3,1,0,0,4
"cg19761060",185,269,13,0,467
"cg19761271",265,158,12,0,435
"cg19762666",1,0,0,0,1
"cg19762811",0,0,1,0,1
"cg19763287",36,6,1,0,43
"cg19764326",590,30,1,0,621
"cg19764421",1,3,0,0,4
"cg19764769",0,0,15,0,15
"cg19765038",267,5,0,0,272
"cg19766065",2,1,0,0,3
"cg19766820",0,0,1,0,1
"cg19768036",0,0,1,0,1
"cg19768162",0,0,1,0,1
"cg19770024",4,0,0,0,4
"cg19770852",0,0,1,0,1
"cg19771031",245,150,5,0,400
"cg19771575",51,11,0,0,62
"cg19772160",1,1,1,0,3
"cg19772356",0,1,0,0,1
"cg19772620",5,0,0,0,5
"cg19772651",0,1,0,0,1
"cg19773370",0,3,1,0,4
"cg19773587",0,0,1,0,1
"cg19774732",0,0,1,0,1
"cg19775086",0,0,1,0,1
"cg19775431",2,0,0,0,2
"cg19775442",1,0,0,0,1
"cg19775763",0,1,1,0,2
"cg19776806",0,0,2,0,2
"cg19776985",1,0,0,0,1
"cg19777542",200,26,0,0,226
"cg19777678",0,0,1,0,1
"cg19777771",0,0,1,0,1
"cg19778276",4,0,0,0,4
"cg19779076",0,0,1,0,1
"cg19780250",1,1,0,0,2
"cg19780637",0,1,0,0,1
"cg19781045",2,0,0,0,2
"cg19781248",0,0,4,0,4
"cg19781775",0,0,1,0,1
"cg19781948",4,0,0,0,4
"cg19784991",2,1,2,0,5
"cg19785225",16,4,0,0,20
"cg19785312",191,434,48,0,673
"cg19785354",45,0,0,0,45
"cg19786422",1,0,0,0,1
"cg19786484",1,1,0,0,2
"cg19789336",6,17,22,0,45
"cg19789755",0,0,1,0,1
"cg19790002",3,0,0,0,3
"cg19791994",0,0,4,0,4
"cg19793366",0,0,3,0,3
"cg19794111",2,4,1,0,7
"cg19794674",1,0,0,0,1
"cg19794706",0,1,0,0,1
"cg19797872",37,7,0,0,44
"cg19797896",0,1,0,0,1
"cg19800728",2,1,0,0,3
"cg19800753",2,0,0,0,2
"cg19801132",40,8,0,0,48
"cg19801398",2,0,0,0,2
"cg19801460",0,0,1,0,1
"cg19802137",1,0,0,0,1
"cg19802725",1,0,0,0,1
"cg19803347",64,24,1,0,89
"cg19804182",1,1,3,0,5
"cg19805217",10,1,0,0,11
"cg19805548",0,0,1,0,1
"cg19805863",2,0,0,0,2
"cg19807044",1,0,0,0,1
"cg19807306",0,0,2,0,2
"cg19807991",2,7,1,0,10
"cg19811455",0,2,1,0,3
"cg19811786",871,179,1,0,1051
"cg19811833",0,0,1,0,1
"cg19811863",4,0,0,0,4
"cg19812432",1,0,0,0,1
"cg19812442",0,0,1,0,1
"cg19812553",2,0,0,0,2
"cg19812887",5,20,15,0,40
"cg19814742",3,1,0,0,4
"cg19815006",97,5,0,0,102
"cg19815110",0,0,1,0,1
"cg19815454",11,8,1,0,20
"cg19815609",0,0,1,0,1
"cg19815803",2,0,0,0,2
"cg19816205",0,3,0,0,3
"cg19816315",2,1,0,0,3
"cg19816527",6,3,0,0,9
"cg19817060",1,0,0,0,1
"cg19817544",1,0,0,0,1
"cg19817609",4,3,2,31,40
"cg19818925",2,0,0,0,2
"cg19819135",1,0,0,0,1
"cg19823256",14,2,0,0,16
"cg19823406",107,70,10,0,187
"cg19824012",1,0,1,0,2
"cg19824037",0,0,4,0,4
"cg19825410",0,0,2,0,2
"cg19825787",1,15,0,0,16
"cg19826397",0,0,1,0,1
"cg19828175",0,1,4,0,5
"cg19828316",1,0,0,0,1
"cg19829170",0,0,1,0,1
"cg19829375",0,1,0,0,1
"cg19829659",0,0,1,0,1
"cg19830270",0,0,1,0,1
"cg19831313",0,0,1,0,1
"cg19831706",1,0,0,0,1
"cg19832322",1,0,0,0,1
"cg19832347",1,0,0,0,1
"cg19833338",0,0,1,0,1
"cg19835973",0,0,1,0,1
"cg19836322",130,3,0,0,133
"cg19837298",1,0,1,0,2
"cg19837901",3,0,2,0,5
"cg19839372",1,0,0,0,1
"cg19839801",1,1,5,0,7
"cg19840093",69,2,0,0,71
"cg19840484",0,1,0,0,1
"cg19841649",0,1,0,0,1
"cg19842571",0,1,0,0,1
"cg19843629",0,0,1,0,1
"cg19843760",1,1,3,0,5
"cg19844110",10,10,0,0,20
"cg19844840",2,2,0,0,4
"cg19845203",1,2,0,0,3
"cg19846887",0,1,0,0,1
"cg19847554",5,3,0,0,8
"cg19849362",1,0,0,0,1
"cg19850407",290,1194,92,0,1576
"cg19850420",0,2,2,2,6
"cg19851401",18,17,0,0,35
"cg19851647",0,3,0,0,3
"cg19854712",0,0,1,0,1
"cg19857114",0,0,1,0,1
"cg19858311",18,0,0,0,18
"cg19858371",59,40,6,0,105
"cg19859559",28,26,2,0,56
"cg19860173",20,32,16,0,68
"cg19860441",2,1,1,0,4
"cg19860759",0,0,12,0,12
"cg19861270",1,0,0,0,1
"cg19862026",1,1,0,0,2
"cg19862389",0,0,1,0,1
"cg19862616",1,0,0,0,1
"cg19863929",1,0,0,0,1
"cg19863964",31,18,0,0,49
"cg19863980",10,26,0,0,36
"cg19865234",0,1,8,0,9
"cg19866040",0,6,3,0,9
"cg19866327",1,0,1,0,2
"cg19867445",1,0,0,0,1
"cg19867476",3,0,0,0,3
"cg19868007",1,2,0,0,3
"cg19869100",13,0,0,0,13
"cg19869592",6,5,4,0,15
"cg19870349",6,1,0,0,7
"cg19870355",0,0,1,0,1
"cg19872475",0,0,0,1,1
"cg19873701",3,2,2,0,7
"cg19874748",0,1,0,0,1
"cg19875483",0,0,1,0,1
"cg19876629",0,1,4,0,5
"cg19877011",2,0,0,0,2
"cg19877840",8,0,0,0,8
"cg19878214",0,0,1,0,1
"cg19878302",0,0,1,0,1
"cg19878711",6,13,0,0,19
"cg19879210",4,0,0,0,4
"cg19879539",0,0,1,0,1
"cg19881174",0,0,4,0,4
"cg19882093",0,9,0,0,9
"cg19882119",0,0,3,0,3
"cg19882132",1,0,0,0,1
"cg19882830",2,1,0,0,3
"cg19882848",4,0,0,0,4
"cg19883843",137,71,3,0,211
"cg19884223",3,1,0,0,4
"cg19885331",0,0,1,0,1
"cg19885539",1,0,0,0,1
"cg19885786",1,0,0,0,1
"cg19887341",29,4,0,0,33
"cg19890168",1,0,1,0,2
"cg19892115",0,1,0,0,1
"cg19893504",0,1,0,0,1
"cg19894588",0,1,0,0,1
"cg19894748",0,0,1,0,1
"cg19895124",9,2,0,0,11
"cg19895380",0,0,2,0,2
"cg19897188",0,0,0,2,2
"cg19897908",16,1,0,0,17
"cg19898487",2,0,0,0,2
"cg19898828",0,0,1,0,1
"cg19900094",0,0,1,0,1
"cg19900557",15,3,1,0,19
"cg19900896",0,1,0,0,1
"cg19901468",9,2,0,0,11
"cg19902321",0,1,0,0,1
"cg19902869",0,0,1,0,1
"cg19904570",2,0,0,0,2
"cg19905630",0,0,1,0,1
"cg19905666",0,0,1,0,1
"cg19906638",7,0,0,0,7
"cg19911329",3,2,0,0,5
"cg19911490",11,19,7,0,37
"cg19911676",2,0,0,0,2
"cg19911969",2,1,0,0,3
"cg19912690",8,4,0,0,12
"cg19912883",0,1,2,0,3
"cg19913755",0,0,2,0,2
"cg19917512",0,0,1,0,1
"cg19918002",2,0,0,0,2
"cg19918037",0,0,1,0,1
"cg19918821",5,1,0,0,6
"cg19918859",3,1,0,0,4
"cg19919881",0,2,2,0,4
"cg19921237",0,0,1,0,1
"cg19922333",7,0,0,0,7
"cg19923471",1,0,0,0,1
"cg19923810",0,2,0,0,2
"cg19925186",1,0,0,0,1
"cg19926096",0,0,1,0,1
"cg19926611",0,0,1,0,1
"cg19927510",0,2,0,0,2
"cg19927565",0,0,1,0,1
"cg19927715",1,2,0,0,3
"cg19928023",2,3,2,0,7
"cg19928084",0,0,1,0,1
"cg19928513",2,1,0,0,3
"cg19928997",6,0,0,0,6
"cg19929033",1,0,0,0,1
"cg19929081",0,1,0,0,1
"cg19929302",57,48,5,0,110
"cg19929967",0,1,0,0,1
"cg19930004",1,0,3,0,4
"cg19930296",0,0,1,0,1
"cg19930569",102,42,1,0,145
"cg19930745",0,0,1,0,1
"cg19930835",0,0,1,0,1
"cg19930841",37,2,0,0,39
"cg19932020",9,8,2,0,19
"cg19932650",1,0,0,0,1
"cg19933327",0,0,1,0,1
"cg19934951",0,1,0,0,1
"cg19935901",3,3,0,0,6
"cg19936629",0,0,1,0,1
"cg19938902",0,0,1,0,1
"cg19939307",3,2,0,0,5
"cg19939554",0,0,1,0,1
"cg19939935",2,7,0,0,9
"cg19940401",0,3,0,0,3
"cg19940459",7,30,5,0,42
"cg19941279",37,4,0,0,41
"cg19942197",0,0,1,0,1
"cg19942559",0,0,2,0,2
"cg19943330",0,0,1,0,1
"cg19945708",6,0,0,0,6
"cg19948914",0,1,0,0,1
"cg19949208",0,2,0,0,2
"cg19950017",1,0,1,0,2
"cg19950606",0,1,0,0,1
"cg19950739",9,0,0,0,9
"cg19950767",0,1,0,0,1
"cg19950846",77,10,1,0,88
"cg19951594",0,0,1,0,1
"cg19952216",39,4,1,0,44
"cg19952280",0,1,0,0,1
"cg19952651",0,0,1,0,1
"cg19953728",2,0,0,0,2
"cg19954187",1,0,0,0,1
"cg19954936",23,0,0,0,23
"cg19956292",0,2,2,0,4
"cg19956449",0,0,1,0,1
"cg19957411",185,4,1,0,190
"cg19957699",2,0,0,0,2
"cg19957765",2,1,0,0,3
"cg19958389",1,0,0,0,1
"cg19958892",0,0,1,0,1
"cg19960590",0,1,0,0,1
"cg19963471",8,8,0,0,16
"cg19963682",0,1,0,0,1
"cg19964475",0,1,0,0,1
"cg19965688",1,0,0,0,1
"cg19967023",1,0,1,0,2
"cg19967449",1,0,0,0,1
"cg19971696",0,0,1,0,1
"cg19972287",5,2,0,0,7
"cg19973220",0,0,1,0,1
"cg19973917",11,5,2,0,18
"cg19974702",1,0,0,0,1
"cg19976495",0,2,0,0,2
"cg19977008",1,0,0,0,1
"cg19977012",268,98,7,0,373
"cg19977194",0,4,7,0,11
"cg19977266",0,0,1,0,1
"cg19977280",0,2,0,0,2
"cg19977870",0,0,1,0,1
"cg19978583",1,0,0,0,1
"cg19978788",0,0,1,0,1
"cg19978955",2,1,1,0,4
"cg19979222",3,1,0,0,4
"cg19980192",1,2,0,0,3
"cg19980648",3,0,0,0,3
"cg19981076",6,0,0,0,6
"cg19981156",1,0,0,0,1
"cg19982557",0,1,0,0,1
"cg19982664",372,48,0,0,420
"cg19983559",3,4,2,0,9
"cg19984503",1,0,0,0,1
"cg19985311",0,3,0,0,3
"cg19985346",1,0,0,0,1
"cg19985489",0,0,1,0,1
"cg19987790",0,0,1,0,1
"cg19987877",0,1,1,0,2
"cg19988733",0,0,2,0,2
"cg19988798",217,10,0,0,227
"cg19991556",0,3,7,0,10
"cg19992367",0,0,1,0,1
"cg19993133",1,0,1,0,2
"cg19993224",0,1,0,0,1
"cg19996313",160,80,6,0,246
"cg19997517",0,0,1,0,1
"cg19997698",0,0,1,0,1
"cg19998378",0,0,1,0,1
"cg19998835",40,29,7,0,76
"cg20000459",13,2,0,0,15
"cg20000644",3,0,0,0,3
"cg20000654",1,0,0,0,1
"cg20001067",9,0,0,0,9
"cg20001876",0,0,1,0,1
"cg20002381",0,1,0,0,1
"cg20002449",4,0,0,0,4
"cg20004596",1,0,0,0,1
"cg20004634",1,0,0,0,1
"cg20005415",3,1,0,0,4
"cg20005649",0,0,0,1,1
"cg20006652",211,276,2,0,489
"cg20007188",5,0,1,0,6
"cg20007245",0,2,0,0,2
"cg20007468",3,1,0,0,4
"cg20008219",1,0,0,0,1
"cg20008332",0,1,0,0,1
"cg20009097",2,1,0,0,3
"cg20009594",5,7,2,0,14
"cg20009650",3,28,13,0,44
"cg20010014",0,2,0,0,2
"cg20010054",0,3,0,0,3
"cg20010076",131,318,69,0,518
"cg20010679",0,1,1,0,2
"cg20011476",3,3,0,0,6
"cg20011604",0,1,3,0,4
"cg20011726",521,45,0,0,566
"cg20011807",1,6,0,0,7
"cg20011931",0,0,2,0,2
"cg20012308",0,0,1,0,1
"cg20012316",98,158,86,0,342
"cg20012849",0,0,1,0,1
"cg20013963",0,1,0,0,1
"cg20014311",0,3,1,0,4
"cg20014824",82,93,9,0,184
"cg20016767",0,1,3,0,4
"cg20016874",0,1,0,0,1
"cg20017108",0,2,1,0,3
"cg20017254",0,1,0,0,1
"cg20017343",0,0,1,0,1
"cg20017989",0,0,2,0,2
"cg20020000",0,0,1,0,1
"cg20020053",0,1,0,0,1
"cg20020483",1,1,2,0,4
"cg20020723",1,0,0,0,1
"cg20022483",13,6,0,0,19
"cg20023310",0,0,1,0,1
"cg20023354",0,0,1,0,1
"cg20023538",1,0,0,0,1
"cg20024577",25,38,7,0,70
"cg20025772",0,1,2,0,3
"cg20026610",204,224,3,0,431
"cg20027314",17,0,0,0,17
"cg20029458",7,1,1,0,9
"cg20029644",0,0,1,0,1
"cg20029657",11,0,0,0,11
"cg20030117",1,0,0,0,1
"cg20032085",6,0,0,0,6
"cg20033808",1202,143,2,0,1347
"cg20034226",0,1,0,0,1
"cg20035105",0,2,0,0,2
"cg20035453",115,117,38,0,270
"cg20036365",1,0,0,0,1
"cg20038038",0,3,1,0,4
"cg20038441",0,0,1,0,1
"cg20039307",1,0,2,0,3
"cg20039979",2,0,0,0,2
"cg20040399",1,0,0,0,1
"cg20041567",1,2,0,0,3
"cg20042116",0,3,0,0,3
"cg20042731",0,0,3,0,3
"cg20044090",0,1,1,0,2
"cg20044143",0,1,2,0,3
"cg20044550",0,2,0,0,2
"cg20044666",37,2,0,0,39
"cg20047924",49,3,0,0,52
"cg20048961",0,0,1,0,1
"cg20049309",4,10,2,0,16
"cg20050563",0,0,1,0,1
"cg20050789",1,1,0,0,2
"cg20052431",169,112,27,0,308
"cg20052814",19,0,0,0,19
"cg20053637",2,0,0,0,2
"cg20053800",0,0,1,0,1
"cg20054939",0,0,0,1,1
"cg20055101",1,0,0,0,1
"cg20055924",1,0,0,0,1
"cg20056341",55,1,0,0,56
"cg20058022",0,0,1,0,1
"cg20058389",1,0,0,0,1
"cg20059197",7,1,0,0,8
"cg20061770",0,6,9,0,15
"cg20061873",0,0,0,1,1
"cg20061931",246,282,34,0,562
"cg20062050",0,1,4,0,5
"cg20062097",2,0,0,0,2
"cg20062301",0,1,0,0,1
"cg20062806",183,301,3,0,487
"cg20063270",0,0,1,0,1
"cg20064047",1,0,0,0,1
"cg20064587",0,0,1,0,1
"cg20065216",28,23,3,0,54
"cg20065266",0,0,2,0,2
"cg20065366",0,1,0,0,1
"cg20067405",0,0,1,0,1
"cg20067418",0,1,0,0,1
"cg20067941",0,0,1,0,1
"cg20069681",19,9,0,0,28
"cg20070038",0,0,1,0,1
"cg20071042",0,0,1,0,1
"cg20072963",5,1,0,0,6
"cg20074089",0,0,1,0,1
"cg20074750",1,0,0,0,1
"cg20075927",625,24,0,0,649
"cg20076186",90,105,8,0,203
"cg20076231",58,61,28,0,147
"cg20077139",3,0,1,0,4
"cg20077827",0,1,0,0,1
"cg20078025",0,1,6,0,7
"cg20078783",0,0,1,0,1
"cg20080678",0,0,1,0,1
"cg20080997",0,0,1,0,1
"cg20081432",1,0,0,0,1
"cg20081767",1,2,0,0,3
"cg20083679",3,1,0,0,4
"cg20083906",0,0,4,0,4
"cg20083995",1,0,0,0,1
"cg20084529",1,0,0,0,1
"cg20084815",53,0,0,0,53
"cg20085077",1,1,0,0,2
"cg20085570",0,0,1,0,1
"cg20086071",1,0,0,0,1
"cg20088835",6,1,1,0,8
"cg20089180",1,2,6,0,9
"cg20089349",2,1,0,0,3
"cg20090662",2,0,0,0,2
"cg20090690",1,0,0,0,1
"cg20093198",2,0,0,0,2
"cg20094934",0,1,0,0,1
"cg20095274",0,0,2,0,2
"cg20095338",1,1,0,0,2
"cg20096872",2,1,0,0,3
"cg20098689",1,2,1,0,4
"cg20098779",0,1,0,0,1
"cg20099511",0,3,2,0,5
"cg20100339",0,1,0,0,1
"cg20100660",1,3,0,0,4
"cg20100998",0,1,1,0,2
"cg20103107",2,3,0,0,5
"cg20104362",0,1,0,0,1
"cg20105448",679,53,3,0,735
"cg20105583",16,12,0,0,28
"cg20105848",0,4,1,0,5
"cg20105939",1,0,0,0,1
"cg20107306",0,0,1,0,1
"cg20107987",1,0,0,0,1
"cg20108910",0,4,4,0,8
"cg20110284",0,3,2,0,5
"cg20110347",1,0,0,0,1
"cg20110984",1,0,0,0,1
"cg20111234",0,0,2,0,2
"cg20113491",0,0,2,0,2
"cg20113726",1,1,0,0,2
"cg20113802",0,0,1,0,1
"cg20114890",0,0,1,0,1
"cg20115597",1,0,0,0,1
"cg20116099",0,1,0,0,1
"cg20116869",0,0,1,0,1
"cg20116979",2,0,0,0,2
"cg20117477",1,0,0,0,1
"cg20117975",38,2,0,0,40
"cg20118189",62,6,0,0,68
"cg20118364",1,0,0,0,1
"cg20118480",0,1,0,0,1
"cg20119080",0,1,0,0,1
"cg20119106",0,0,1,0,1
"cg20120463",0,0,1,0,1
"cg20120631",0,0,2,0,2
"cg20120786",45,9,1,0,55
"cg20121125",0,0,1,0,1
"cg20121513",0,1,0,0,1
"cg20122077",1,0,0,0,1
"cg20123317",1,2,0,0,3
"cg20125331",1,3,1,0,5
"cg20125424",1,0,1,0,2
"cg20125516",0,2,1,0,3
"cg20126417",12,1,0,0,13
"cg20129610",1,0,0,0,1
"cg20129806",0,1,6,0,7
"cg20129853",0,0,1,0,1
"cg20130989",0,1,0,0,1
"cg20131227",2,1,0,0,3
"cg20134271",1,0,0,0,1
"cg20137147",1,0,0,0,1
"cg20138833",0,1,2,0,3
"cg20139368",1,0,0,0,1
"cg20140425",1,2,0,0,3
"cg20141434",0,0,10,0,10
"cg20142672",3,6,2,0,11
"cg20142762",1,0,0,0,1
"cg20144481",1,0,0,0,1
"cg20144487",0,1,0,0,1
"cg20144488",0,0,1,0,1
"cg20145426",1,0,0,0,1
"cg20145687",1,0,0,0,1
"cg20146904",0,1,0,0,1
"cg20147285",3,6,1,0,10
"cg20147550",0,0,1,0,1
"cg20148511",0,0,3,0,3
"cg20148729",0,0,1,0,1
"cg20149571",0,1,1,0,2
"cg20149757",36,657,2,0,695
"cg20149898",1,0,0,0,1
"cg20149922",392,67,4,0,463
"cg20153829",13,1,0,0,14
"cg20156793",1,0,0,0,1
"cg20157003",389,204,11,0,604
"cg20157693",0,0,2,0,2
"cg20158159",385,26,0,0,411
"cg20158613",0,0,3,0,3
"cg20158946",0,1,0,0,1
"cg20159036",18,7,0,0,25
"cg20159152",1,0,0,0,1
"cg20159543",5,4,0,0,9
"cg20159608",1,1,1,0,3
"cg20160127",5,5,4,0,14
"cg20160885",1,0,0,0,1
"cg20161227",0,0,1,0,1
"cg20161771",0,0,1,0,1
"cg20162066",418,24,0,0,442
"cg20162553",298,108,2,0,408
"cg20162580",0,1,11,0,12
"cg20162677",2,1,0,0,3
"cg20163113",1,0,0,0,1
"cg20163423",1,0,0,0,1
"cg20165220",5,2,0,0,7
"cg20165301",179,7,1,0,187
"cg20165515",23,2,0,0,25
"cg20165732",264,31,1,0,296
"cg20167216",0,1,0,0,1
"cg20168315",0,1,2,0,3
"cg20170601",1,0,0,0,1
"cg20171860",1,0,0,0,1
"cg20172003",2,0,0,0,2
"cg20172858",0,0,2,0,2
"cg20174429",2,0,0,0,2
"cg20174893",0,0,2,0,2
"cg20175866",237,104,15,0,356
"cg20176595",7,0,0,0,7
"cg20177086",59,100,0,0,159
"cg20177771",2,0,0,0,2
"cg20178082",3,0,0,0,3
"cg20178430",6,0,0,0,6
"cg20178707",0,4,0,0,4
"cg20178757",0,0,1,0,1
"cg20179048",886,228,5,0,1119
"cg20180512",0,0,1,0,1
"cg20180808",0,0,1,0,1
"cg20180988",1,0,0,0,1
"cg20181543",10,3,0,0,13
"cg20181585",0,0,1,0,1
"cg20182819",2,0,0,0,2
"cg20184238",0,1,0,0,1
"cg20184660",0,0,1,0,1
"cg20185083",0,1,0,0,1
"cg20188207",0,4,0,0,4
"cg20188285",0,1,1,0,2
"cg20188490",0,1,0,0,1
"cg20189116",0,0,1,0,1
"cg20189467",0,2,1,0,3
"cg20191913",3,1,0,0,4
"cg20191959",1,8,0,0,9
"cg20193183",0,0,1,0,1
"cg20194358",0,0,1,0,1
"cg20194814",340,15,0,0,355
"cg20194871",1,1,0,0,2
"cg20195005",0,0,1,0,1
"cg20195464",1,0,0,0,1
"cg20198824",0,2,0,0,2
"cg20199387",0,1,0,0,1
"cg20200361",248,42,2,0,292
"cg20201030",8,43,4,0,55
"cg20203210",2,0,0,0,2
"cg20203854",0,0,2,0,2
"cg20204455",3,0,0,0,3
"cg20206322",1,0,0,0,1
"cg20208498",7,2,0,0,9
"cg20209359",9,4,0,0,13
"cg20210329",4,3,0,0,7
"cg20210449",0,0,1,0,1
"cg20211506",1,0,0,0,1
"cg20212304",501,19,0,0,520
"cg20213024",0,0,1,0,1
"cg20215480",1,0,0,0,1
"cg20215494",0,1,0,0,1
"cg20215831",296,45,1,0,342
"cg20215948",0,1,0,0,1
"cg20220121",4,1,0,0,5
"cg20220580",0,0,1,0,1
"cg20223687",0,1,1,0,2
"cg20224061",0,0,1,0,1
"cg20224751",1,1,0,0,2
"cg20226149",2,0,0,0,2
"cg20226162",2,0,0,0,2
"cg20228101",0,0,2,0,2
"cg20228603",2,1,0,0,3
"cg20228890",0,0,1,0,1
"cg20229362",0,0,1,0,1
"cg20229555",1,0,0,0,1
"cg20230305",1,0,0,0,1
"cg20232119",0,2,0,0,2
"cg20233244",0,0,1,0,1
"cg20235871",0,0,1,0,1
"cg20236151",1,0,0,0,1
"cg20236487",0,0,1,0,1
"cg20237125",20,1,0,0,21
"cg20238152",0,0,1,0,1
"cg20238412",1,2,3,0,6
"cg20238681",1,0,0,0,1
"cg20240154",0,0,1,0,1
"cg20241604",2,0,0,0,2
"cg20242136",0,0,1,0,1
"cg20242889",0,1,0,0,1
"cg20242937",0,0,1,0,1
"cg20242981",2,0,0,0,2
"cg20243078",1,0,0,0,1
"cg20244649",1,2,1,0,4
"cg20245515",0,1,1,0,2
"cg20245568",1,0,0,0,1
"cg20247011",1,1,0,0,2
"cg20247222",0,0,1,0,1
"cg20247523",2,0,1,0,3
"cg20248403",1,4,1,0,6
"cg20248611",0,0,2,0,2
"cg20250134",0,0,1,0,1
"cg20250341",0,0,8,0,8
"cg20250343",0,4,4,0,8
"cg20250922",12,0,0,0,12
"cg20250988",0,0,8,0,8
"cg20252435",1,15,0,0,16
"cg20252517",329,4,0,0,333
"cg20253340",0,0,2,0,2
"cg20253350",1,0,0,0,1
"cg20253913",1,0,0,0,1
"cg20254168",7,1,0,0,8
"cg20254733",0,0,1,0,1
"cg20255284",8,20,10,0,38
"cg20255560",1,0,0,0,1
"cg20255699",2,0,1,0,3
"cg20256120",0,0,2,0,2
"cg20256738",0,0,11,0,11
"cg20257330",21,22,9,0,52
"cg20257460",0,1,0,0,1
"cg20257797",0,0,1,0,1
"cg20258083",0,1,1,0,2
"cg20258768",3,0,0,0,3
"cg20260312",0,0,1,0,1
"cg20262540",200,300,9,0,509
"cg20262684",1,3,1,0,5
"cg20262722",0,1,0,0,1
"cg20263165",0,5,0,0,5
"cg20264033",2,0,0,0,2
"cg20264093",0,1,0,0,1
"cg20264573",0,1,0,0,1
"cg20265360",8,1,0,0,9
"cg20265572",42,2,0,0,44
"cg20266226",5,1,0,0,6
"cg20266229",0,0,1,0,1
"cg20267590",0,0,2,0,2
"cg20268683",0,1,0,0,1
"cg20269520",3,0,0,0,3
"cg20269876",0,0,2,0,2
"cg20271366",2,0,0,0,2
"cg20271389",1,0,0,0,1
"cg20271692",1,0,0,0,1
"cg20271985",1,0,0,0,1
"cg20272102",0,0,1,0,1
"cg20272415",0,0,1,0,1
"cg20273843",0,1,0,0,1
"cg20274783",0,0,1,0,1
"cg20274978",0,0,1,0,1
"cg20275066",0,0,1,0,1
"cg20275462",0,0,1,0,1
"cg20276793",1,0,0,0,1
"cg20277250",2,0,0,0,2
"cg20278269",0,0,1,0,1
"cg20278439",33,1,0,0,34
"cg20279479",0,0,2,0,2
"cg20281046",0,1,0,0,1
"cg20281117",1,0,0,0,1
"cg20281554",0,1,2,0,3
"cg20283468",6,2,1,0,9
"cg20284682",0,0,1,0,1
"cg20284705",349,99,1,0,449
"cg20285723",0,3,0,0,3
"cg20286147",0,2,3,0,5
"cg20286261",4,0,0,0,4
"cg20288105",0,0,1,0,1
"cg20290001",10,13,0,0,23
"cg20291602",0,1,0,0,1
"cg20294457",0,1,1,0,2
"cg20295120",17,11,4,0,32
"cg20295408",0,1,4,0,5
"cg20295973",2,0,0,0,2
"cg20296141",2,0,0,0,2
"cg20297360",0,0,1,0,1
"cg20297631",0,0,1,0,1
"cg20298005",0,0,5,0,5
"cg20299105",6,0,0,0,6
"cg20299573",0,0,1,0,1
"cg20299656",2,0,0,0,2
"cg20300592",1,0,0,0,1
"cg20301593",0,0,2,0,2
"cg20301888",0,0,1,0,1
"cg20301962",0,0,1,0,1
"cg20301980",6,19,6,0,31
"cg20302957",0,1,0,0,1
"cg20303001",1,0,0,0,1
"cg20303033",0,1,2,0,3
"cg20304401",0,1,0,0,1
"cg20304526",4,1,0,0,5
"cg20305286",1,0,0,0,1
"cg20305912",0,1,0,0,1
"cg20306093",1,0,0,0,1
"cg20307021",26,37,7,0,70
"cg20309240",0,0,1,0,1
"cg20310100",0,1,0,0,1
"cg20310532",0,1,0,0,1
"cg20311065",0,0,2,0,2
"cg20311197",0,1,0,0,1
"cg20311333",0,1,0,0,1
"cg20312077",0,0,1,0,1
"cg20312390",3,0,0,0,3
"cg20313364",0,1,0,0,1
"cg20313522",2,2,0,0,4
"cg20313798",3,1,4,0,8
"cg20313902",0,0,2,0,2
"cg20314184",3,0,0,0,3
"cg20314560",1,2,0,0,3
"cg20319634",99,48,8,0,155
"cg20319911",1,0,0,0,1
"cg20320111",1,0,0,0,1
"cg20320574",0,0,1,0,1
"cg20320905",15,2,0,0,17
"cg20321250",5,1,0,0,6
"cg20321498",595,714,115,0,1424
"cg20324928",0,1,0,0,1
"cg20325092",0,1,0,0,1
"cg20325280",2,3,0,0,5
"cg20325800",1,0,0,0,1
"cg20326359",1,1,0,0,2
"cg20326388",0,1,0,0,1
"cg20326622",0,1,3,0,4
"cg20328160",278,13,0,0,291
"cg20328726",2,0,0,0,2
"cg20329021",0,2,0,0,2
"cg20329220",0,0,1,0,1
"cg20329533",3,0,0,0,3
"cg20329723",5,0,0,0,5
"cg20332060",0,0,6,0,6
"cg20332112",5,4,0,0,9
"cg20332404",1,0,0,0,1
"cg20332806",0,0,1,0,1
"cg20332866",0,0,1,0,1
"cg20333067",0,0,1,0,1
"cg20333536",3,2,0,0,5
"cg20334513",0,0,1,0,1
"cg20334591",1,0,0,0,1
"cg20336730",1,0,0,0,1
"cg20337687",1,0,0,0,1
"cg20337698",1,0,0,0,1
"cg20338393",1,0,0,0,1
"cg20339692",0,0,2,0,2
"cg20340405",1031,154,1,0,1186
"cg20345015",0,0,1,0,1
"cg20347101",2,0,0,0,2
"cg20348895",0,2,2,0,4
"cg20349231",1,0,0,0,1
"cg20349448",2,0,0,0,2
"cg20349574",2,0,0,0,2
"cg20349793",0,2,0,0,2
"cg20350501",1,0,0,0,1
"cg20350716",0,0,1,0,1
"cg20352786",0,1,0,0,1
"cg20353685",0,1,0,0,1
"cg20354231",1,1,0,0,2
"cg20354485",0,1,0,0,1
"cg20354859",2,2,0,0,4
"cg20355644",0,0,1,0,1
"cg20355731",3,1,2,0,6
"cg20358061",0,3,5,0,8
"cg20358158",0,1,0,0,1
"cg20359535",0,0,1,0,1
"cg20360428",0,1,0,0,1
"cg20360810",3,2,0,0,5
"cg20361960",0,0,1,0,1
"cg20363699",0,0,2,0,2
"cg20364241",149,221,6,0,376
"cg20364505",3,0,0,0,3
"cg20364531",12,1,0,0,13
"cg20364820",0,3,0,0,3
"cg20364988",1,0,3,0,4
"cg20365451",2,2,0,0,4
"cg20365719",1,0,0,0,1
"cg20366296",1,0,0,0,1
"cg20367170",1,1,0,0,2
"cg20368377",1,1,0,0,2
"cg20370901",1,1,1,0,3
"cg20372690",1,1,1,0,3
"cg20373587",0,0,1,0,1
"cg20374114",1,0,0,0,1
"cg20374928",0,1,0,0,1
"cg20375388",5,2,0,0,7
"cg20375585",0,0,1,0,1
"cg20376489",17,4,0,0,21
"cg20377766",1,0,1,0,2
"cg20379598",3,1,0,0,4
"cg20380091",0,0,0,1,1
"cg20383101",0,0,1,0,1
"cg20383766",0,2,0,0,2
"cg20384732",0,0,5,0,5
"cg20385129",0,0,1,0,1
"cg20385366",20,2,0,0,22
"cg20386219",0,0,2,0,2
"cg20386784",100,28,13,0,141
"cg20387256",1,0,2,0,3
"cg20388428",0,1,0,0,1
"cg20389009",1,0,0,0,1
"cg20390826",172,361,23,0,556
"cg20391556",1,0,0,0,1
"cg20391668",1,0,0,0,1
"cg20391833",0,1,0,0,1
"cg20393002",26,20,2,0,48
"cg20393549",0,1,0,0,1
"cg20393882",0,1,1,0,2
"cg20394609",0,0,1,0,1
"cg20395490",0,1,0,0,1
"cg20397219",709,67,0,0,776
"cg20398571",0,0,1,0,1
"cg20400718",0,1,0,0,1
"cg20400795",0,0,0,1,1
"cg20401786",7,3,0,0,10
"cg20401833",0,1,0,0,1
"cg20402628",33,9,0,0,42
"cg20402659",1,0,0,0,1
"cg20402990",2,0,0,0,2
"cg20405114",0,0,1,0,1
"cg20405809",2,0,0,0,2
"cg20407713",0,2,0,0,2
"cg20408074",0,0,1,0,1
"cg20409368",1,13,2,0,16
"cg20409922",0,0,1,0,1
"cg20410062",2,3,0,0,5
"cg20411727",2,0,0,0,2
"cg20412698",1,3,0,0,4
"cg20413331",78,9,1,0,88
"cg20414217",1,1,0,0,2
"cg20414893",0,1,0,0,1
"cg20416132",0,1,0,0,1
"cg20416139",0,6,0,0,6
"cg20416574",39,0,0,0,39
"cg20417195",0,0,1,0,1
"cg20417233",0,2,0,0,2
"cg20417583",53,23,0,0,76
"cg20418204",7,16,11,0,34
"cg20418562",0,0,0,1,1
"cg20418818",0,0,1,0,1
"cg20419802",10,0,0,0,10
"cg20421360",1,0,0,0,1
"cg20423368",0,0,1,0,1
"cg20423484",14,3,0,0,17
"cg20423519",3,1,0,0,4
"cg20423581",16,29,6,0,51
"cg20423982",0,0,1,0,1
"cg20425150",0,1,0,0,1
"cg20425154",0,1,1,0,2
"cg20426729",0,0,2,0,2
"cg20428120",66,17,1,0,84
"cg20428887",1,0,0,0,1
"cg20429584",6,0,0,0,6
"cg20430870",0,1,0,0,1
"cg20431488",1,0,1,0,2
"cg20432401",0,3,1,0,4
"cg20433828",1,0,0,0,1
"cg20434300",1,0,0,0,1
"cg20435370",0,0,1,0,1
"cg20435725",0,0,1,0,1
"cg20437718",0,0,2,0,2
"cg20437876",0,1,0,0,1
"cg20438427",0,1,0,0,1
"cg20438820",0,2,0,0,2
"cg20439892",0,1,0,0,1
"cg20441912",0,1,3,0,4
"cg20442586",1,0,0,0,1
"cg20442636",0,0,1,0,1
"cg20442722",1,0,0,0,1
"cg20443413",1,0,0,0,1
"cg20444525",1,0,0,0,1
"cg20444604",0,2,1,0,3
"cg20444784",3,10,9,0,22
"cg20444858",0,1,1,0,2
"cg20445967",31,102,19,0,152
"cg20447508",2,1,1,0,4
"cg20447754",0,0,1,0,1
"cg20448617",0,1,0,0,1
"cg20448710",1,0,0,0,1
"cg20448974",1,1,0,0,2
"cg20449134",15,0,0,0,15
"cg20449764",16,124,1,0,141
"cg20450338",0,1,0,0,1
"cg20450977",2,0,0,1,3
"cg20452609",1,0,0,0,1
"cg20454464",5,0,0,0,5
"cg20456732",0,1,2,0,3
"cg20457894",0,1,0,0,1
"cg20458277",0,0,2,0,2
"cg20461196",1,0,0,0,1
"cg20462569",0,0,1,0,1
"cg20463302",1,0,0,0,1
"cg20464438",1,0,0,0,1
"cg20464617",0,0,0,1,1
"cg20465830",3,3,1,0,7
"cg20466045",0,1,0,0,1
"cg20466739",842,581,17,0,1440
"cg20468462",417,16,0,0,433
"cg20469666",0,1,1,0,2
"cg20469780",0,1,0,0,1
"cg20469847",268,8,0,0,276
"cg20472189",0,1,3,0,4
"cg20472939",3,1,0,0,4
"cg20473622",55,2,0,0,57
"cg20475035",1,6,7,0,14
"cg20475304",16,0,0,0,16
"cg20476329",0,1,0,0,1
"cg20477059",0,1,3,0,4
"cg20477274",0,0,1,0,1
"cg20477318",0,0,1,0,1
"cg20477464",1,0,0,0,1
"cg20477962",6,11,1,0,18
"cg20479054",0,1,0,0,1
"cg20479672",0,1,0,0,1
"cg20481037",13,11,12,0,36
"cg20481416",0,1,0,0,1
"cg20482788",574,23,1,0,598
"cg20482922",0,1,0,0,1
"cg20483694",0,1,0,0,1
"cg20484215",0,0,2,0,2
"cg20484640",1,1,0,0,2
"cg20485361",3,0,0,0,3
"cg20485932",21,24,9,0,54
"cg20486417",0,0,1,0,1
"cg20486643",2,0,0,0,2
"cg20488573",8,2,0,0,10
"cg20489954",0,0,1,0,1
"cg20492230",74,3,0,0,77
"cg20493229",1,0,0,0,1
"cg20493661",2,2,0,0,4
"cg20494196",18,11,0,0,29
"cg20494576",103,218,23,0,344
"cg20494682",83,3,0,0,86
"cg20494995",3,0,0,0,3
"cg20496061",3,4,0,0,7
"cg20496485",0,0,1,0,1
"cg20496613",113,24,1,0,138
"cg20499993",0,0,1,0,1
"cg20500081",4,0,0,0,4
"cg20500839",6,2,0,0,8
"cg20501883",1,0,1,0,2
"cg20502901",1,0,0,0,1
"cg20503050",0,0,2,0,2
"cg20503077",0,0,15,0,15
"cg20503432",0,0,1,0,1
"cg20503907",2,0,0,0,2
"cg20505486",59,2,0,0,61
"cg20507224",0,0,0,1,1
"cg20507363",5,0,0,0,5
"cg20507643",1,0,0,0,1
"cg20508345",0,0,2,0,2
"cg20508743",0,1,5,0,6
"cg20508815",12,1,1,0,14
"cg20510070",0,0,1,0,1
"cg20510418",1,0,0,0,1
"cg20510500",2,13,1,0,16
"cg20510675",1,0,0,0,1
"cg20510772",0,0,1,0,1
"cg20511463",0,0,1,0,1
"cg20511534",11,15,1,0,27
"cg20512389",0,0,0,1,1
"cg20513398",0,1,0,0,1
"cg20514320",3,0,0,0,3
"cg20514367",5,1,0,0,6
"cg20514760",0,0,0,1,1
"cg20516699",4,3,0,0,7
"cg20517615",2,2,0,0,4
"cg20518942",320,75,1,0,396
"cg20520147",1,0,0,0,1
"cg20521104",0,1,0,0,1
"cg20521277",1,0,0,0,1
"cg20522505",0,0,1,0,1
"cg20523278",198,196,16,0,410
"cg20523569",0,1,0,0,1
"cg20523891",3,1,0,0,4
"cg20525663",5,14,13,0,32
"cg20526943",4,0,0,0,4
"cg20527049",2,0,0,0,2
"cg20527373",0,0,1,0,1
"cg20527398",0,1,1,0,2
"cg20527733",1,6,0,0,7
"cg20529334",74,4,1,0,79
"cg20533095",6,2,0,0,8
"cg20533579",0,1,1,0,2
"cg20534297",0,1,0,0,1
"cg20534596",0,0,1,0,1
"cg20535026",0,0,1,0,1
"cg20535197",0,1,4,0,5
"cg20535425",0,1,0,0,1
"cg20535931",0,0,1,0,1
"cg20537464",1,0,0,0,1
"cg20538951",0,0,2,0,2
"cg20539350",3,11,7,0,21
"cg20539360",0,1,3,0,4
"cg20539430",1,0,0,0,1
"cg20539798",0,0,1,0,1
"cg20540370",0,8,12,0,20
"cg20541233",0,1,5,0,6
"cg20541376",1,0,0,0,1
"cg20541925",0,1,1,0,2
"cg20542592",1,1,1,0,3
"cg20545224",0,1,0,0,1
"cg20545626",0,1,0,0,1
"cg20547806",44,0,0,0,44
"cg20549186",1,1,0,0,2
"cg20550954",96,8,0,0,104
"cg20552012",0,2,1,0,3
"cg20553058",1,0,0,0,1
"cg20554397",0,0,1,0,1
"cg20554822",1,0,0,0,1
"cg20554832",0,2,0,0,2
"cg20555222",18,0,0,0,18
"cg20556216",0,1,0,0,1
"cg20556704",1,2,0,0,3
"cg20558497",0,0,1,0,1
"cg20559422",0,0,2,0,2
"cg20559600",0,0,1,0,1
"cg20559786",1,0,0,0,1
"cg20560038",1,0,0,0,1
"cg20563971",5,1,0,0,6
"cg20564442",6,0,0,0,6
"cg20564496",1,1,0,0,2
"cg20565374",0,1,0,0,1
"cg20567176",10,1,0,0,11
"cg20568408",9,3,0,0,12
"cg20569129",140,142,9,0,291
"cg20569562",0,0,1,0,1
"cg20569940",0,0,1,0,1
"cg20571115",0,1,0,0,1
"cg20571404",0,0,1,0,1
"cg20571825",1,0,0,0,1
"cg20573729",0,0,2,0,2
"cg20575660",2,1,0,0,3
"cg20576638",0,2,0,0,2
"cg20577102",1,0,0,0,1
"cg20578581",4,0,0,0,4
"cg20578850",6,4,3,0,13
"cg20579505",0,0,1,0,1
"cg20580912",4,0,0,0,4
"cg20581076",5,3,2,0,10
"cg20581154",1,0,2,0,3
"cg20581424",3,0,0,0,3
"cg20581490",1,0,0,0,1
"cg20582547",19,2,0,0,21
"cg20583250",51,1434,162,0,1647
"cg20583271",4,1,1,0,6
"cg20584997",1,5,1,0,7
"cg20586091",0,0,0,1,1
"cg20586239",0,0,1,0,1
"cg20586328",1,0,0,0,1
"cg20586366",2,0,0,0,2
"cg20586764",2,1,0,0,3
"cg20586911",4,0,1,0,5
"cg20587968",0,1,0,0,1
"cg20587970",0,1,1,0,2
"cg20588605",0,1,0,0,1
"cg20590680",659,217,6,0,882
"cg20591136",0,0,2,0,2
"cg20591587",7,2,0,0,9
"cg20592656",1,0,0,0,1
"cg20593404",880,228,9,0,1117
"cg20593599",1,0,0,0,1
"cg20593868",0,1,0,0,1
"cg20594433",635,41,0,0,676
"cg20595818",4,0,0,0,4
"cg20596590",0,0,1,0,1
"cg20597714",0,0,1,0,1
"cg20597812",0,0,1,0,1
"cg20598555",2,0,0,0,2
"cg20598650",1,0,0,0,1
"cg20598808",0,1,0,0,1
"cg20600154",1,1,6,0,8
"cg20602628",236,322,33,0,591
"cg20602842",1,6,0,0,7
"cg20602954",1,0,0,0,1
"cg20603668",3,13,8,0,24
"cg20603821",0,2,0,0,2
"cg20604634",4,0,0,0,4
"cg20604645",2,0,0,0,2
"cg20606340",40,18,1,0,59
"cg20606964",0,2,0,0,2
"cg20607684",0,1,1,0,2
"cg20608095",2,0,0,0,2
"cg20608329",1,6,9,0,16
"cg20608892",24,2,0,0,26
"cg20609331",16,3,0,0,19
"cg20611453",1,0,0,0,1
"cg20612962",0,1,1,0,2
"cg20613468",3,0,0,0,3
"cg20613639",422,331,7,0,760
"cg20614148",0,1,0,0,1
"cg20614157",0,0,1,0,1
"cg20614214",13,0,0,0,13
"cg20615655",0,0,2,0,2
"cg20616125",1,0,0,0,1
"cg20617637",1,0,0,0,1
"cg20618527",0,0,3,0,3
"cg20620067",1,0,0,0,1
"cg20620652",0,1,0,0,1
"cg20621459",239,344,3,0,586
"cg20621471",0,1,0,0,1
"cg20622111",2,0,0,0,2
"cg20622629",4,0,0,0,4
"cg20622826",0,0,1,0,1
"cg20623645",23,5,0,0,28
"cg20625065",46,2,0,0,48
"cg20625903",1,0,0,0,1
"cg20626144",0,1,0,0,1
"cg20626321",12,1,2,0,15
"cg20626391",0,1,0,0,1
"cg20627509",0,0,1,0,1
"cg20627546",0,1,0,0,1
"cg20627643",1,1,3,0,5
"cg20627743",1,4,5,0,10
"cg20628718",1,0,0,0,1
"cg20629468",0,0,2,0,2
"cg20629667",0,0,1,0,1
"cg20630363",6,0,0,0,6
"cg20630442",0,0,1,0,1
"cg20631224",1,1,3,0,5
"cg20631839",0,0,1,0,1
"cg20632416",0,0,1,0,1
"cg20634628",9,2,0,0,11
"cg20634754",1,0,2,0,3
"cg20636457",6,2,0,0,8
"cg20638450",27,4,0,0,31
"cg20638644",244,215,8,0,467
"cg20638805",14,9,0,0,23
"cg20639203",1,0,0,0,1
"cg20639942",0,1,0,0,1
"cg20641020",0,0,1,0,1
"cg20641423",0,0,1,0,1
"cg20641450",1,0,0,0,1
"cg20643621",0,0,1,0,1
"cg20643659",2,0,0,0,2
"cg20646533",8,1,0,0,9
"cg20646627",0,1,0,0,1
"cg20646889",1,0,0,0,1
"cg20647158",1,0,0,0,1
"cg20649256",1,0,0,0,1
"cg20649716",2,7,6,0,15
"cg20649848",0,0,1,0,1
"cg20650035",1,2,0,0,3
"cg20651456",0,0,1,0,1
"cg20652371",2,0,0,0,2
"cg20653227",1,2,0,0,3
"cg20653689",0,0,1,0,1
"cg20653859",0,1,0,0,1
"cg20654746",24,7,0,0,31
"cg20655405",1,0,0,0,1
"cg20656058",0,0,1,0,1
"cg20656477",0,0,1,0,1
"cg20656595",0,3,0,0,3
"cg20656962",1,0,0,0,1
"cg20657188",0,1,0,0,1
"cg20657306",0,1,0,0,1
"cg20657383",0,1,0,0,1
"cg20657674",2,0,0,0,2
"cg20658149",0,1,0,0,1
"cg20658918",5,0,1,0,6
"cg20659064",9,0,0,0,9
"cg20659736",7,10,1,0,18
"cg20661756",0,1,0,0,1
"cg20661965",0,0,1,0,1
"cg20662397",2,0,0,0,2
"cg20663688",1,0,1,0,2
"cg20665709",0,1,0,0,1
"cg20666428",0,0,1,0,1
"cg20666738",1,0,0,0,1
"cg20666807",1,0,1,0,2
"cg20667330",3,0,0,0,3
"cg20667960",0,1,0,0,1
"cg20668607",1,0,0,0,1
"cg20668952",0,1,0,0,1
"cg20669822",0,0,1,0,1
"cg20670404",6,1,0,0,7
"cg20671790",0,1,0,0,1
"cg20675040",0,1,1,0,2
"cg20675251",0,1,0,0,1
"cg20675557",150,335,8,0,493
"cg20675616",0,1,0,0,1
"cg20675840",57,30,1,0,88
"cg20676303",0,0,8,0,8
"cg20676413",11,2,0,0,13
"cg20676760",1,0,0,0,1
"cg20677078",2,2,0,0,4
"cg20677114",4,0,0,0,4
"cg20677261",298,6,0,0,304
"cg20677962",0,0,1,0,1
"cg20678128",122,31,4,0,157
"cg20678665",0,1,1,2,4
"cg20679403",1,0,0,0,1
"cg20680308",0,2,0,0,2
"cg20681626",0,1,1,0,2
"cg20681653",0,2,1,0,3
"cg20681704",1,0,0,0,1
"cg20681783",0,1,0,0,1
"cg20682376",0,0,1,0,1
"cg20682991",2,0,2,0,4
"cg20683250",1,0,0,0,1
"cg20683454",2,1,3,0,6
"cg20683809",2,0,0,0,2
"cg20685520",0,0,2,0,2
"cg20685897",1,0,0,0,1
"cg20687190",0,1,3,0,4
"cg20687553",0,0,1,0,1
"cg20687587",126,7,0,0,133
"cg20688114",1,0,0,0,1
"cg20689232",0,0,4,0,4
"cg20693303",5,3,0,0,8
"cg20693615",3,1,0,0,4
"cg20694253",0,0,2,0,2
"cg20694303",2,5,3,0,10
"cg20695203",0,0,1,0,1
"cg20695578",0,0,1,0,1
"cg20696198",1,0,0,0,1
"cg20696493",1,0,0,0,1
"cg20696674",0,1,0,0,1
"cg20697075",4,2,2,0,8
"cg20698037",0,1,1,0,2
"cg20699097",1,1,1,0,3
"cg20699227",1,1,0,0,2
"cg20699457",3,0,0,0,3
"cg20700435",0,0,1,0,1
"cg20700549",1,2,0,0,3
"cg20700576",0,2,1,0,3
"cg20702862",1,0,0,0,1
"cg20703467",1,0,0,0,1
"cg20703581",0,1,0,0,1
"cg20703731",0,0,1,0,1
"cg20704585",0,0,1,0,1
"cg20704793",0,1,0,0,1
"cg20705570",477,16,0,0,493
"cg20705829",7,1,0,0,8
"cg20706620",676,148,42,0,866
"cg20706621",1,2,0,0,3
"cg20707921",2,0,0,0,2
"cg20708224",0,2,19,0,21
"cg20708535",1,1,0,0,2
"cg20708961",10,6,3,0,19
"cg20709797",12,0,0,0,12
"cg20709984",1,0,0,0,1
"cg20710569",66,576,6,0,648
"cg20710890",0,0,1,0,1
"cg20711639",1,0,0,0,1
"cg20712925",368,25,0,0,393
"cg20714059",4,3,0,0,7
"cg20715506",0,0,1,0,1
"cg20716074",4,1,0,0,5
"cg20716100",40,27,2,0,69
"cg20716998",1,0,0,0,1
"cg20717053",1,0,0,0,1
"cg20717077",153,69,6,0,228
"cg20719263",3,5,0,0,8
"cg20722353",1,0,0,0,1
"cg20722698",1,0,0,0,1
"cg20723599",2,0,0,0,2
"cg20723941",1,0,0,0,1
"cg20724014",3,0,0,0,3
"cg20724918",2,0,0,0,2
"cg20725157",2,4,0,0,6
"cg20725493",2,1,1,0,4
"cg20726070",3,0,0,0,3
"cg20727233",0,1,0,0,1
"cg20727345",307,6,0,0,313
"cg20727403",26,4,0,0,30
"cg20727449",0,1,0,0,1
"cg20727814",0,0,1,0,1
"cg20727998",0,1,0,0,1
"cg20729130",2,0,0,0,2
"cg20730917",20,6,0,0,26
"cg20731562",1,6,0,0,7
"cg20732166",2,0,0,0,2
"cg20735015",1,0,0,0,1
"cg20735069",1,0,0,0,1
"cg20735183",1,0,0,0,1
"cg20735259",1,0,0,0,1
"cg20736490",0,1,0,0,1
"cg20737769",1,0,0,0,1
"cg20737836",0,0,1,0,1
"cg20738924",1,0,0,0,1
"cg20741163",0,2,0,0,2
"cg20741528",0,0,1,0,1
"cg20742080",0,0,1,0,1
"cg20742548",0,1,0,0,1
"cg20744275",0,1,0,0,1
"cg20746081",17,8,2,0,27
"cg20746451",0,1,0,0,1
"cg20746702",0,1,2,0,3
"cg20746762",0,1,0,0,1
"cg20747401",0,1,0,0,1
"cg20747565",1,0,0,0,1
"cg20747789",1,0,0,0,1
"cg20748131",0,1,0,0,1
"cg20748558",1,0,0,0,1
"cg20750953",1,0,1,0,2
"cg20753979",0,1,0,0,1
"cg20754394",0,2,1,0,3
"cg20754430",1,0,0,0,1
"cg20754582",0,1,1,0,2
"cg20755309",0,1,0,0,1
"cg20756175",170,170,7,0,347
"cg20756454",1,0,0,0,1
"cg20756702",0,0,1,0,1
"cg20757966",1,0,0,0,1
"cg20758932",0,0,1,0,1
"cg20760467",0,0,2,0,2
"cg20761303",1,1,1,0,3
"cg20762182",0,0,1,0,1
"cg20764753",1,0,0,0,1
"cg20764796",0,0,1,0,1
"cg20764907",0,1,0,0,1
"cg20765571",3,0,0,0,3
"cg20765985",0,0,2,0,2
"cg20766940",0,1,0,0,1
"cg20767257",331,11,0,0,342
"cg20767722",43,2,0,0,45
"cg20767890",3,0,0,0,3
"cg20768340",0,1,1,0,2
"cg20768342",3,1,0,0,4
"cg20768669",0,5,0,0,5
"cg20769256",0,1,0,0,1
"cg20769683",0,0,1,0,1
"cg20770075",1,0,2,0,3
"cg20770498",3,2,0,0,5
"cg20770572",0,0,1,0,1
"cg20771687",0,1,0,0,1
"cg20772373",0,1,0,0,1
"cg20774413",1,0,0,0,1
"cg20774646",0,0,2,0,2
"cg20775222",2,0,3,0,5
"cg20775712",0,1,0,0,1
"cg20776462",181,94,4,0,279
"cg20776891",0,1,0,0,1
"cg20777257",2,0,0,0,2
"cg20777656",0,1,0,0,1
"cg20777740",1,0,0,0,1
"cg20778411",0,1,0,0,1
"cg20778496",2,9,4,0,15
"cg20778694",1,1,0,0,2
"cg20780319",24,2,0,0,26
"cg20780612",2,2,0,0,4
"cg20781234",0,0,1,0,1
"cg20781526",0,0,1,0,1
"cg20782286",1,0,0,0,1
"cg20782731",0,0,1,0,1
"cg20783453",2,0,0,0,2
"cg20785177",0,2,0,0,2
"cg20785313",0,0,1,0,1
"cg20785695",0,0,1,0,1
"cg20786489",1,0,0,0,1
"cg20786740",197,14,0,0,211
"cg20786779",2,0,0,0,2
"cg20787634",0,0,1,0,1
"cg20788673",0,0,1,0,1
"cg20789691",1,0,0,0,1
"cg20791323",2,0,0,0,2
"cg20791412",171,3,0,0,174
"cg20792256",1,1,2,0,4
"cg20792381",0,1,1,0,2
"cg20793648",4,0,1,0,5
"cg20794546",1,0,0,0,1
"cg20796544",53,25,0,0,78
"cg20796883",1,0,0,0,1
"cg20797068",2,0,0,0,2
"cg20797188",0,2,1,0,3
"cg20797431",0,1,0,0,1
"cg20799503",1,0,0,0,1
"cg20800579",0,0,1,0,1
"cg20800816",0,1,0,0,1
"cg20803076",680,25,0,0,705
"cg20803423",1,0,0,0,1
"cg20803549",6,15,0,0,21
"cg20803780",1,0,0,0,1
"cg20804072",0,0,1,0,1
"cg20804581",1,3,0,0,4
"cg20806140",0,1,0,0,1
"cg20806274",8,0,0,0,8
"cg20807583",0,1,1,0,2
"cg20807821",3,1,1,0,5
"cg20808224",9,2,0,0,11
"cg20808578",1,0,0,0,1
"cg20809690",0,1,0,0,1
"cg20809829",1,1,0,0,2
"cg20809929",2,0,0,0,2
"cg20810684",0,0,1,0,1
"cg20811321",0,0,2,0,2
"cg20811586",1,2,0,0,3
"cg20811988",0,1,0,0,1
"cg20812209",5,5,1,0,11
"cg20812354",0,1,0,0,1
"cg20812929",0,0,1,0,1
"cg20813927",1,0,0,0,1
"cg20814882",1,0,0,0,1
"cg20815539",0,0,4,0,4
"cg20815643",1,1,1,0,3
"cg20817073",0,0,0,2,2
"cg20817228",0,2,4,0,6
"cg20818341",0,0,1,0,1
"cg20820808",0,0,1,0,1
"cg20821042",1,0,0,0,1
"cg20821082",0,1,1,0,2
"cg20821544",0,0,1,0,1
"cg20822087",1,0,2,0,3
"cg20823055",1,0,1,0,2
"cg20823181",87,155,3,0,245
"cg20823529",1,1,0,0,2
"cg20823730",1,1,0,0,2
"cg20824200",0,1,0,0,1
"cg20825769",0,0,1,0,1
"cg20826526",0,0,1,0,1
"cg20826737",16,1,0,0,17
"cg20826759",399,24,2,0,425
"cg20826792",0,1,3,0,4
"cg20827346",1,0,0,0,1
"cg20827882",216,26,0,0,242
"cg20828969",0,0,1,0,1
"cg20829176",250,516,11,0,777
"cg20829256",1,0,0,0,1
"cg20829789",0,0,1,0,1
"cg20830565",0,2,1,0,3
"cg20831236",9,8,0,0,17
"cg20833774",0,2,2,0,4
"cg20834643",1,1,0,0,2
"cg20834966",426,66,1,0,493
"cg20836156",0,0,1,0,1
"cg20836817",0,0,1,0,1
"cg20836993",31,6,0,0,37
"cg20837171",0,0,0,1,1
"cg20837803",1,0,0,0,1
"cg20837938",1,0,0,0,1
"cg20838623",1,0,0,0,1
"cg20839522",2,0,2,0,4
"cg20840639",5,1,1,0,7
"cg20840800",1,0,0,0,1
"cg20841362",5,2,2,0,9
"cg20842340",0,0,1,0,1
"cg20842435",1,0,0,0,1
"cg20842969",3,0,0,0,3
"cg20843080",0,1,1,0,2
"cg20843984",0,1,0,0,1
"cg20845262",1,0,0,0,1
"cg20845305",0,1,0,0,1
"cg20845336",0,1,0,0,1
"cg20845342",1,0,0,0,1
"cg20845684",2,0,0,0,2
"cg20848710",0,0,1,0,1
"cg20848924",16,2,0,0,18
"cg20849062",0,1,0,0,1
"cg20849935",58,9,0,0,67
"cg20850055",1,0,2,0,3
"cg20850981",2,0,0,0,2
"cg20851265",1,1,0,0,2
"cg20852653",0,1,0,0,1
"cg20852738",0,1,0,0,1
"cg20853229",1,0,0,0,1
"cg20854570",5,0,0,0,5
"cg20855042",0,0,1,0,1
"cg20856750",15,1,0,0,16
"cg20857301",4,0,0,0,4
"cg20858284",0,1,0,0,1
"cg20858577",0,1,0,0,1
"cg20858611",0,1,0,0,1
"cg20859451",221,477,3,0,701
"cg20861053",0,0,1,0,1
"cg20861237",2,0,0,0,2
"cg20863160",0,0,1,0,1
"cg20864028",100,4,0,0,104
"cg20864859",3,1,0,0,4
"cg20865782",8,1,16,0,25
"cg20866409",0,0,1,0,1
"cg20866592",2,1,0,0,3
"cg20867157",0,0,1,0,1
"cg20867475",205,104,13,0,322
"cg20868058",0,4,1,0,5
"cg20868359",1,0,0,0,1
"cg20868463",41,1,0,0,42
"cg20868868",0,0,1,0,1
"cg20869310",1,0,0,0,1
"cg20869999",902,265,4,0,1171
"cg20870372",0,2,1,0,3
"cg20873579",0,1,1,0,2
"cg20874987",0,0,1,0,1
"cg20875182",3,0,0,0,3
"cg20876428",2,0,0,0,2
"cg20877162",0,0,1,0,1
"cg20877230",2,0,0,0,2
"cg20877507",0,1,0,0,1
"cg20879279",39,20,0,0,59
"cg20879959",2,3,0,0,5
"cg20880339",1,0,0,0,1
"cg20882459",0,1,0,0,1
"cg20883882",1,0,0,0,1
"cg20884109",147,167,5,0,319
"cg20884330",1,0,0,0,1
"cg20884589",0,0,1,0,1
"cg20885342",10,3,0,0,13
"cg20885910",0,3,1,0,4
"cg20888184",1,0,0,0,1
"cg20889631",0,0,1,0,1
"cg20889774",44,0,0,0,44
"cg20889841",0,0,3,0,3
"cg20891060",1,0,0,0,1
"cg20891225",0,1,0,0,1
"cg20891817",1,0,0,0,1
"cg20892606",0,1,0,0,1
"cg20892674",0,2,0,0,2
"cg20892743",0,1,0,0,1
"cg20893291",1,0,0,0,1
"cg20894936",0,0,1,0,1
"cg20896063",0,1,0,0,1
"cg20896293",2,0,0,0,2
"cg20897026",6,14,0,0,20
"cg20898922",0,1,3,0,4
"cg20899329",0,0,1,0,1
"cg20899581",2,4,0,0,6
"cg20899713",1,2,4,1,8
"cg20899718",1,0,0,0,1
"cg20900557",1,0,0,0,1
"cg20902850",0,1,6,0,7
"cg20904024",0,0,1,0,1
"cg20906217",0,0,1,0,1
"cg20907137",205,207,26,0,438
"cg20908200",11,0,0,0,11
"cg20908297",0,1,0,0,1
"cg20908894",1,0,0,0,1
"cg20910562",0,5,0,0,5
"cg20914792",0,0,1,0,1
"cg20915150",0,0,1,0,1
"cg20915907",174,14,0,0,188
"cg20916804",0,0,2,0,2
"cg20918220",0,0,1,1,2
"cg20921874",2,1,0,0,3
"cg20922957",0,0,5,0,5
"cg20923676",59,9,0,0,68
"cg20924269",3,4,1,0,8
"cg20924972",8,2,0,0,10
"cg20925400",0,0,1,0,1
"cg20925763",2,0,0,0,2
"cg20926353",0,0,1,0,1
"cg20929132",0,1,1,0,2
"cg20930299",0,0,1,0,1
"cg20930329",1,0,3,0,4
"cg20930685",5,1,0,0,6
"cg20931662",2,0,0,0,2
"cg20932644",1,0,2,0,3
"cg20934323",0,2,0,0,2
"cg20934481",0,0,1,0,1
"cg20934697",0,0,1,0,1
"cg20935057",0,3,0,0,3
"cg20937317",2,0,0,0,2
"cg20938689",0,1,0,0,1
"cg20938846",0,1,1,0,2
"cg20939736",0,0,1,0,1
"cg20942625",4,0,0,0,4
"cg20943076",4,18,2,0,24
"cg20944651",18,3,0,0,21
"cg20944928",0,0,2,0,2
"cg20945463",1,0,0,0,1
"cg20945764",0,0,1,0,1
"cg20947127",0,0,1,0,1
"cg20947553",2,0,0,0,2
"cg20948347",1,0,0,0,1
"cg20948604",0,0,2,0,2
"cg20949223",0,0,3,0,3
"cg20949320",0,1,0,0,1
"cg20950092",0,0,1,0,1
"cg20951194",0,0,1,0,1
"cg20952364",0,1,0,0,1
"cg20953510",1,0,0,0,1
"cg20955193",0,1,0,0,1
"cg20956187",0,0,1,0,1
"cg20956629",2,0,0,0,2
"cg20957029",0,0,1,0,1
"cg20957182",0,2,0,0,2
"cg20957317",1,0,0,0,1
"cg20958434",1,0,0,0,1
"cg20959274",0,1,6,0,7
"cg20960039",3,0,0,0,3
"cg20960167",267,7,0,0,274
"cg20960953",21,706,24,0,751
"cg20961007",0,0,2,0,2
"cg20962833",3,3,1,0,7
"cg20962915",12,15,3,0,30
"cg20963015",0,2,0,2,4
"cg20963047",2,2,0,0,4
"cg20963267",0,1,0,0,1
"cg20965017",0,0,2,0,2
"cg20966032",1,0,0,0,1
"cg20966148",2,2,5,0,9
"cg20966187",3,7,0,0,10
"cg20967147",0,2,0,0,2
"cg20967183",13,1,0,0,14
"cg20969061",0,1,0,0,1
"cg20969105",1,0,0,0,1
"cg20969614",5,0,0,0,5
"cg20970086",8,7,1,0,16
"cg20970149",0,3,5,0,8
"cg20970685",71,448,24,0,543
"cg20971263",0,1,2,0,3
"cg20971459",963,153,4,0,1120
"cg20971995",0,1,0,0,1
"cg20972091",0,0,2,0,2
"cg20972142",5,1,0,0,6
"cg20972216",1,0,0,0,1
"cg20972342",0,0,2,0,2
"cg20972559",1,0,0,0,1
"cg20973396",1,1,0,0,2
"cg20973417",0,0,1,0,1
"cg20975546",0,0,1,0,1
"cg20975954",0,0,1,0,1
"cg20976708",0,1,0,0,1
"cg20976951",0,2,0,0,2
"cg20977192",0,0,2,0,2
"cg20978698",1,0,0,0,1
"cg20979032",0,1,0,0,1
"cg20980303",2,0,0,0,2
"cg20981001",1,0,0,0,1
"cg20981286",3,5,2,0,10
"cg20981451",1,0,0,0,1
"cg20981728",0,1,0,0,1
"cg20982223",1,0,0,0,1
"cg20982367",2,0,0,0,2
"cg20982911",2,0,0,0,2
"cg20983902",0,1,0,0,1
"cg20985028",0,0,1,0,1
"cg20985617",3,0,1,0,4
"cg20986443",1,0,0,0,1
"cg20987072",5,3,0,0,8
"cg20988870",41,0,0,0,41
"cg20989591",0,2,1,0,3
"cg20990400",1,0,1,0,2
"cg20990527",0,0,1,0,1
"cg20990620",0,0,2,0,2
"cg20991261",1,1,0,0,2
"cg20991341",1,1,0,0,2
"cg20991470",1,0,0,0,1
"cg20992330",3,0,4,0,7
"cg20992733",6,0,0,0,6
"cg20993262",1,0,0,0,1
"cg20993764",3,2,0,0,5
"cg20993868",3,6,9,0,18
"cg20994227",229,110,16,0,355
"cg20994829",0,0,1,0,1
"cg20995185",0,2,0,0,2
"cg20995835",1,1,0,0,2
"cg20995984",2,5,0,0,7
"cg20996348",5,2,0,0,7
"cg20996825",3,0,0,0,3
"cg20997355",0,0,1,0,1
"cg20999516",11,4,1,0,16
"cg20999797",0,1,0,0,1
"cg21001260",3,0,0,0,3
"cg21002146",3,0,0,0,3
"cg21002157",42,1,0,0,43
"cg21003584",1,0,0,0,1
"cg21003892",44,5,0,0,49
"cg21004538",7,5,0,0,12
"cg21005457",0,0,1,0,1
"cg21007530",39,2,0,0,41
"cg21008928",3,0,0,0,3
"cg21009400",0,0,6,0,6
"cg21009420",2,2,0,0,4
"cg21009935",0,0,2,0,2
"cg21010129",43,59,5,0,107
"cg21010476",1,0,0,0,1
"cg21010686",1,2,1,0,4
"cg21010973",4,1,0,0,5
"cg21011350",1,0,2,0,3
"cg21011835",0,1,0,0,1
"cg21011909",10,17,4,0,31
"cg21012380",22,1,0,0,23
"cg21015393",1,0,0,0,1
"cg21017113",7,1,0,0,8
"cg21017406",1,0,0,0,1
"cg21018522",0,1,2,0,3
"cg21019072",3,0,0,0,3
"cg21019771",3,0,0,0,3
"cg21023447",0,0,1,0,1
"cg21024422",0,0,1,0,1
"cg21026933",0,1,0,0,1
"cg21027052",0,0,1,0,1
"cg21027267",0,1,0,0,1
"cg21027792",0,8,0,0,8
"cg21028460",0,1,1,0,2
"cg21030536",5,2,0,0,7
"cg21032476",0,2,0,0,2
"cg21032535",0,0,0,1,1
"cg21033116",1,1,0,0,2
"cg21033675",1,2,0,0,3
"cg21034366",0,0,1,0,1
"cg21034784",0,0,2,0,2
"cg21035964",1,0,0,0,1
"cg21036007",1,1,0,0,2
"cg21036164",1,3,11,0,15
"cg21036766",1,0,0,0,1
"cg21036852",33,0,0,0,33
"cg21039099",187,157,28,0,372
"cg21041011",1,0,0,0,1
"cg21041202",0,1,2,2,5
"cg21041228",1,0,0,0,1
"cg21041447",1,0,0,0,1
"cg21041594",0,0,1,0,1
"cg21041694",1,0,0,0,1
"cg21041751",10,0,0,0,10
"cg21042032",0,3,0,0,3
"cg21042333",4,0,1,0,5
"cg21042477",0,0,1,0,1
"cg21043289",42,2,0,0,44
"cg21043691",6,2,0,0,8
"cg21044349",2,0,0,0,2
"cg21046959",0,1,0,0,1
"cg21047528",0,0,1,0,1
"cg21047761",2,0,0,0,2
"cg21047835",1,2,0,0,3
"cg21048770",1,0,3,0,4
"cg21048930",1,0,0,0,1
"cg21050013",0,0,1,0,1
"cg21051086",0,2,4,0,6
"cg21051907",0,0,2,0,2
"cg21051976",1,0,2,0,3
"cg21052403",0,2,2,0,4
"cg21052788",0,1,0,0,1
"cg21052844",0,2,0,0,2
"cg21053644",190,34,0,0,224
"cg21054563",0,1,0,0,1
"cg21055540",0,2,0,0,2
"cg21056783",0,0,1,0,1
"cg21058129",0,2,2,0,4
"cg21059054",44,2,0,0,46
"cg21059543",2,1,0,0,3
"cg21062931",1,0,0,0,1
"cg21063154",2,0,0,0,2
"cg21063275",0,1,1,0,2
"cg21063400",0,0,1,0,1
"cg21065959",1,0,0,0,1
"cg21066415",0,0,1,0,1
"cg21066506",0,1,1,0,2
"cg21067079",3,0,0,0,3
"cg21068149",1,0,0,0,1
"cg21068703",0,0,1,0,1
"cg21069494",0,1,0,0,1
"cg21070527",0,0,1,0,1
"cg21070846",0,0,1,0,1
"cg21071076",1,0,0,0,1
"cg21071625",0,2,0,0,2
"cg21071940",158,290,34,0,482
"cg21072513",3,0,0,0,3
"cg21073776",13,0,0,0,13
"cg21074943",3,2,0,0,5
"cg21075870",1,0,0,0,1
"cg21075976",10,19,7,0,36
"cg21077378",3,1,0,0,4
"cg21078108",80,48,2,0,130
"cg21078195",1,0,0,0,1
"cg21078247",196,329,8,0,533
"cg21078414",0,1,0,0,1
"cg21079604",1,0,0,0,1
"cg21081039",1,0,0,0,1
"cg21082444",0,1,0,0,1
"cg21083189",13,4,0,0,17
"cg21085001",0,1,0,0,1
"cg21085274",5,1,0,0,6
"cg21085594",1,0,0,0,1
"cg21085701",1,0,0,0,1
"cg21087300",0,0,1,0,1
"cg21088159",5,1,1,0,7
"cg21088468",2,0,0,0,2
"cg21089394",7,0,0,0,7
"cg21089976",0,1,0,0,1
"cg21090278",0,0,1,0,1
"cg21093119",4,0,0,0,4
"cg21093215",0,0,1,0,1
"cg21094249",0,1,1,0,2
"cg21094465",0,0,1,1,2
"cg21094501",1,0,1,0,2
"cg21094949",2,2,2,0,6
"cg21095142",0,1,0,0,1
"cg21095318",0,3,1,0,4
"cg21095379",1,0,0,0,1
"cg21095395",2,4,0,0,6
"cg21095610",33,5,0,0,38
"cg21095983",0,1,0,0,1
"cg21096591",0,0,3,0,3
"cg21096716",0,1,0,0,1
"cg21097091",375,67,2,0,444
"cg21097504",0,0,1,0,1
"cg21098892",1,0,0,0,1
"cg21099111",0,0,1,0,1
"cg21099718",12,6,5,0,23
"cg21100596",1,0,0,0,1
"cg21100690",2,0,0,0,2
"cg21101714",176,11,1,0,188
"cg21101750",1,0,1,0,2
"cg21101893",0,0,1,0,1
"cg21103668",0,1,0,0,1
"cg21103758",1,0,0,0,1
"cg21104892",1,0,0,0,1
"cg21104950",0,0,10,0,10
"cg21105577",1,1,0,0,2
"cg21106486",1,0,0,0,1
"cg21106946",0,1,0,0,1
"cg21107143",6,1,0,0,7
"cg21108999",1,0,0,0,1
"cg21109011",0,3,1,0,4
"cg21110089",10,4,0,0,14
"cg21110322",1,2,0,0,3
"cg21110825",1,0,0,0,1
"cg21110873",120,17,2,0,139
"cg21111301",14,8,0,0,22
"cg21112831",0,1,0,0,1
"cg21113094",127,114,19,0,260
"cg21114004",0,1,0,0,1
"cg21114049",4,3,0,0,7
"cg21116334",7,19,11,0,37
"cg21117368",28,20,1,0,49
"cg21117728",0,0,1,0,1
"cg21118250",6,1,0,0,7
"cg21118881",20,0,0,0,20
"cg21120458",0,0,1,0,1
"cg21121943",0,0,1,0,1
"cg21122605",7,3,0,0,10
"cg21123299",0,0,1,0,1
"cg21125207",0,0,1,0,1
"cg21125709",2,0,0,0,2
"cg21126035",0,1,0,0,1
"cg21126118",121,2,0,0,123
"cg21126306",248,168,10,0,426
"cg21127134",0,0,3,0,3
"cg21128600",0,0,6,0,6
"cg21129115",2,5,0,0,7
"cg21131402",1,0,0,0,1
"cg21132114",1,1,0,0,2
"cg21132759",11,0,0,0,11
"cg21133266",0,0,5,0,5
"cg21134501",5,0,1,0,6
"cg21137289",364,213,31,0,608
"cg21137501",0,0,1,0,1
"cg21137983",6,1,0,0,7
"cg21139063",1,0,1,0,2
"cg21139564",3,0,0,0,3
"cg21139941",112,63,0,0,175
"cg21140633",0,0,1,0,1
"cg21141026",0,1,1,0,2
"cg21141034",1,2,16,0,19
"cg21141470",2,1,0,0,3
"cg21141827",0,1,0,0,1
"cg21141980",0,2,5,0,7
"cg21142000",0,0,1,0,1
"cg21144274",1,0,0,0,1
"cg21144587",0,1,0,0,1
"cg21144882",6,0,0,0,6
"cg21147167",254,364,46,0,664
"cg21149921",0,1,0,0,1
"cg21150992",2,0,0,0,2
"cg21151200",57,250,18,0,325
"cg21152173",2,0,0,0,2
"cg21152316",2,0,0,0,2
"cg21152376",3,0,0,1,4
"cg21152476",2,2,0,0,4
"cg21152485",1,0,0,0,1
"cg21153204",3,9,13,0,25
"cg21153622",3,1,2,0,6
"cg21154304",0,0,1,0,1
"cg21156200",6,17,9,0,32
"cg21156702",43,0,0,0,43
"cg21156776",1,1,0,0,2
"cg21156936",1,0,0,0,1
"cg21157094",0,0,1,0,1
"cg21157301",9,14,0,0,23
"cg21158501",0,0,3,0,3
"cg21158526",5,7,2,0,14
"cg21158551",3,7,0,0,10
"cg21158561",1,0,2,0,3
"cg21160516",211,43,0,0,254
"cg21160562",45,37,2,0,84
"cg21160877",1,3,17,0,21
"cg21161173",0,0,1,0,1
"cg21162351",0,2,1,0,3
"cg21163262",3,9,6,0,18
"cg21163765",0,0,1,0,1
"cg21164410",0,1,0,0,1
"cg21164640",0,0,1,0,1
"cg21165045",0,1,0,0,1
"cg21165122",0,1,0,0,1
"cg21165224",0,0,1,0,1
"cg21165567",2,0,0,0,2
"cg21165641",0,1,0,0,1
"cg21166047",0,3,0,0,3
"cg21166143",2,0,0,0,2
"cg21166544",0,0,1,0,1
"cg21167453",0,1,0,0,1
"cg21168458",2,0,0,0,2
"cg21169995",116,337,60,0,513
"cg21170820",2,0,0,0,2
"cg21171639",0,1,0,0,1
"cg21171800",0,0,1,0,1
"cg21172962",0,0,2,0,2
"cg21173157",1,0,0,0,1
"cg21173221",0,1,0,0,1
"cg21173489",0,0,1,0,1
"cg21173642",1,0,0,0,1
"cg21173805",0,0,0,1,1
"cg21174114",0,0,1,0,1
"cg21175676",1,1,6,0,8
"cg21177063",17,21,4,0,42
"cg21177064",1,0,0,0,1
"cg21177257",3,0,0,0,3
"cg21177713",132,28,4,0,164
"cg21178143",0,0,1,0,1
"cg21179412",4,8,2,0,14
"cg21180923",1,0,0,0,1
"cg21184204",3,0,0,0,3
"cg21184257",0,0,14,0,14
"cg21184806",4,1,0,0,5
"cg21185154",43,1,0,0,44
"cg21185936",0,1,1,0,2
"cg21186888",1,0,0,0,1
"cg21187554",0,1,2,0,3
"cg21187898",0,0,1,0,1
"cg21188233",0,1,0,0,1
"cg21188507",1,0,0,0,1
"cg21188989",1,0,0,0,1
"cg21189010",3,0,0,0,3
"cg21189019",2,1,2,0,5
"cg21189477",5,0,0,0,5
"cg21190145",8,11,0,0,19
"cg21191508",2,0,0,0,2
"cg21192238",1,0,0,0,1
"cg21192452",19,0,0,0,19
"cg21192905",1,0,0,0,1
"cg21193212",0,1,0,0,1
"cg21193813",5,5,5,0,15
"cg21194341",0,0,2,0,2
"cg21194454",0,4,3,0,7
"cg21194765",0,1,0,0,1
"cg21195535",0,1,0,0,1
"cg21196034",0,5,0,0,5
"cg21196136",14,0,4,0,18
"cg21196597",0,12,3,0,15
"cg21197232",13,12,15,0,40
"cg21197363",0,0,1,0,1
"cg21197371",446,25,11,0,482
"cg21197685",0,1,0,0,1
"cg21199120",0,0,5,0,5
"cg21199346",1,0,0,0,1
"cg21200515",0,1,1,0,2
"cg21200735",0,1,1,0,2
"cg21201844",1,0,0,0,1
"cg21202732",0,0,2,0,2
"cg21203956",1,0,0,0,1
"cg21203984",2,0,0,0,2
"cg21203998",0,2,0,0,2
"cg21206180",0,0,1,0,1
"cg21206234",0,0,1,0,1
"cg21206915",0,2,1,0,3
"cg21207498",5,0,0,0,5
"cg21207699",0,5,0,0,5
"cg21209113",5,1,0,0,6
"cg21209282",3,3,0,0,6
"cg21209629",216,350,16,0,582
"cg21211299",2,0,0,0,2
"cg21211680",0,0,13,0,13
"cg21212014",34,4,0,0,38
"cg21212624",0,1,0,0,1
"cg21212977",83,1,1,0,85
"cg21213306",0,0,1,0,1
"cg21214232",0,1,0,0,1
"cg21214300",8,3,2,0,13
"cg21214449",0,0,2,0,2
"cg21214969",11,2,0,0,13
"cg21215961",0,0,1,0,1
"cg21216010",0,1,0,0,1
"cg21216606",0,1,0,0,1
"cg21218646",22,4,0,0,26
"cg21219692",0,0,1,0,1
"cg21219864",0,1,0,0,1
"cg21220536",0,1,0,0,1
"cg21220623",0,1,0,0,1
"cg21220873",0,0,1,1,2
"cg21221511",0,1,0,0,1
"cg21221785",1,0,0,0,1
"cg21221891",0,0,1,0,1
"cg21222110",63,5,1,0,69
"cg21224349",6,9,1,0,16
"cg21226843",1,1,0,0,2
"cg21227060",1,0,0,0,1
"cg21227085",0,0,1,0,1
"cg21228075",38,2,0,0,40
"cg21228642",9,0,0,0,9
"cg21228792",0,1,1,0,2
"cg21229135",0,0,1,0,1
"cg21229901",0,1,0,0,1
"cg21230425",0,0,1,0,1
"cg21230578",0,2,0,0,2
"cg21231853",190,9,0,0,199
"cg21232397",0,1,0,0,1
"cg21232490",0,2,0,0,2
"cg21232879",5,0,0,0,5
"cg21233252",43,12,0,0,55
"cg21235025",5,1,6,0,12
"cg21235179",3,1,1,0,5
"cg21235359",1,0,0,0,1
"cg21236090",5,7,0,0,12
"cg21236663",68,44,19,0,131
"cg21237037",0,0,1,0,1
"cg21238516",0,0,2,0,2
"cg21239378",0,2,1,0,3
"cg21240283",7,1,0,0,8
"cg21240551",0,0,1,0,1
"cg21240954",0,1,0,0,1
"cg21240990",0,1,0,0,1
"cg21241389",1,3,19,0,23
"cg21242584",1,0,0,0,1
"cg21243031",3,1,2,0,6
"cg21243143",10,1,0,0,11
"cg21244253",0,0,1,0,1
"cg21244845",109,8,0,0,117
"cg21245719",1,0,0,0,1
"cg21246325",0,1,0,0,1
"cg21246490",1,0,0,0,1
"cg21246673",1,0,0,0,1
"cg21247263",1,0,0,0,1
"cg21249582",9,0,0,0,9
"cg21251344",1,5,22,0,28
"cg21251452",1,2,0,0,3
"cg21252148",1,0,0,0,1
"cg21252906",6,7,1,0,14
"cg21253474",2,0,0,0,2
"cg21253551",3,0,4,0,7
"cg21254605",0,0,1,0,1
"cg21254778",0,1,0,0,1
"cg21254796",403,550,12,0,965
"cg21255826",12,0,0,0,12
"cg21257081",1,0,0,0,1
"cg21257293",3,1,0,0,4
"cg21258001",0,1,0,0,1
"cg21258305",1,0,0,0,1
"cg21260118",0,1,1,0,2
"cg21262907",132,11,0,0,143
"cg21265404",449,6,1,0,456
"cg21267113",0,0,1,0,1
"cg21267232",4,1,0,0,5
"cg21269045",1,0,0,0,1
"cg21269893",0,1,0,0,1
"cg21273787",2,0,0,0,2
"cg21274067",4,0,0,0,4
"cg21278164",0,0,1,0,1
"cg21278370",10,7,1,0,18
"cg21278796",2,0,0,0,2
"cg21279155",7,0,0,0,7
"cg21279613",0,1,0,0,1
"cg21279826",1,0,3,0,4
"cg21279865",0,2,0,0,2
"cg21280976",1,0,0,0,1
"cg21282076",1,0,0,0,1
"cg21282669",335,30,0,0,365
"cg21282998",694,92,0,0,786
"cg21286015",1,0,0,0,1
"cg21286416",0,1,4,0,5
"cg21286768",2,0,0,0,2
"cg21286921",0,1,0,0,1
"cg21288207",3,1,1,0,5
"cg21288259",1,0,0,0,1
"cg21288414",1,0,1,0,2
"cg21289365",1,1,2,0,4
"cg21289995",130,129,19,0,278
"cg21292012",0,6,0,0,6
"cg21292912",0,1,0,0,1
"cg21293013",0,1,1,0,2
"cg21293091",1,1,0,0,2
"cg21294714",0,0,1,0,1
"cg21295209",2,1,1,0,4
"cg21295398",2,1,0,0,3
"cg21296675",2,0,2,0,4
"cg21296878",0,0,1,0,1
"cg21301391",0,0,1,0,1
"cg21301499",0,0,1,0,1
"cg21301655",0,0,2,0,2
"cg21302407",0,4,0,0,4
"cg21304367",0,0,1,0,1
"cg21304498",4,0,0,0,4
"cg21304871",2,0,0,0,2
"cg21305475",0,0,4,0,4
"cg21307126",0,0,2,0,2
"cg21307374",104,40,4,0,148
"cg21307424",0,1,0,0,1
"cg21307775",0,0,1,0,1
"cg21308011",1,0,0,0,1
"cg21308919",2,4,3,0,9
"cg21309582",1,0,0,0,1
"cg21310034",5,0,0,0,5
"cg21311223",1,0,0,0,1
"cg21311292",0,1,0,0,1
"cg21311952",0,1,0,0,1
"cg21312281",67,6,0,0,73
"cg21312337",1,0,0,0,1
"cg21314304",891,74,3,0,968
"cg21314471",1,0,0,0,1
"cg21314662",1,0,0,0,1
"cg21314978",4,0,0,0,4
"cg21318547",0,0,3,0,3
"cg21319613",1,0,0,0,1
"cg21319686",0,1,1,0,2
"cg21320945",0,0,2,0,2
"cg21321814",1,0,0,0,1
"cg21323738",1,1,0,0,2
"cg21323836",1,1,0,0,2
"cg21323993",0,1,1,0,2
"cg21325941",0,0,7,0,7
"cg21329307",2,0,0,0,2
"cg21330088",339,904,57,0,1300
"cg21330577",0,0,1,0,1
"cg21331290",3,1,0,0,4
"cg21331545",0,0,1,0,1
"cg21332426",1,1,0,0,2
"cg21333026",2,0,0,0,2
"cg21333147",1,0,0,0,1
"cg21335375",0,2,0,0,2
"cg21335826",0,1,3,0,4
"cg21336581",0,1,0,0,1
"cg21338240",8,0,1,0,9
"cg21339555",2,7,0,0,9
"cg21340093",19,5,0,0,24
"cg21341170",1,0,0,0,1
"cg21341517",0,0,0,1,1
"cg21342276",3,1,3,0,7
"cg21343223",4,3,1,0,8
"cg21343859",341,19,0,0,360
"cg21344200",15,0,0,0,15
"cg21346031",0,0,1,0,1
"cg21346063",0,0,2,0,2
"cg21346925",0,1,0,0,1
"cg21347444",0,0,1,0,1
"cg21347729",1,0,0,0,1
"cg21348937",1,0,0,0,1
"cg21349901",1,5,14,0,20
"cg21350073",1,0,1,0,2
"cg21350691",0,0,1,0,1
"cg21350697",4,0,0,0,4
"cg21350892",15,0,0,0,15
"cg21351140",2,0,0,0,2
"cg21351873",0,1,0,0,1
"cg21352393",142,10,1,0,153
"cg21354397",0,0,1,0,1
"cg21355042",0,0,1,0,1
"cg21355338",9,0,0,0,9
"cg21357536",5,0,0,0,5
"cg21357729",1,0,0,0,1
"cg21358429",50,44,0,0,94
"cg21361342",0,1,0,0,1
"cg21364782",8,10,5,0,23
"cg21364806",0,0,1,0,1
"cg21365496",0,0,0,1,1
"cg21367580",1,0,0,0,1
"cg21368154",4,1,1,0,6
"cg21368429",1,0,1,0,2
"cg21368526",2,0,1,0,3
"cg21372672",0,0,2,0,2
"cg21373616",15,7,3,0,25
"cg21374276",11,0,0,0,11
"cg21376120",0,0,1,0,1
"cg21376133",678,27,0,0,705
"cg21376570",0,1,0,0,1
"cg21377260",1,0,0,0,1
"cg21377396",0,1,0,0,1
"cg21377518",3,0,0,0,3
"cg21377680",3,1,4,0,8
"cg21379666",2,0,0,0,2
"cg21379682",2,0,0,0,2
"cg21381395",34,15,0,0,49
"cg21381909",0,0,1,0,1
"cg21382564",3,0,0,0,3
"cg21382720",2,0,1,0,3
"cg21382847",19,0,0,0,19
"cg21383220",0,1,0,0,1
"cg21385304",6,1,0,0,7
"cg21385411",111,445,10,0,566
"cg21385522",1,2,0,0,3
"cg21385615",0,1,6,0,7
"cg21386687",1,0,0,0,1
"cg21386904",1,1,0,0,2
"cg21387117",43,49,24,0,116
"cg21389924",4,2,1,0,7
"cg21391659",3,6,0,0,9
"cg21391668",0,4,0,0,4
"cg21391861",1,0,0,0,1
"cg21392229",0,0,1,0,1
"cg21392893",0,0,1,0,1
"cg21393149",1,0,0,0,1
"cg21393387",0,2,3,0,5
"cg21393587",0,0,3,0,3
"cg21395158",0,1,0,0,1
"cg21395198",21,18,3,0,42
"cg21395384",2,2,0,0,4
"cg21395626",636,23,0,0,659
"cg21396553",540,34,1,0,575
"cg21396558",5,2,3,0,10
"cg21397124",274,270,13,0,557
"cg21398071",0,1,0,0,1
"cg21398435",1,0,0,0,1
"cg21399118",6,0,0,0,6
"cg21399320",237,16,0,0,253
"cg21399385",345,82,5,0,432
"cg21399445",2,2,0,0,4
"cg21399992",1,1,0,0,2
"cg21401546",0,3,0,0,3
"cg21401740",5,0,0,0,5
"cg21402453",0,0,2,0,2
"cg21403543",0,0,1,0,1
"cg21404851",0,0,3,0,3
"cg21404933",1,0,0,0,1
"cg21405394",4,3,0,0,7
"cg21406063",0,0,1,0,1
"cg21406548",3,5,9,0,17
"cg21406566",1,0,0,0,1
"cg21406606",1,0,0,0,1
"cg21409857",2,0,0,0,2
"cg21410132",0,1,0,0,1
"cg21412054",1,0,0,0,1
"cg21412084",1,1,0,0,2
"cg21414336",1,1,0,0,2
"cg21415219",0,1,0,0,1
"cg21415604",1,0,0,0,1
"cg21415708",0,0,1,0,1
"cg21417030",5,0,1,0,6
"cg21418044",0,0,1,0,1
"cg21419689",2,1,0,0,3
"cg21420109",0,0,1,0,1
"cg21420272",0,0,1,0,1
"cg21420896",0,0,0,1,1
"cg21422650",0,3,0,0,3
"cg21422834",0,0,1,0,1
"cg21423610",6,1,2,0,9
"cg21424595",0,0,1,0,1
"cg21425513",0,1,0,0,1
"cg21425723",19,0,0,0,19
"cg21426897",1,0,0,0,1
"cg21428095",1,0,0,0,1
"cg21428628",0,1,0,0,1
"cg21428733",0,0,2,0,2
"cg21428908",5,0,0,0,5
"cg21429173",0,0,1,0,1
"cg21429728",3,0,0,0,3
"cg21429780",0,1,0,0,1
"cg21430464",734,703,13,0,1450
"cg21431525",1,0,0,0,1
"cg21432745",0,0,1,0,1
"cg21433332",1,0,6,0,7
"cg21433933",34,3,0,0,37
"cg21434402",1,2,0,0,3
"cg21434886",1,0,0,0,1
"cg21435360",338,113,2,0,453
"cg21437119",0,0,1,0,1
"cg21437470",0,1,1,0,2
"cg21437865",0,1,1,0,2
"cg21438681",0,0,0,1,1
"cg21438754",0,0,1,0,1
"cg21439880",0,1,0,0,1
"cg21441256",5,1,0,0,6
"cg21441716",151,7,1,0,159
"cg21443284",0,2,0,0,2
"cg21443531",0,0,1,0,1
"cg21444484",8,0,0,0,8
"cg21445553",1,6,0,0,7
"cg21445913",9,4,1,0,14
"cg21446455",0,0,4,0,4
"cg21447147",0,2,1,0,3
"cg21447170",12,3,0,0,15
"cg21448033",1,0,0,0,1
"cg21448741",0,1,0,0,1
"cg21448781",17,1,0,0,18
"cg21449352",1,0,0,0,1
"cg21450700",0,3,1,0,4
"cg21451110",0,0,0,1,1
"cg21451455",1,0,0,0,1
"cg21452025",0,0,1,0,1
"cg21453409",0,0,1,0,1
"cg21456916",4,0,0,0,4
"cg21457541",1,0,0,0,1
"cg21458030",1,0,0,0,1
"cg21460946",726,442,8,0,1176
"cg21461033",1,0,0,0,1
"cg21462477",0,1,0,0,1
"cg21462999",0,0,2,0,2
"cg21464102",0,0,1,0,1
"cg21464596",29,11,0,0,40
"cg21464698",3,0,0,0,3
"cg21465252",7,5,3,0,15
"cg21466043",1,0,0,0,1
"cg21467371",0,1,0,0,1
"cg21467828",0,1,0,0,1
"cg21469153",816,717,17,0,1550
"cg21471053",0,0,8,0,8
"cg21472059",0,1,0,0,1
"cg21472198",1,0,0,0,1
"cg21473147",0,2,0,0,2
"cg21474022",0,0,1,0,1
"cg21474095",0,0,1,0,1
"cg21475963",1,2,2,0,5
"cg21476536",0,2,0,0,2
"cg21476837",12,0,0,0,12
"cg21478609",39,3,0,0,42
"cg21479762",0,1,15,0,16
"cg21480165",0,0,1,0,1
"cg21480902",9,1,0,0,10
"cg21481021",11,4,0,0,15
"cg21482019",2,12,11,0,25
"cg21482074",0,0,5,0,5
"cg21482217",0,1,0,0,1
"cg21482377",0,0,1,0,1
"cg21483539",22,2,0,0,24
"cg21483702",236,217,11,0,464
"cg21483735",236,51,5,0,292
"cg21484512",1,1,2,0,4
"cg21485150",2,0,0,0,2
"cg21485906",0,0,2,0,2
"cg21486195",0,0,1,0,1
"cg21486712",0,0,1,0,1
"cg21487447",0,1,5,0,6
"cg21487894",0,0,1,0,1
"cg21488555",0,1,0,0,1
"cg21489692",619,55,0,0,674
"cg21491308",0,3,1,0,4
"cg21491365",0,0,1,0,1
"cg21493212",0,0,1,0,1
"cg21496672",84,23,5,0,112
"cg21496761",0,0,1,0,1
"cg21496831",1,0,0,0,1
"cg21497739",0,0,2,0,2
"cg21499006",0,0,1,0,1
"cg21499467",1,0,0,0,1
"cg21499895",0,0,2,0,2
"cg21500063",0,1,2,0,3
"cg21500456",0,0,1,0,1
"cg21500549",41,3,0,0,44
"cg21501096",29,27,4,0,60
"cg21501436",4,1,0,0,5
"cg21502629",0,0,14,0,14
"cg21502663",1,0,0,0,1
"cg21502695",243,28,0,0,271
"cg21503330",1,0,0,0,1
"cg21503619",1,0,0,0,1
"cg21504815",0,0,1,0,1
"cg21505015",1,0,0,0,1
"cg21507636",56,26,0,0,82
"cg21509645",0,1,0,0,1
"cg21509846",0,1,0,0,1
"cg21509901",0,0,1,0,1
"cg21510284",2,1,0,0,3
"cg21511056",0,1,0,0,1
"cg21511395",0,0,1,0,1
"cg21511748",87,22,0,0,109
"cg21511979",2,1,0,0,3
"cg21512599",11,2,0,0,13
"cg21514834",0,1,0,0,1
"cg21515494",2,1,0,0,3
"cg21515879",0,2,0,0,2
"cg21516353",101,357,1,0,459
"cg21516666",0,1,0,0,1
"cg21518248",0,1,0,0,1
"cg21518287",22,38,0,0,60
"cg21518654",1,0,0,0,1
"cg21518746",0,0,1,0,1
"cg21518974",5,4,0,0,9
"cg21520564",0,0,1,0,1
"cg21520684",1,1,0,0,2
"cg21520950",0,0,1,0,1
"cg21521779",1,0,0,0,1
"cg21522932",0,1,0,0,1
"cg21523701",0,1,0,0,1
"cg21524199",11,0,0,0,11
"cg21524356",0,1,0,0,1
"cg21524398",2,1,0,0,3
"cg21525092",1,0,0,0,1
"cg21525314",0,1,0,0,1
"cg21527724",4,2,1,0,7
"cg21528040",1,0,0,0,1
"cg21530621",0,1,0,0,1
"cg21531444",0,0,1,0,1
"cg21532236",12,5,1,0,18
"cg21532334",4,0,0,0,4
"cg21533303",0,0,1,0,1
"cg21533964",1,0,0,0,1
"cg21533977",1,2,1,0,4
"cg21534309",1,1,0,0,2
"cg21535199",3,0,1,0,4
"cg21535222",20,7,6,0,33
"cg21535871",0,0,0,2,2
"cg21535976",1,0,0,0,1
"cg21537122",21,0,0,0,21
"cg21537212",1,5,0,0,6
"cg21537459",0,1,1,0,2
"cg21537939",2,0,0,0,2
"cg21538190",0,1,0,0,1
"cg21538259",1,1,0,0,2
"cg21538355",2,0,0,0,2
"cg21539907",0,1,0,0,1
"cg21540266",0,0,0,1,1
"cg21540460",4,20,0,0,24
"cg21540970",9,1,0,0,10
"cg21541272",1,1,0,0,2
"cg21542652",6,1,0,0,7
"cg21542951",0,2,0,1,3
"cg21543081",0,0,1,0,1
"cg21543123",12,4,1,0,17
"cg21543489",485,238,6,0,729
"cg21543640",5,10,1,0,16
"cg21543899",1,0,0,0,1
"cg21544075",4,0,0,0,4
"cg21544702",395,16,0,0,411
"cg21544818",0,0,1,0,1
"cg21545052",1,1,0,0,2
"cg21545611",0,1,0,0,1
"cg21546286",2,4,1,0,7
"cg21546996",0,1,0,0,1
"cg21547594",10,3,1,0,14
"cg21547845",37,1,0,0,38
"cg21548955",3,0,0,0,3
"cg21549011",0,0,0,1,1
"cg21549457",0,0,1,0,1
"cg21550006",0,0,1,0,1
"cg21550165",0,1,0,0,1
"cg21550279",0,0,1,0,1
"cg21554399",0,1,2,0,3
"cg21555435",0,3,0,0,3
"cg21555793",215,9,0,0,224
"cg21558614",3,1,1,0,5
"cg21558706",15,5,1,0,21
"cg21559013",0,0,1,0,1
"cg21559117",10,21,1,0,32
"cg21559154",2,0,0,0,2
"cg21559755",141,7,0,0,148
"cg21561392",0,0,6,0,6
"cg21562186",0,0,1,0,1
"cg21564217",8,2,1,0,11
"cg21565781",0,0,2,0,2
"cg21565802",7,0,0,0,7
"cg21567090",1,1,1,0,3
"cg21567298",626,23,1,0,650
"cg21567404",0,1,1,0,2
"cg21567831",0,3,0,0,3
"cg21570062",0,1,0,0,1
"cg21570182",4,1,0,0,5
"cg21570277",292,16,0,0,308
"cg21570431",0,0,1,0,1
"cg21570493",11,2,0,0,13
"cg21571245",4,12,8,0,24
"cg21572730",5,0,0,0,5
"cg21572997",0,1,0,0,1
"cg21574582",1,0,0,0,1
"cg21574864",0,0,1,0,1
"cg21576151",0,0,3,0,3
"cg21576555",0,1,0,0,1
"cg21577036",7,0,0,0,7
"cg21577639",19,2,0,0,21
"cg21578424",2,0,0,0,2
"cg21578783",2,0,0,0,2
"cg21579415",3,0,0,0,3
"cg21581088",5,0,0,0,5
"cg21581381",0,0,4,0,4
"cg21581567",1,0,0,0,1
"cg21581855",0,0,1,0,1
"cg21582633",1,5,0,0,6
"cg21582695",0,0,1,0,1
"cg21583400",11,0,0,0,11
"cg21583727",174,447,128,0,749
"cg21583961",0,1,0,0,1
"cg21584251",0,0,2,0,2
"cg21584823",29,17,7,0,53
"cg21585068",68,8,0,0,76
"cg21585627",1,0,0,0,1
"cg21585671",11,2,0,0,13
"cg21585845",2,0,0,0,2
"cg21587709",2,13,3,0,18
"cg21589460",16,18,15,0,49
"cg21590497",2,1,0,0,3
"cg21591553",1,0,0,0,1
"cg21593628",0,1,0,0,1
"cg21594014",5,0,0,0,5
"cg21594343",0,0,1,0,1
"cg21594541",0,1,0,0,1
"cg21594642",0,0,1,0,1
"cg21595240",1,1,0,0,2
"cg21599215",1,0,0,0,1
"cg21599794",92,4,2,0,98
"cg21600678",1,0,0,0,1
"cg21603421",1,0,0,0,1
"cg21603563",253,212,0,0,465
"cg21603676",10,1,0,0,11
"cg21604464",0,0,1,0,1
"cg21604601",0,1,0,0,1
"cg21604697",6,1,0,0,7
"cg21604726",2,0,0,0,2
"cg21605271",2,7,3,0,12
"cg21605512",0,1,0,0,1
"cg21605731",0,0,6,0,6
"cg21606168",3,0,0,0,3
"cg21606202",0,0,6,0,6
"cg21606744",98,55,11,0,164
"cg21608022",1,0,0,0,1
"cg21610164",8,1,0,0,9
"cg21610999",0,3,0,0,3
"cg21613662",0,1,0,0,1
"cg21615898",0,0,1,0,1
"cg21616720",15,2,0,0,17
"cg21617916",9,1,0,0,10
"cg21618418",0,1,10,0,11
"cg21618529",22,4,0,0,26
"cg21618548",0,1,0,0,1
"cg21618694",41,2,0,0,43
"cg21618718",10,1,0,0,11
"cg21618784",415,103,2,0,520
"cg21619773",1,0,0,0,1
"cg21619881",1,0,0,0,1
"cg21619883",0,3,0,0,3
"cg21622831",0,1,0,0,1
"cg21623115",1,0,0,0,1
"cg21623175",0,0,3,0,3
"cg21623633",0,1,0,0,1
"cg21623841",0,1,0,0,1
"cg21625829",0,0,1,0,1
"cg21626820",0,0,1,0,1
"cg21626986",7,8,2,0,17
"cg21629657",0,5,1,0,6
"cg21629842",0,2,0,0,2
"cg21631409",14,2,0,0,16
"cg21632117",744,212,3,0,959
"cg21632181",3,0,0,0,3
"cg21632230",2,0,1,0,3
"cg21634242",3,1,1,0,5
"cg21634818",0,2,1,0,3
"cg21637172",42,3,0,0,45
"cg21637776",0,0,3,0,3
"cg21638094",1,0,1,0,2
"cg21639435",0,0,1,0,1
"cg21639553",0,1,0,0,1
"cg21639675",1,15,9,0,25
"cg21640261",0,0,1,0,1
"cg21640931",0,0,1,0,1
"cg21642229",32,5,0,0,37
"cg21642251",7,0,0,0,7
"cg21642396",1,1,0,0,2
"cg21643265",1,0,0,0,1
"cg21643429",1,0,0,0,1
"cg21643513",45,71,0,0,116
"cg21644611",0,0,1,0,1
"cg21644732",0,1,0,0,1
"cg21644830",1,0,0,0,1
"cg21645762",0,1,0,0,1
"cg21646060",1,1,1,0,3
"cg21649761",4,1,0,0,5
"cg21652771",191,120,28,0,339
"cg21653586",0,1,3,0,4
"cg21653804",81,3,0,0,84
"cg21655448",27,0,0,0,27
"cg21656108",2,0,0,0,2
"cg21659206",0,0,1,0,1
"cg21659572",2,0,0,0,2
"cg21660040",0,1,0,0,1
"cg21660300",125,355,17,0,497
"cg21662478",1,1,0,0,2
"cg21662491",1,2,1,0,4
"cg21662836",1,0,1,0,2
"cg21664388",0,0,1,0,1
"cg21664781",9,0,1,0,10
"cg21665151",0,1,0,0,1
"cg21665448",0,1,1,0,2
"cg21665502",0,0,2,0,2
"cg21665599",0,0,1,0,1
"cg21665869",592,632,27,0,1251
"cg21666957",0,1,3,0,4
"cg21667069",1,0,0,0,1
"cg21667498",6,1,0,0,7
"cg21668231",2,4,3,0,9
"cg21669037",1,2,1,0,4
"cg21670599",1,0,0,0,1
"cg21672379",1,0,0,0,1
"cg21672468",1,0,0,0,1
"cg21673175",1,1,0,0,2
"cg21673929",784,70,2,0,856
"cg21674418",8,1,0,0,9
"cg21676005",0,0,1,0,1
"cg21677594",100,280,216,0,596
"cg21679039",4,0,0,0,4
"cg21679098",1,0,0,0,1
"cg21680896",0,0,1,0,1
"cg21683154",3,0,0,0,3
"cg21683159",2,0,0,0,2
"cg21683927",30,3,0,0,33
"cg21684505",0,1,1,0,2
"cg21685195",25,7,0,0,32
"cg21685775",0,1,0,0,1
"cg21688533",0,1,0,0,1
"cg21688634",177,65,7,0,249
"cg21689824",7,6,0,0,13
"cg21690675",1,0,0,0,1
"cg21691893",0,2,0,0,2
"cg21692666",1,0,0,0,1
"cg21694626",286,6,2,0,294
"cg21695436",16,15,4,0,35
"cg21696256",7,0,0,0,7
"cg21698879",2,0,0,0,2
"cg21700293",0,1,0,0,1
"cg21700582",1,0,0,0,1
"cg21700863",0,0,1,0,1
"cg21704267",0,1,0,0,1
"cg21704788",0,0,1,0,1
"cg21705506",0,1,0,0,1
"cg21705625",1,0,0,0,1
"cg21707131",0,0,1,0,1
"cg21707816",120,12,0,0,132
"cg21708890",0,1,0,0,1
"cg21709671",1,0,0,0,1
"cg21710992",0,1,1,0,2
"cg21711554",2,4,0,0,6
"cg21712038",1,0,0,0,1
"cg21712790",88,24,1,0,113
"cg21713780",1,0,0,0,1
"cg21720236",109,22,2,0,133
"cg21720265",0,1,0,0,1
"cg21720268",6,0,0,0,6
"cg21720373",0,1,1,0,2
"cg21720618",1,1,0,0,2
"cg21720999",152,183,48,0,383
"cg21722795",0,2,0,0,2
"cg21723246",82,72,8,0,162
"cg21723382",1,0,0,0,1
"cg21724658",1,0,0,0,1
"cg21726325",66,241,2,0,309
"cg21727470",0,1,0,0,1
"cg21727574",1,0,0,0,1
"cg21727899",0,0,2,0,2
"cg21727907",0,0,2,0,2
"cg21728840",0,1,0,0,1
"cg21733973",0,1,0,0,1
"cg21734168",1,0,0,0,1
"cg21734318",10,0,0,0,10
"cg21735128",0,1,0,0,1
"cg21735530",0,0,2,0,2
"cg21735670",0,0,1,0,1
"cg21735676",0,0,1,0,1
"cg21736089",1,1,0,0,2
"cg21736205",0,1,0,0,1
"cg21736597",0,4,4,0,8
"cg21737665",0,0,1,0,1
"cg21738631",6,2,0,0,8
"cg21739681",1,0,0,0,1
"cg21741198",0,1,0,0,1
"cg21741858",0,1,0,0,1
"cg21742060",0,0,1,0,1
"cg21742585",3,12,0,0,15
"cg21743929",0,0,1,0,1
"cg21744965",0,0,1,0,1
"cg21745599",1,0,0,0,1
"cg21747188",0,1,0,0,1
"cg21747405",2,4,10,0,16
"cg21747842",1,1,0,0,2
"cg21748578",2,1,0,0,3
"cg21749317",0,0,1,0,1
"cg21749456",0,0,7,0,7
"cg21751739",0,0,1,0,1
"cg21752292",1,1,0,0,2
"cg21752357",0,1,1,0,2
"cg21752889",4,0,0,0,4
"cg21754343",1,0,0,0,1
"cg21755396",22,2,0,0,24
"cg21755487",5,0,0,0,5
"cg21757392",11,0,0,0,11
"cg21757988",1,1,0,0,2
"cg21758171",0,1,0,0,1
"cg21759734",1,0,1,0,2
"cg21760302",0,0,1,0,1
"cg21761171",1,0,0,0,1
"cg21762236",60,21,2,0,83
"cg21763723",0,1,0,0,1
"cg21763814",0,0,4,0,4
"cg21765440",2,0,0,0,2
"cg21765753",55,4,1,0,60
"cg21766145",0,0,1,0,1
"cg21766651",4,0,0,0,4
"cg21767461",3,1,0,0,4
"cg21769640",2,0,0,0,2
"cg21771408",0,0,1,0,1
"cg21771528",1,1,0,0,2
"cg21774397",0,2,0,0,2
"cg21775122",0,0,1,0,1
"cg21776678",1,1,0,0,2
"cg21777364",0,0,1,0,1
"cg21777602",0,0,3,0,3
"cg21777866",0,0,2,0,2
"cg21779247",1,0,0,0,1
"cg21780154",339,42,11,0,392
"cg21780796",1,0,0,0,1
"cg21781085",2,0,0,0,2
"cg21782998",0,1,0,0,1
"cg21783156",265,247,7,0,519
"cg21783223",0,1,0,0,1
"cg21784030",24,2,0,0,26
"cg21784859",3,12,2,0,17
"cg21785102",1,0,0,0,1
"cg21786227",0,0,4,0,4
"cg21787303",227,97,2,0,326
"cg21787489",15,8,6,0,29
"cg21788878",24,0,0,0,24
"cg21789181",0,1,0,0,1
"cg21789440",1,0,0,0,1
"cg21789510",0,0,1,0,1
"cg21790818",0,0,1,0,1
"cg21791083",1,0,0,0,1
"cg21793044",317,10,0,0,327
"cg21794008",0,0,2,0,2
"cg21794066",4,2,1,0,7
"cg21795914",0,0,2,0,2
"cg21796313",19,3,1,0,23
"cg21796765",2,8,0,0,10
"cg21797046",10,2,0,0,12
"cg21797739",0,0,3,1,4
"cg21797898",0,1,0,0,1
"cg21797973",88,6,0,0,94
"cg21800382",1,0,0,0,1
"cg21801085",310,228,31,0,569
"cg21802401",0,2,0,0,2
"cg21802687",2,0,0,0,2
"cg21803141",0,1,0,0,1
"cg21803661",8,0,0,0,8
"cg21803797",13,5,0,0,18
"cg21806233",0,0,1,0,1
"cg21806409",0,1,0,0,1
"cg21807253",360,57,2,0,419
"cg21807343",5,3,0,0,8
"cg21808131",62,3,0,0,65
"cg21808470",0,0,1,0,1
"cg21808937",0,0,1,0,1
"cg21809217",3,1,4,0,8
"cg21810664",1,1,1,0,3
"cg21811549",0,2,1,0,3
"cg21812211",1,0,0,0,1
"cg21814362",19,30,2,0,51
"cg21814615",26,27,4,0,57
"cg21815502",0,0,1,0,1
"cg21817935",0,0,1,0,1
"cg21822170",1,0,0,0,1
"cg21822711",1,0,0,0,1
"cg21823025",0,0,1,0,1
"cg21824770",0,0,1,0,1
"cg21825577",68,30,6,0,104
"cg21827221",689,82,1,0,772
"cg21828341",1,0,0,0,1
"cg21828751",9,4,0,0,13
"cg21829420",28,0,0,0,28
"cg21831587",0,0,1,0,1
"cg21832962",1,0,0,0,1
"cg21833728",0,1,0,0,1
"cg21835378",0,0,2,0,2
"cg21836827",1,0,0,0,1
"cg21837471",1,0,0,0,1
"cg21840035",1,1,0,0,2
"cg21840121",1,2,0,0,3
"cg21840672",223,35,1,0,259
"cg21842246",1,1,0,0,2
"cg21842731",0,0,1,0,1
"cg21843195",1,0,2,0,3
"cg21843262",0,0,1,0,1
"cg21844246",2,0,0,0,2
"cg21844331",0,0,1,0,1
"cg21844726",278,179,12,0,469
"cg21845373",1,0,0,0,1
"cg21846159",0,0,1,0,1
"cg21846669",0,0,1,0,1
"cg21847859",2,0,0,0,2
"cg21848066",182,416,10,0,608
"cg21848724",0,1,0,0,1
"cg21850429",18,2,0,0,20
"cg21852342",8,12,1,0,21
"cg21852905",0,0,1,0,1
"cg21852926",2,0,0,0,2
"cg21853198",157,34,4,0,195
"cg21853296",11,1,0,0,12
"cg21853836",0,1,7,0,8
"cg21856435",0,1,0,0,1
"cg21856771",0,1,0,0,1
"cg21857017",0,1,0,0,1
"cg21857146",11,3,9,0,23
"cg21858446",0,1,0,0,1
"cg21858856",2,0,0,0,2
"cg21858899",0,0,2,0,2
"cg21859000",6,0,0,0,6
"cg21860926",3,0,0,0,3
"cg21861403",0,0,1,0,1
"cg21862797",1,0,0,0,1
"cg21863826",1,0,0,0,1
"cg21863946",0,1,0,0,1
"cg21864026",2,5,2,0,9
"cg21864616",115,168,1,0,284
"cg21865923",0,0,1,0,1
"cg21866125",0,0,1,0,1
"cg21866431",2,0,0,0,2
"cg21866947",1,0,0,0,1
"cg21867608",1,0,0,0,1
"cg21867839",1,0,0,0,1
"cg21868502",2,0,0,0,2
"cg21868636",413,384,7,0,804
"cg21868699",1,3,5,0,9
"cg21869524",21,15,1,0,37
"cg21869646",1,1,0,0,2
"cg21870274",0,2,0,0,2
"cg21870518",2,3,0,0,5
"cg21870885",131,20,1,0,152
"cg21871203",297,20,1,0,318
"cg21872009",1,0,0,0,1
"cg21872428",4,0,0,0,4
"cg21872919",0,2,0,0,2
"cg21873524",0,0,0,1,1
"cg21873567",0,0,1,0,1
"cg21873858",0,1,0,0,1
"cg21874706",0,3,0,0,3
"cg21875216",1,0,0,0,1
"cg21877500",0,2,0,0,2
"cg21878211",1,0,0,0,1
"cg21879320",2,0,0,0,2
"cg21879761",5,2,1,0,8
"cg21880331",1,0,0,0,1
"cg21880422",11,2,0,0,13
"cg21882037",0,0,1,0,1
"cg21883115",0,1,0,0,1
"cg21884372",1,0,0,0,1
"cg21887309",3,2,0,0,5
"cg21887489",1,0,0,0,1
"cg21887581",0,0,0,1,1
"cg21889078",0,1,0,0,1
"cg21890592",0,0,1,0,1
"cg21890850",0,1,0,0,1
"cg21891745",0,0,1,0,1
"cg21892463",0,0,1,0,1
"cg21892758",0,1,0,0,1
"cg21893461",107,8,0,0,115
"cg21893651",1,1,0,0,2
"cg21893751",0,1,0,0,1
"cg21893931",0,0,1,0,1
"cg21894728",0,0,1,0,1
"cg21896661",0,0,1,0,1
"cg21897004",0,1,1,0,2
"cg21898280",1,0,0,0,1
"cg21900653",12,7,0,0,19
"cg21901361",650,98,4,0,752
"cg21902160",1,1,0,0,2
"cg21903079",0,0,1,0,1
"cg21904654",281,19,3,0,303
"cg21905627",1,0,0,0,1
"cg21906138",1,0,1,0,2
"cg21906539",0,0,1,0,1
"cg21906586",1,9,1,0,11
"cg21906644",123,4,0,0,127
"cg21908038",2,0,0,0,2
"cg21909192",0,0,2,0,2
"cg21909533",197,34,1,0,232
"cg21909733",0,1,1,0,2
"cg21909782",1,5,0,0,6
"cg21911100",1,0,0,0,1
"cg21911143",0,0,4,0,4
"cg21912197",0,0,1,0,1
"cg21913027",0,0,1,0,1
"cg21914477",1,0,0,0,1
"cg21915666",1,0,0,0,1
"cg21915917",0,0,0,1,1
"cg21915962",2,0,0,0,2
"cg21916358",0,0,0,2,2
"cg21917933",0,0,1,0,1
"cg21918105",1,0,0,0,1
"cg21920872",1,0,0,0,1
"cg21921584",0,0,1,0,1
"cg21922194",1,2,4,0,7
"cg21922214",0,1,0,0,1
"cg21922369",0,0,2,0,2
"cg21922416",1,0,0,0,1
"cg21925135",0,0,1,0,1
"cg21925503",0,0,1,0,1
"cg21928406",0,0,1,0,1
"cg21929784",2,0,0,0,2
"cg21930286",3,3,0,0,6
"cg21930842",0,1,0,0,1
"cg21930889",2,3,6,0,11
"cg21930968",5,16,5,0,26
"cg21931552",0,1,1,0,2
"cg21931864",1,0,1,0,2
"cg21932190",1,0,0,0,1
"cg21932343",1,2,0,0,3
"cg21932400",7,0,0,0,7
"cg21932466",56,2,0,0,58
"cg21932743",98,0,1,0,99
"cg21933197",263,93,2,0,358
"cg21934337",305,29,2,0,336
"cg21935503",0,1,0,0,1
"cg21936145",2,0,0,0,2
"cg21936261",1,0,0,0,1
"cg21937028",1,0,0,0,1
"cg21937152",16,9,0,0,25
"cg21937887",1,7,3,0,11
"cg21938694",1,2,5,0,8
"cg21939303",5,1,0,0,6
"cg21940339",5,2,0,0,7
"cg21941796",5,6,3,0,14
"cg21942701",1,0,2,0,3
"cg21944221",0,1,0,0,1
"cg21944701",0,2,0,0,2
"cg21945322",0,0,1,0,1
"cg21945686",0,0,2,0,2
"cg21945946",0,1,0,0,1
"cg21946496",1,0,1,0,2
"cg21947488",0,0,3,0,3
"cg21948030",0,0,4,0,4
"cg21948071",2,0,0,0,2
"cg21948827",1,0,1,0,2
"cg21949097",1,0,0,0,1
"cg21950609",0,1,2,0,3
"cg21953702",1,0,0,0,1
"cg21956862",836,69,2,0,907
"cg21957306",1,1,0,0,2
"cg21958457",13,15,8,0,36
"cg21959034",3,5,0,0,8
"cg21959414",0,0,4,0,4
"cg21959912",0,0,1,0,1
"cg21962600",1,0,0,0,1
"cg21962608",0,0,1,0,1
"cg21962962",2,2,0,0,4
"cg21963048",0,0,1,0,1
"cg21963218",8,0,0,0,8
"cg21963320",1,0,0,0,1
"cg21963583",1,0,0,0,1
"cg21963720",1,0,0,0,1
"cg21964058",0,7,0,0,7
"cg21965565",1,0,0,0,1
"cg21966345",0,0,1,0,1
"cg21966982",0,1,0,0,1
"cg21968438",0,1,5,0,6
"cg21968530",1,0,0,0,1
"cg21969548",235,12,0,0,247
"cg21969566",0,2,0,0,2
"cg21970259",3,1,0,0,4
"cg21970626",1,0,0,0,1
"cg21970748",0,0,1,0,1
"cg21972664",1,2,0,0,3
"cg21973309",0,0,1,0,1
"cg21974985",0,0,1,0,1
"cg21977057",0,1,0,0,1
"cg21979437",2,0,0,0,2
"cg21980338",1,2,1,0,4
"cg21981298",2,1,0,0,3
"cg21983048",1,0,0,0,1
"cg21984129",4,0,0,0,4
"cg21984635",20,1,0,0,21
"cg21985132",0,0,1,0,1
"cg21986148",1,0,0,0,1
"cg21986174",4,0,0,0,4
"cg21986226",0,0,1,0,1
"cg21987135",0,0,1,0,1
"cg21987390",15,1,1,0,17
"cg21987731",0,0,1,0,1
"cg21988296",3,1,1,0,5
"cg21989307",0,1,0,0,1
"cg21989314",0,0,1,0,1
"cg21990316",0,2,0,0,2
"cg21991913",1,0,0,0,1
"cg21994152",0,0,1,0,1
"cg21995068",2,4,0,0,6
"cg21995203",3,0,0,0,3
"cg21995377",0,1,0,0,1
"cg21995484",0,2,3,0,5
"cg21995847",0,0,1,0,1
"cg21996134",0,0,7,0,7
"cg21996139",1,0,0,0,1
"cg21996336",1,1,0,0,2
"cg21997034",1,1,0,0,2
"cg21997182",1,3,21,0,25
"cg21997198",0,0,3,0,3
"cg21998354",4,1,0,0,5
"cg21998505",0,1,1,0,2
"cg21998566",4,5,3,0,12
"cg21999563",0,3,0,0,3
"cg22000984",9,0,0,0,9
"cg22001073",91,49,0,0,140
"cg22001279",1,4,0,0,5
"cg22002733",2,0,0,0,2
"cg22002746",0,0,1,0,1
"cg22003124",1,0,0,0,1
"cg22003347",9,0,0,0,9
"cg22004258",17,0,0,0,17
"cg22005401",1,0,0,0,1
"cg22006699",1,2,0,0,3
"cg22009593",4,1,0,0,5
"cg22010058",0,1,0,0,1
"cg22010094",3,10,1,0,14
"cg22011538",0,2,0,0,2
"cg22012333",0,1,0,0,1
"cg22012477",1,0,0,0,1
"cg22012577",0,5,1,0,6
"cg22012975",0,1,0,0,1
"cg22013619",1,3,0,0,4
"cg22014379",0,1,0,0,1
"cg22014891",0,0,1,0,1
"cg22014986",0,0,1,0,1
"cg22015128",0,1,1,0,2
"cg22016447",1,0,0,0,1
"cg22017187",1,0,0,0,1
"cg22017654",1,0,0,0,1
"cg22018116",0,2,1,2,5
"cg22019065",0,1,0,0,1
"cg22019178",0,1,0,0,1
"cg22020207",0,0,1,0,1
"cg22020455",566,226,1,0,793
"cg22021768",2,1,0,0,3
"cg22021832",1,1,0,0,2
"cg22022580",0,1,0,0,1
"cg22022857",1,3,9,0,13
"cg22023035",1,1,0,0,2
"cg22027360",0,1,5,0,6
"cg22027879",0,1,0,0,1
"cg22028367",1,0,8,0,9
"cg22028814",0,0,1,0,1
"cg22029073",0,1,0,0,1
"cg22029476",1,1,0,0,2
"cg22030214",118,35,2,0,155
"cg22030421",195,35,1,0,231
"cg22031411",4,0,0,0,4
"cg22031596",4,1,0,0,5
"cg22032092",27,1,0,0,28
"cg22034268",316,86,5,0,407
"cg22036057",0,0,3,0,3
"cg22037209",0,0,1,0,1
"cg22038319",1,0,0,0,1
"cg22039215",0,0,2,0,2
"cg22040728",17,0,0,0,17
"cg22040809",1,0,0,0,1
"cg22040889",0,1,0,0,1
"cg22040989",12,8,3,0,23
"cg22041073",1,1,1,0,3
"cg22041446",9,2,0,0,11
"cg22041507",0,0,1,0,1
"cg22042005",0,2,0,0,2
"cg22042157",445,37,1,0,483
"cg22042992",0,3,8,0,11
"cg22043777",2,1,0,0,3
"cg22044216",0,0,1,0,1
"cg22045604",1,0,1,0,2
"cg22047143",0,1,1,0,2
"cg22047977",0,0,1,0,1
"cg22048833",0,0,1,0,1
"cg22049321",0,1,0,0,1
"cg22051015",0,1,0,0,1
"cg22051170",2,0,0,0,2
"cg22052720",0,1,0,0,1
"cg22053558",1,22,0,0,23
"cg22053560",12,0,0,0,12
"cg22053721",3,1,0,0,4
"cg22054015",3,0,0,0,3
"cg22054593",0,1,0,0,1
"cg22054658",10,0,0,0,10
"cg22055451",0,1,0,0,1
"cg22056142",5,0,0,0,5
"cg22056476",0,0,1,0,1
"cg22057846",0,0,5,0,5
"cg22058467",488,44,1,0,533
"cg22058533",13,3,1,0,17
"cg22058816",0,3,0,0,3
"cg22059431",0,1,0,0,1
"cg22059735",1,1,0,0,2
"cg22060694",7,2,0,0,9
"cg22062383",0,1,0,0,1
"cg22063722",1,0,0,0,1
"cg22064440",0,0,2,0,2
"cg22065923",0,1,0,0,1
"cg22066146",3,1,0,0,4
"cg22066262",6,0,0,0,6
"cg22067617",43,11,1,0,55
"cg22068400",0,1,0,0,1
"cg22068759",18,0,0,0,18
"cg22069017",0,0,4,0,4
"cg22069347",1,0,0,0,1
"cg22069388",37,12,1,0,50
"cg22070177",0,0,1,0,1
"cg22070266",1,0,0,0,1
"cg22070865",0,1,0,0,1
"cg22071169",0,0,1,0,1
"cg22072462",0,0,1,0,1
"cg22072691",0,0,1,0,1
"cg22072825",0,0,6,0,6
"cg22073401",0,1,0,0,1
"cg22073507",12,4,1,0,17
"cg22073553",0,1,0,0,1
"cg22074871",1,1,0,0,2
"cg22075245",0,0,1,0,1
"cg22076228",2,5,0,0,7
"cg22076945",1,0,0,0,1
"cg22077988",0,0,2,0,2
"cg22080472",0,0,1,0,1
"cg22081367",3,0,0,0,3
"cg22082216",1,0,0,0,1
"cg22082601",0,1,0,0,1
"cg22083062",0,1,0,0,1
"cg22083641",159,86,17,0,262
"cg22083790",0,0,0,1,1
"cg22085718",0,1,0,0,1
"cg22086011",0,0,1,0,1
"cg22087053",0,2,2,0,4
"cg22087953",3,2,0,0,5
"cg22090266",0,0,1,0,1
"cg22092111",0,1,0,0,1
"cg22093640",0,1,0,0,1
"cg22093885",6,2,2,0,10
"cg22094050",1,2,0,0,3
"cg22094075",0,1,0,0,1
"cg22094706",3,5,4,0,12
"cg22095238",0,1,0,0,1
"cg22095396",0,0,1,0,1
"cg22096032",1,0,0,0,1
"cg22098042",4,0,0,0,4
"cg22099398",0,2,0,0,2
"cg22099521",37,2,0,0,39
"cg22104394",66,5,0,0,71
"cg22104743",1,2,0,0,3
"cg22105103",3,11,4,0,18
"cg22105215",0,1,3,0,4
"cg22105495",2,0,0,0,2
"cg22106265",1,1,6,0,8
"cg22106628",0,1,1,0,2
"cg22107546",32,10,0,0,42
"cg22107662",0,0,1,0,1
"cg22108265",0,2,0,0,2
"cg22108680",7,0,0,0,7
"cg22109801",1,0,0,0,1
"cg22110492",0,0,1,0,1
"cg22114133",0,1,0,0,1
"cg22114209",2,8,10,0,20
"cg22114267",10,1,0,0,11
"cg22115126",0,2,0,0,2
"cg22116530",0,0,1,0,1
"cg22116555",0,1,0,0,1
"cg22116966",1,2,0,0,3
"cg22117193",57,33,4,0,94
"cg22117642",0,1,0,0,1
"cg22118113",0,0,1,0,1
"cg22118645",36,0,0,0,36
"cg22120509",0,0,2,0,2
"cg22120738",17,2,1,0,20
"cg22120894",4,1,2,0,7
"cg22122542",1,1,4,0,6
"cg22122572",0,0,1,0,1
"cg22123459",0,1,1,0,2
"cg22123804",0,0,1,0,1
"cg22123825",0,1,0,0,1
"cg22124493",1,0,0,0,1
"cg22125253",2,1,0,0,3
"cg22125717",0,0,1,0,1
"cg22125950",3,1,0,0,4
"cg22127299",208,694,12,0,914
"cg22128830",0,1,0,0,1
"cg22129241",1,3,2,0,6
"cg22130067",0,1,0,0,1
"cg22130734",0,1,0,0,1
"cg22130868",227,152,2,0,381
"cg22131249",0,2,3,0,5
"cg22131547",414,7,0,0,421
"cg22132026",0,0,1,0,1
"cg22132964",0,3,0,0,3
"cg22133058",0,1,0,0,1
"cg22133949",0,1,2,0,3
"cg22135511",0,0,1,0,1
"cg22135583",0,3,0,0,3
"cg22136020",0,0,2,0,2
"cg22136317",1,0,0,0,1
"cg22136600",0,0,2,0,2
"cg22136960",0,0,2,0,2
"cg22139648",0,0,2,0,2
"cg22139774",0,0,2,0,2
"cg22141780",1,0,0,0,1
"cg22142212",0,1,0,0,1
"cg22143120",1,0,0,0,1
"cg22144892",116,25,0,0,141
"cg22145940",5,3,0,0,8
"cg22147827",1,2,0,0,3
"cg22148186",0,1,0,0,1
"cg22148934",1,0,0,0,1
"cg22148999",0,21,7,0,28
"cg22149095",628,55,1,0,684
"cg22150440",1,0,0,0,1
"cg22150925",1,0,0,0,1
"cg22151186",1,0,0,0,1
"cg22152229",2,3,1,0,6
"cg22152618",2,1,0,0,3
"cg22152667",0,0,1,0,1
"cg22152734",0,0,2,0,2
"cg22153062",1,0,0,0,1
"cg22154293",317,238,2,0,557
"cg22154447",8,0,0,0,8
"cg22155325",90,7,0,0,97
"cg22155755",1,0,0,0,1
"cg22157255",1,1,0,0,2
"cg22158158",0,1,0,0,1
"cg22158252",0,0,1,0,1
"cg22158388",1,0,0,0,1
"cg22158476",166,13,1,0,180
"cg22159716",7,4,0,0,11
"cg22160349",48,1,0,0,49
"cg22161736",263,51,0,0,314
"cg22162314",0,2,2,0,4
"cg22162478",4,10,17,0,31
"cg22163834",2,4,0,0,6
"cg22163966",200,7,0,0,207
"cg22164177",0,1,0,0,1
"cg22164216",0,1,1,0,2
"cg22165480",0,0,1,0,1
"cg22166195",4,0,0,0,4
"cg22167093",738,25,2,0,765
"cg22167498",21,27,0,0,48
"cg22168674",430,84,1,0,515
"cg22169042",0,0,2,0,2
"cg22169270",1,1,0,0,2
"cg22169782",1,0,1,0,2
"cg22170222",2,0,0,0,2
"cg22171036",4,0,0,0,4
"cg22171314",14,16,1,0,31
"cg22173481",10,9,1,0,20
"cg22174010",1,1,0,0,2
"cg22174356",0,0,1,0,1
"cg22176254",1,0,0,0,1
"cg22177227",41,22,1,0,64
"cg22177585",0,1,6,0,7
"cg22177721",0,0,1,0,1
"cg22178519",1,0,0,0,1
"cg22179552",0,1,0,0,1
"cg22180157",0,0,0,1,1
"cg22180614",231,68,1,0,300
"cg22180738",1,3,0,0,4
"cg22182781",1,0,0,0,1
"cg22183053",0,0,1,0,1
"cg22184891",0,0,1,0,1
"cg22185268",0,0,2,0,2
"cg22185643",0,0,4,0,4
"cg22185847",0,0,1,0,1
"cg22187246",0,1,0,0,1
"cg22191443",1,0,0,0,1
"cg22191682",0,0,1,0,1
"cg22191803",0,1,0,0,1
"cg22192412",4,1,0,0,5
"cg22192744",1,0,0,0,1
"cg22193393",2,1,0,0,3
"cg22193447",0,1,5,0,6
"cg22193924",0,0,1,0,1
"cg22194396",5,0,0,0,5
"cg22194761",1,1,0,0,2
"cg22195836",1,0,0,0,1
"cg22195880",16,0,0,0,16
"cg22197092",0,1,0,0,1
"cg22197358",0,1,0,0,1
"cg22198623",0,0,1,0,1
"cg22199216",0,1,0,0,1
"cg22199361",1,0,0,0,1
"cg22201646",0,0,1,0,1
"cg22201997",0,0,3,0,3
"cg22202653",1,3,8,0,12
"cg22203862",242,23,0,0,265
"cg22204050",0,2,1,0,3
"cg22204764",0,0,2,0,2
"cg22204954",0,0,2,0,2
"cg22205573",0,1,4,0,5
"cg22205607",0,2,0,0,2
"cg22206240",5,1,0,0,6
"cg22207141",0,1,0,0,1
"cg22208536",0,0,1,0,1
"cg22209476",0,0,1,0,1
"cg22209588",0,0,1,0,1
"cg22211266",0,0,1,0,1
"cg22211497",301,65,1,0,367
"cg22211749",2,0,0,0,2
"cg22211784",3,0,0,0,3
"cg22212542",8,14,7,0,29
"cg22213193",14,2,0,0,16
"cg22215836",0,3,4,0,7
"cg22216431",642,49,0,0,691
"cg22216952",0,2,0,0,2
"cg22217676",1,1,0,0,2
"cg22218470",0,0,0,1,1
"cg22219776",0,0,1,0,1
"cg22219933",2,0,0,0,2
"cg22220545",0,0,1,0,1
"cg22222355",2,2,7,0,11
"cg22222592",0,0,1,0,1
"cg22224083",1,1,0,0,2
"cg22224202",2,2,2,0,6
"cg22225307",425,38,0,0,463
"cg22225685",1,0,0,0,1
"cg22225918",1,0,0,0,1
"cg22226526",0,0,1,0,1
"cg22227474",5,3,0,0,8
"cg22227747",2,0,0,0,2
"cg22227893",1,0,1,0,2
"cg22229836",0,0,1,0,1
"cg22230293",1,0,0,0,1
"cg22230584",3,1,0,0,4
"cg22231758",5,0,0,0,5
"cg22232048",0,2,0,0,2
"cg22232424",0,0,1,0,1
"cg22233152",0,0,1,0,1
"cg22233255",0,1,0,0,1
"cg22233726",1,0,0,0,1
"cg22234135",2,2,1,0,5
"cg22235936",1,0,2,0,3
"cg22236073",658,249,2,0,909
"cg22236711",1,1,0,0,2
"cg22237508",3,1,0,0,4
"cg22238692",0,0,1,0,1
"cg22239376",2,0,0,0,2
"cg22241014",9,1,0,0,10
"cg22241177",1,0,0,0,1
"cg22243494",1,0,0,0,1
"cg22243989",0,0,1,0,1
"cg22246565",14,8,1,0,23
"cg22246666",0,0,2,0,2
"cg22247005",0,0,1,0,1
"cg22249754",0,1,1,0,2
"cg22249956",2,0,0,0,2
"cg22250376",17,1,0,0,18
"cg22250661",0,0,0,2,2
"cg22251401",0,0,1,0,1
"cg22252283",2,0,3,0,5
"cg22252903",0,1,0,0,1
"cg22252938",0,0,1,0,1
"cg22254313",5,17,13,0,35
"cg22255378",1,0,0,0,1
"cg22255404",1,0,0,0,1
"cg22255514",1,0,0,0,1
"cg22255532",12,15,1,0,28
"cg22257747",1,1,0,0,2
"cg22257753",8,0,0,0,8
"cg22258230",4,0,0,0,4
"cg22258490",607,31,1,0,639
"cg22258758",1,0,0,0,1
"cg22259242",2,0,0,0,2
"cg22260196",1,0,0,0,1
"cg22260982",1,1,0,0,2
"cg22261399",0,0,1,0,1
"cg22261761",0,1,0,0,1
"cg22261987",0,0,1,0,1
"cg22265796",18,2,0,0,20
"cg22267131",154,17,0,0,171
"cg22267527",1,5,2,0,8
"cg22267542",30,0,0,0,30
"cg22268093",6,2,6,0,14
"cg22268279",1,3,0,0,4
"cg22268467",1,0,0,0,1
"cg22269622",0,0,1,0,1
"cg22269969",120,204,69,0,393
"cg22270914",25,1,0,0,26
"cg22272240",735,23,0,0,758
"cg22272911",3,0,0,0,3
"cg22273242",4,0,1,0,5
"cg22273354",1,2,0,0,3
"cg22274522",0,0,1,0,1
"cg22275314",523,86,0,0,609
"cg22276047",5,6,3,0,14
"cg22276251",6,0,5,0,11
"cg22276519",0,1,1,0,2
"cg22276528",1,10,17,0,28
"cg22277272",1,0,0,0,1
"cg22277357",4,0,0,0,4
"cg22278668",0,1,0,0,1
"cg22280210",0,1,0,0,1
"cg22281372",4,0,0,0,4
"cg22281935",0,1,0,0,1
"cg22282632",1,0,0,0,1
"cg22282896",1,0,1,0,2
"cg22283959",0,1,0,0,1
"cg22284514",1,0,0,0,1
"cg22284786",0,1,0,0,1
"cg22286996",0,0,1,0,1
"cg22287166",0,0,1,0,1
"cg22287731",0,6,1,0,7
"cg22288066",8,0,0,0,8
"cg22288613",0,0,0,1,1
"cg22290284",0,1,0,0,1
"cg22290935",1,0,0,0,1
"cg22291580",0,3,6,0,9
"cg22291742",0,0,1,0,1
"cg22292390",0,0,1,0,1
"cg22294288",0,0,1,0,1
"cg22297156",0,0,1,0,1
"cg22297305",0,0,1,0,1
"cg22298437",11,1,0,0,12
"cg22298470",5,5,1,0,11
"cg22298609",0,1,0,0,1
"cg22300615",2,1,0,0,3
"cg22300727",0,0,1,0,1
"cg22303227",1,0,0,0,1
"cg22305782",1,0,0,0,1
"cg22306579",1,0,0,0,1
"cg22308014",0,1,0,0,1
"cg22308240",0,1,0,0,1
"cg22308746",0,0,2,0,2
"cg22308926",1,0,2,0,3
"cg22311436",1,0,0,0,1
"cg22312050",1,0,0,0,1
"cg22313601",0,0,1,0,1
"cg22316154",1,0,0,0,1
"cg22317184",4,0,1,0,5
"cg22317776",0,1,0,0,1
"cg22318077",1,3,0,0,4
"cg22318821",7,0,0,0,7
"cg22320231",0,0,1,0,1
"cg22320833",0,1,0,0,1
"cg22321514",82,5,1,0,88
"cg22324618",0,0,1,0,1
"cg22326188",0,1,0,0,1
"cg22326239",1,0,0,0,1
"cg22326420",0,0,0,1,1
"cg22326973",0,0,1,0,1
"cg22328857",39,31,5,0,75
"cg22330695",0,0,1,0,1
"cg22332495",276,851,255,0,1382
"cg22332589",0,0,1,0,1
"cg22332696",1,0,0,0,1
"cg22334320",0,1,0,0,1
"cg22336754",2,0,1,0,3
"cg22338677",1,1,0,0,2
"cg22344661",0,0,1,0,1
"cg22344949",0,6,0,0,6
"cg22345349",3,1,0,0,4
"cg22345896",6,1,0,0,7
"cg22346179",91,19,0,0,110
"cg22346764",0,0,1,0,1
"cg22347126",0,0,1,0,1
"cg22347633",2,1,1,0,4
"cg22349261",1,0,2,0,3
"cg22349387",0,1,1,0,2
"cg22349487",3,2,0,0,5
"cg22350729",0,1,0,0,1
"cg22352717",0,1,0,0,1
"cg22353381",0,1,1,0,2
"cg22354397",2,0,0,0,2
"cg22354447",1,0,0,0,1
"cg22354505",9,0,0,0,9
"cg22355558",4,0,1,0,5
"cg22357014",0,1,0,0,1
"cg22358067",2,1,0,0,3
"cg22358241",1,0,0,0,1
"cg22361409",15,14,0,0,29
"cg22361727",18,6,1,0,25
"cg22361816",0,2,0,0,2
"cg22362837",0,1,0,0,1
"cg22363643",0,1,0,0,1
"cg22364098",0,0,1,0,1
"cg22364604",1,3,0,0,4
"cg22364675",0,0,1,0,1
"cg22364729",0,0,1,0,1
"cg22365450",1,1,3,0,5
"cg22366696",0,3,0,0,3
"cg22366885",1,0,0,0,1
"cg22366938",1,1,0,0,2
"cg22368426",0,2,0,0,2
"cg22369009",1,0,0,0,1
"cg22369362",0,2,0,0,2
"cg22371600",0,0,1,0,1
"cg22371952",33,9,0,0,42
"cg22371963",3,10,1,0,14
"cg22372508",72,10,1,0,83
"cg22373294",0,0,1,0,1
"cg22373450",0,1,0,0,1
"cg22373472",0,0,1,0,1
"cg22375332",0,2,1,0,3
"cg22375718",0,0,1,0,1
"cg22375853",4,0,0,0,4
"cg22377117",0,1,0,0,1
"cg22380663",0,0,3,0,3
"cg22380849",19,0,0,0,19
"cg22381527",0,0,1,0,1
"cg22381563",106,379,53,0,538
"cg22382112",0,1,8,0,9
"cg22382197",0,1,0,0,1
"cg22383744",0,0,2,0,2
"cg22384010",82,60,1,0,143
"cg22388316",3,0,0,0,3
"cg22389215",5,1,0,0,6
"cg22389615",0,0,2,0,2
"cg22392250",1,0,0,0,1
"cg22392276",2,0,0,0,2
"cg22392809",0,0,3,0,3
"cg22394869",0,1,0,0,1
"cg22394889",16,0,0,0,16
"cg22396730",2,0,0,0,2
"cg22398426",1,0,0,0,1
"cg22400787",0,2,1,0,3
"cg22402291",0,2,0,0,2
"cg22403154",145,37,6,0,188
"cg22404196",27,2,0,0,29
"cg22404551",0,2,0,0,2
"cg22404786",1,0,0,0,1
"cg22405122",0,1,0,0,1
"cg22405521",2,0,0,0,2
"cg22406415",1,0,0,0,1
"cg22406869",0,1,1,0,2
"cg22407123",1,2,0,0,3
"cg22407154",0,0,1,0,1
"cg22407255",1,0,0,0,1
"cg22407511",0,1,0,0,1
"cg22407879",1,0,1,0,2
"cg22408559",13,3,0,0,16
"cg22411185",2,0,0,0,2
"cg22411415",1,0,0,0,1
"cg22411830",2,0,0,0,2
"cg22411837",0,2,0,0,2
"cg22413399",1,0,0,0,1
"cg22413749",3,0,0,0,3
"cg22415591",31,7,2,0,40
"cg22415784",0,1,0,0,1
"cg22415810",1,0,1,0,2
"cg22416599",0,0,1,0,1
"cg22416672",38,3,0,0,41
"cg22418083",1,0,0,0,1
"cg22420671",0,2,0,0,2
"cg22420756",0,0,1,0,1
"cg22423821",1,0,0,0,1
"cg22423841",0,2,0,0,2
"cg22426139",9,0,3,0,12
"cg22426228",22,0,0,0,22
"cg22426650",1,0,0,0,1
"cg22429896",1,0,0,0,1
"cg22432133",1,0,0,0,1
"cg22432182",1,0,0,0,1
"cg22432410",5,3,0,0,8
"cg22432612",1,1,0,0,2
"cg22433141",0,1,2,0,3
"cg22434333",1,0,0,0,1
"cg22434633",0,1,0,0,1
"cg22434766",0,0,3,0,3
"cg22435349",2,0,0,0,2
"cg22436103",15,11,5,0,31
"cg22436634",54,116,2,0,172
"cg22438284",0,2,0,0,2
"cg22439381",0,0,1,0,1
"cg22439783",0,1,0,0,1
"cg22440706",1,0,0,0,1
"cg22441237",1,0,1,0,2
"cg22442210",0,1,2,0,3
"cg22443102",2,0,0,0,2
"cg22443258",2,1,0,0,3
"cg22443404",4,1,0,0,5
"cg22445183",1,1,0,0,2
"cg22447396",114,12,0,0,126
"cg22447539",0,1,0,0,1
"cg22448679",11,13,2,0,26
"cg22449330",1,0,0,0,1
"cg22451782",0,1,0,0,1
"cg22453033",0,0,2,0,2
"cg22454564",0,7,0,0,7
"cg22455197",2,1,0,0,3
"cg22455667",5,0,0,0,5
"cg22456785",0,1,0,0,1
"cg22457102",1,0,1,0,2
"cg22457256",2,2,1,0,5
"cg22458832",1,0,0,0,1
"cg22458888",1,0,0,0,1
"cg22458965",51,5,0,0,56
"cg22459051",0,0,3,0,3
"cg22459078",206,216,42,0,464
"cg22459320",2,0,0,0,2
"cg22460063",1,0,0,0,1
"cg22460590",74,27,1,0,102
"cg22461298",0,2,0,0,2
"cg22461375",1,0,0,0,1
"cg22463138",4,4,2,0,10
"cg22464292",0,0,1,0,1
"cg22464447",18,3,0,0,21
"cg22464455",0,0,1,0,1
"cg22466573",1,2,0,0,3
"cg22466726",0,0,2,0,2
"cg22466850",216,21,1,0,238
"cg22466967",0,0,1,0,1
"cg22467304",0,0,5,0,5
"cg22469720",1,0,0,0,1
"cg22471496",0,0,1,0,1
"cg22472953",0,1,0,0,1
"cg22474480",0,0,1,0,1
"cg22475008",0,1,0,0,1
"cg22475082",1,0,0,0,1
"cg22476963",2,1,1,0,4
"cg22477766",3,0,0,0,3
"cg22478179",1,3,5,0,9
"cg22478447",0,1,1,0,2
"cg22478966",0,0,1,0,1
"cg22480490",0,2,6,0,8
"cg22481882",0,1,0,0,1
"cg22482048",15,3,0,0,18
"cg22482142",266,140,13,0,419
"cg22482191",1,0,0,0,1
"cg22483030",0,1,0,0,1
"cg22483634",5,3,0,0,8
"cg22484390",2,0,0,0,2
"cg22484959",0,1,0,0,1
"cg22485344",6,1,0,0,7
"cg22486083",0,0,1,0,1
"cg22487242",63,1,0,0,64
"cg22487367",206,37,1,0,244
"cg22488780",0,1,0,0,1
"cg22489198",4,7,0,0,11
"cg22491207",0,0,1,0,1
"cg22492936",0,0,1,0,1
"cg22493236",23,2,0,0,25
"cg22493809",0,0,2,0,2
"cg22493873",13,0,0,0,13
"cg22494346",0,0,2,0,2
"cg22494808",2,0,0,0,2
"cg22495150",98,42,5,0,145
"cg22495298",0,1,1,0,2
"cg22496380",0,16,1,0,17
"cg22496920",1,0,0,0,1
"cg22498050",2,0,0,0,2
"cg22499139",0,1,2,0,3
"cg22499237",0,1,0,0,1
"cg22500559",3,0,0,0,3
"cg22500738",0,0,1,0,1
"cg22502179",147,1744,47,0,1938
"cg22502621",3,1,1,0,5
"cg22503116",0,0,2,0,2
"cg22504933",7,1,0,0,8
"cg22505295",1,2,0,0,3
"cg22505778",2,8,10,0,20
"cg22508069",0,0,1,0,1
"cg22508143",1,1,19,0,21
"cg22508530",833,773,12,0,1618
"cg22509113",0,0,1,0,1
"cg22510362",1,2,1,0,4
"cg22510396",2,0,13,0,15
"cg22510911",1,1,0,0,2
"cg22511073",0,1,1,0,2
"cg22511074",0,1,8,0,9
"cg22511432",6,2,0,0,8
"cg22511706",11,23,12,0,46
"cg22514743",0,0,1,0,1
"cg22515648",0,0,1,0,1
"cg22515696",1,0,0,0,1
"cg22516105",1,1,0,0,2
"cg22516161",3,0,0,0,3
"cg22516721",1,0,0,0,1
"cg22517607",73,5,0,0,78
"cg22517681",0,1,0,0,1
"cg22518769",0,0,2,0,2
"cg22519158",0,0,2,0,2
"cg22519672",351,53,1,0,405
"cg22521135",1,1,0,0,2
"cg22521818",1,0,0,0,1
"cg22522402",0,0,1,0,1
"cg22522985",0,0,1,0,1
"cg22523074",0,1,0,0,1
"cg22523729",0,1,0,0,1
"cg22523851",13,3,0,0,16
"cg22525941",346,57,1,0,404
"cg22527535",10,2,0,0,12
"cg22529427",374,83,5,0,462
"cg22529668",1,0,0,0,1
"cg22529822",0,0,1,0,1
"cg22531257",0,0,1,0,1
"cg22533724",353,64,1,0,418
"cg22534288",0,1,0,0,1
"cg22534777",0,1,0,0,1
"cg22535363",0,0,1,0,1
"cg22535679",2,0,0,0,2
"cg22536508",0,1,0,0,1
"cg22536921",0,0,1,0,1
"cg22537843",3,2,8,0,13
"cg22538535",0,1,0,0,1
"cg22539280",1,0,0,0,1
"cg22540561",2,0,0,0,2
"cg22541535",1,0,0,0,1
"cg22541830",0,0,2,0,2
"cg22541831",6,0,0,0,6
"cg22542036",4,0,0,0,4
"cg22542120",1,0,0,0,1
"cg22542147",1,0,0,0,1
"cg22542420",0,1,0,0,1
"cg22542632",2,2,0,0,4
"cg22542685",0,1,0,0,1
"cg22542702",0,3,0,0,3
"cg22544007",0,0,3,0,3
"cg22545618",0,2,2,2,6
"cg22546134",3,0,0,0,3
"cg22547286",0,0,1,0,1
"cg22547550",2,2,0,0,4
"cg22550397",0,0,1,0,1
"cg22551695",2,1,1,0,4
"cg22551751",0,0,5,0,5
"cg22552237",1,2,1,0,4
"cg22552312",17,3,1,0,21
"cg22552448",0,1,0,0,1
"cg22553357",95,7,0,0,102
"cg22553717",1,0,0,0,1
"cg22555543",0,1,0,0,1
"cg22556069",0,1,0,0,1
"cg22556300",3,0,0,0,3
"cg22556816",2,4,1,0,7
"cg22557523",3,0,0,0,3
"cg22559355",1,0,0,0,1
"cg22559788",0,1,3,0,4
"cg22559801",1,0,0,0,1
"cg22560952",0,12,2,0,14
"cg22561140",0,0,0,1,1
"cg22561380",1,0,0,0,1
"cg22561567",1,0,0,0,1
"cg22562021",2,3,4,0,9
"cg22562335",1,3,0,0,4
"cg22562363",10,1,0,0,11
"cg22562509",230,3,0,0,233
"cg22562596",0,1,0,0,1
"cg22563036",1,1,0,0,2
"cg22563742",0,1,0,0,1
"cg22563980",2,0,0,0,2
"cg22564285",1,1,0,0,2
"cg22564551",0,0,4,0,4
"cg22564599",0,0,1,0,1
"cg22565361",0,2,3,0,5
"cg22572090",0,0,1,0,1
"cg22572125",0,1,0,0,1
"cg22573179",438,629,16,0,1083
"cg22574873",0,1,0,0,1
"cg22575379",1,0,0,0,1
"cg22577120",73,18,0,0,91
"cg22578373",3,0,0,0,3
"cg22578698",1,1,2,0,4
"cg22579467",0,1,0,0,1
"cg22579948",20,11,2,0,33
"cg22580088",1,5,4,0,10
"cg22580603",1,0,0,0,1
"cg22581364",0,0,2,0,2
"cg22582671",0,1,0,0,1
"cg22584157",1,0,0,0,1
"cg22584296",2,0,0,0,2
"cg22584440",0,0,2,0,2
"cg22587675",1,1,0,0,2
"cg22587804",4,0,0,0,4
"cg22588702",1,0,0,0,1
"cg22588712",1,0,1,0,2
"cg22588799",0,0,1,0,1
"cg22589778",1,0,0,0,1
"cg22590099",0,0,1,0,1
"cg22590315",0,10,8,0,18
"cg22590594",0,0,3,0,3
"cg22591006",5,6,0,0,11
"cg22591672",33,23,0,0,56
"cg22591862",0,0,3,0,3
"cg22592346",124,25,3,0,152
"cg22593651",0,0,1,0,1
"cg22593889",2,0,0,0,2
"cg22594098",1,0,0,0,1
"cg22594737",0,0,1,0,1
"cg22595315",0,0,0,1,1
"cg22595526",1,2,3,0,6
"cg22595593",1,1,0,0,2
"cg22595806",2,0,0,0,2
"cg22595864",6,6,3,1,16
"cg22595970",1,0,0,0,1
"cg22596861",1,1,7,0,9
"cg22597981",1,0,0,0,1
"cg22598179",1,0,0,0,1
"cg22598267",2,0,0,0,2
"cg22598840",0,0,2,0,2
"cg22600284",0,0,1,0,1
"cg22603366",0,1,0,0,1
"cg22604188",0,0,1,1,2
"cg22604393",0,1,0,0,1
"cg22604793",1,6,0,0,7
"cg22605598",0,0,1,0,1
"cg22605641",0,1,0,0,1
"cg22605785",3,6,0,0,9
"cg22606179",3,1,0,0,4
"cg22606769",66,6,0,0,72
"cg22607688",7,7,2,0,16
"cg22608521",1,0,0,0,1
"cg22608996",2,0,0,0,2
"cg22609331",2,5,2,0,9
"cg22609510",0,1,0,0,1
"cg22609539",4,0,0,0,4
"cg22609722",0,1,0,0,1
"cg22610410",0,0,1,0,1
"cg22610787",1,1,1,0,3
"cg22611973",1,1,0,0,2
"cg22612318",4,0,0,0,4
"cg22612982",2,0,0,0,2
"cg22613042",1,0,0,0,1
"cg22613240",5,1,1,0,7
"cg22613956",4,0,0,0,4
"cg22613969",0,0,1,0,1
"cg22614748",11,14,5,0,30
"cg22616596",4,0,2,0,6
"cg22616671",1,0,0,0,1
"cg22616687",0,0,5,0,5
"cg22617703",0,3,2,0,5
"cg22617898",0,1,0,0,1
"cg22618752",0,0,1,0,1
"cg22618905",0,0,1,0,1
"cg22619910",1,1,0,0,2
"cg22621006",1,0,1,0,2
"cg22621161",34,7,0,0,41
"cg22621535",228,17,0,0,245
"cg22621542",0,1,0,0,1
"cg22621663",27,1,0,0,28
"cg22621706",0,0,1,0,1
"cg22622183",0,2,0,0,2
"cg22622676",0,4,3,0,7
"cg22623273",0,0,1,0,1
"cg22624116",2,0,0,0,2
"cg22625418",0,0,1,0,1
"cg22625576",260,20,0,0,280
"cg22627222",3,2,0,0,5
"cg22628064",6,3,0,0,9
"cg22629035",0,0,1,0,1
"cg22629482",0,0,1,0,1
"cg22629722",19,2,0,0,21
"cg22630160",3,3,1,0,7
"cg22630768",0,4,0,0,4
"cg22634027",0,1,0,0,1
"cg22634105",1,0,0,0,1
"cg22635098",75,7,3,0,85
"cg22635880",0,1,0,0,1
"cg22636056",14,0,0,0,14
"cg22636191",1,0,0,0,1
"cg22637722",1,0,0,0,1
"cg22638471",15,5,1,0,21
"cg22638505",5,2,1,0,8
"cg22639048",20,17,3,0,40
"cg22640202",0,0,1,0,1
"cg22643233",1,0,0,0,1
"cg22643337",103,20,0,0,123
"cg22646054",0,2,0,0,2
"cg22648015",1,0,0,0,1
"cg22648282",0,1,0,0,1
"cg22648967",1,0,0,0,1
"cg22649124",0,0,1,0,1
"cg22649289",0,2,0,0,2
"cg22649290",938,657,25,0,1620
"cg22649640",1,0,0,0,1
"cg22651603",0,1,2,0,3
"cg22651692",0,0,1,0,1
"cg22651968",0,2,0,0,2
"cg22652960",1,2,0,0,3
"cg22652999",10,19,9,0,38
"cg22654517",0,0,1,0,1
"cg22654601",4,1,0,0,5
"cg22654677",218,93,12,0,323
"cg22656544",0,1,0,0,1
"cg22656550",1,1,0,0,2
"cg22656997",912,314,2,0,1228
"cg22657059",1,0,0,0,1
"cg22657457",0,2,0,0,2
"cg22657730",0,0,0,1,1
"cg22658129",0,0,5,0,5
"cg22658229",0,1,0,0,1
"cg22658660",0,0,1,0,1
"cg22661742",0,0,1,0,1
"cg22661775",274,131,4,0,409
"cg22662834",0,0,1,0,1
"cg22662844",0,1,0,0,1
"cg22664922",0,0,0,1,1
"cg22666513",73,23,1,0,97
"cg22666828",0,0,0,1,1
"cg22668218",0,0,1,0,1
"cg22669002",0,1,0,0,1
"cg22669842",0,0,1,0,1
"cg22670733",1,3,0,0,4
"cg22670843",0,0,1,0,1
"cg22671611",0,0,5,0,5
"cg22672389",0,3,7,0,10
"cg22672796",1,0,0,0,1
"cg22673336",82,1,0,0,83
"cg22674388",0,8,17,0,25
"cg22674430",0,0,1,0,1
"cg22674977",0,1,0,0,1
"cg22675593",1,0,0,0,1
"cg22676447",193,391,19,0,603
"cg22676984",1,0,0,0,1
"cg22677199",0,0,2,0,2
"cg22678674",2,0,0,0,2
"cg22678734",3,3,0,0,6
"cg22679042",1,1,0,0,2
"cg22679858",30,51,0,0,81
"cg22680066",0,0,1,0,1
"cg22680911",638,16,0,0,654
"cg22682254",1,0,0,0,1
"cg22683283",0,1,0,0,1
"cg22683657",15,0,0,0,15
"cg22684065",1,0,1,0,2
"cg22684316",2,0,0,0,2
"cg22685226",0,4,0,0,4
"cg22685566",0,1,0,0,1
"cg22685643",6,2,0,0,8
"cg22685907",65,11,2,0,78
"cg22686253",3,0,0,0,3
"cg22687756",0,0,0,1,1
"cg22688687",34,1,0,0,35
"cg22688894",2,1,3,0,6
"cg22689396",0,0,3,0,3
"cg22689836",0,0,1,0,1
"cg22690103",1,0,0,0,1
"cg22690188",0,1,0,0,1
"cg22691336",0,0,1,0,1
"cg22692118",0,0,1,0,1
"cg22692213",0,0,0,1,1
"cg22694630",1,0,0,0,1
"cg22696391",0,0,1,0,1
"cg22696612",651,41,0,0,692
"cg22697572",0,1,0,0,1
"cg22698031",10,0,0,0,10
"cg22699461",0,1,0,0,1
"cg22700039",0,0,1,0,1
"cg22700312",4,2,2,0,8
"cg22700365",0,1,0,0,1
"cg22701048",3,1,0,0,4
"cg22701346",1,0,0,0,1
"cg22702949",0,0,1,0,1
"cg22703043",1,0,0,0,1
"cg22703198",1,0,0,0,1
"cg22703972",0,1,0,0,1
"cg22705316",7,1,1,0,9
"cg22706438",3,0,0,0,3
"cg22706889",1,0,0,0,1
"cg22706901",1,0,0,0,1
"cg22710391",0,0,2,0,2
"cg22710840",0,0,2,0,2
"cg22711185",0,0,1,0,1
"cg22711619",135,167,4,0,306
"cg22712785",1,0,0,0,1
"cg22713752",0,1,0,0,1
"cg22714517",1,0,10,0,11
"cg22715479",0,1,0,0,1
"cg22716025",0,0,9,0,9
"cg22717900",213,20,0,0,233
"cg22717941",0,0,1,0,1
"cg22718111",55,34,29,0,118
"cg22722802",0,0,1,0,1
"cg22722807",123,95,1,0,219
"cg22724179",1,0,0,0,1
"cg22724433",0,0,1,0,1
"cg22724639",48,23,0,0,71
"cg22724921",0,1,3,0,4
"cg22725764",0,1,0,0,1
"cg22725940",4,1,0,0,5
"cg22726373",0,0,1,0,1
"cg22726533",0,1,0,0,1
"cg22728225",0,0,1,0,1
"cg22728268",0,1,0,0,1
"cg22728851",13,1,0,0,14
"cg22729562",3,0,0,0,3
"cg22730048",9,6,2,0,17
"cg22730398",1,0,0,0,1
"cg22730636",0,0,1,0,1
"cg22730657",1,0,0,0,1
"cg22731120",1,0,0,0,1
"cg22731215",170,9,0,0,179
"cg22731638",44,17,0,0,61
"cg22732055",0,0,1,0,1
"cg22732209",1,0,1,0,2
"cg22733608",56,2,0,0,58
"cg22734315",0,1,0,0,1
"cg22734451",2,4,19,2,27
"cg22734714",1,1,0,0,2
"cg22736267",2,0,0,0,2
"cg22736458",0,1,0,0,1
"cg22736718",0,0,1,0,1
"cg22736777",121,83,4,0,208
"cg22739421",678,101,2,0,781
"cg22739610",2,0,0,0,2
"cg22740527",1,0,0,0,1
"cg22742764",1,0,0,0,1
"cg22743525",0,0,1,0,1
"cg22744480",0,8,0,0,8
"cg22745209",0,1,0,0,1
"cg22745280",288,13,0,0,301
"cg22745624",1,2,0,0,3
"cg22746681",1,1,0,0,2
"cg22747324",0,0,1,0,1
"cg22748144",0,2,0,0,2
"cg22748606",10,4,0,0,14
"cg22751639",0,0,1,0,1
"cg22753417",3,0,0,0,3
"cg22753462",0,1,0,0,1
"cg22753472",0,1,0,0,1
"cg22753508",3,6,2,0,11
"cg22753515",1,1,0,0,2
"cg22753607",1,0,0,0,1
"cg22753980",1,0,0,0,1
"cg22754489",179,318,94,0,591
"cg22756356",1,0,0,0,1
"cg22757531",1,0,0,0,1
"cg22757569",0,0,2,0,2
"cg22758143",2,0,0,0,2
"cg22758714",0,0,0,1,1
"cg22759173",0,1,2,0,3
"cg22759686",0,1,0,0,1
"cg22760421",0,1,0,0,1
"cg22761787",1,0,0,0,1
"cg22761795",0,4,0,0,4
"cg22763895",0,0,1,0,1
"cg22763995",3,0,0,0,3
"cg22764186",0,1,0,0,1
"cg22765718",0,1,0,0,1
"cg22766368",0,0,1,0,1
"cg22766585",17,3,0,0,20
"cg22767001",0,1,0,0,1
"cg22767164",1,0,0,0,1
"cg22767754",2,0,0,0,2
"cg22767914",0,3,0,0,3
"cg22768273",6,1,0,0,7
"cg22769483",1,0,0,0,1
"cg22769911",2,0,0,0,2
"cg22770088",1,2,8,0,11
"cg22771332",0,0,1,0,1
"cg22771759",0,1,0,0,1
"cg22771861",2,0,0,0,2
"cg22772235",6,0,0,0,6
"cg22772698",261,33,1,0,295
"cg22773100",240,625,52,0,917
"cg22773314",0,2,0,0,2
"cg22773883",0,0,2,0,2
"cg22774681",0,0,1,0,1
"cg22774922",17,1,0,0,18
"cg22775415",6,0,0,0,6
"cg22776304",1,0,0,0,1
"cg22776443",0,1,0,0,1
"cg22776504",0,1,1,1,3
"cg22777553",1,1,0,0,2
"cg22777883",2,1,0,0,3
"cg22778503",0,1,0,0,1
"cg22779195",1,1,4,0,6
"cg22779553",1,0,0,0,1
"cg22779687",1,0,0,0,1
"cg22779973",0,0,1,0,1
"cg22781063",18,15,1,0,34
"cg22781211",29,3,0,0,32
"cg22781961",7,1,0,0,8
"cg22785256",11,1,0,0,12
"cg22785503",1,0,0,0,1
"cg22785972",0,1,0,0,1
"cg22786013",1,0,0,0,1
"cg22786898",132,5,0,0,137
"cg22786923",0,0,1,0,1
"cg22788846",0,1,0,0,1
"cg22788909",4,1,1,0,6
"cg22789415",1,0,0,0,1
"cg22789937",0,0,2,0,2
"cg22790926",20,29,1,0,50
"cg22793065",4,9,2,0,15
"cg22793067",5,0,0,0,5
"cg22794127",69,5,0,0,74
"cg22795192",46,25,6,0,77
"cg22796313",1,6,4,0,11
"cg22796834",0,1,5,0,6
"cg22797182",1,0,0,0,1
"cg22797365",0,2,0,0,2
"cg22797884",0,1,0,0,1
"cg22797907",0,0,1,0,1
"cg22797978",663,153,0,0,816
"cg22798287",1,0,0,0,1
"cg22798303",179,90,12,0,281
"cg22801075",3,0,0,0,3
"cg22802167",0,9,56,0,65
"cg22802773",1,0,0,0,1
"cg22803772",77,9,0,0,86
"cg22803950",0,2,0,0,2
"cg22804352",17,1,0,0,18
"cg22804593",37,3,0,0,40
"cg22804606",1,2,0,0,3
"cg22805431",1,0,0,0,1
"cg22805500",0,0,1,0,1
"cg22805605",1,1,2,0,4
"cg22805813",433,45,3,0,481
"cg22807598",5,7,0,0,12
"cg22808713",0,0,1,0,1
"cg22809780",1,1,0,0,2
"cg22810105",24,0,0,0,24
"cg22810196",187,121,9,0,317
"cg22810198",0,0,1,0,1
"cg22810515",0,5,0,0,5
"cg22812571",0,1,0,0,1
"cg22813165",784,544,2,0,1330
"cg22813310",2,0,0,0,2
"cg22814417",0,1,0,0,1
"cg22814564",57,1,0,0,58
"cg22814875",0,1,5,0,6
"cg22815670",0,1,0,0,1
"cg22815873",2,2,0,0,4
"cg22816218",0,8,13,0,21
"cg22816621",0,0,1,0,1
"cg22817315",23,4,0,0,27
"cg22817647",1,0,0,0,1
"cg22818319",0,1,0,0,1
"cg22818873",0,0,2,0,2
"cg22819952",19,2,0,0,21
"cg22821189",2,1,0,0,3
"cg22821930",1,0,0,0,1
"cg22822440",72,9,0,0,81
"cg22822890",97,59,5,0,161
"cg22824366",0,0,1,0,1
"cg22824450",9,1,1,0,11
"cg22824934",1,0,0,0,1
"cg22825525",1,0,0,0,1
"cg22825664",3,0,1,0,4
"cg22828967",0,0,1,0,1
"cg22830805",1,7,2,0,10
"cg22831795",4,0,0,0,4
"cg22832747",0,2,4,0,6
"cg22833127",1,2,1,0,4
"cg22834498",1,0,0,0,1
"cg22836066",0,0,4,0,4
"cg22836207",16,1,0,0,17
"cg22836546",697,46,0,0,743
"cg22837814",0,0,2,0,2
"cg22839082",0,0,3,0,3
"cg22842855",1,0,0,0,1
"cg22842932",0,2,1,0,3
"cg22843723",0,0,1,0,1
"cg22843978",1,0,0,0,1
"cg22844780",3,0,0,0,3
"cg22844849",0,0,1,0,1
"cg22846741",0,0,2,0,2
"cg22847221",1,0,0,0,1
"cg22848031",1,0,0,0,1
"cg22849485",4,0,0,0,4
"cg22849543",1,0,0,0,1
"cg22850505",0,1,0,0,1
"cg22851175",0,2,0,0,2
"cg22852134",8,2,0,0,10
"cg22852177",1,0,0,0,1
"cg22852196",0,0,1,0,1
"cg22852503",0,0,1,0,1
"cg22856329",380,297,12,0,689
"cg22857324",0,3,0,0,3
"cg22858278",1,0,0,0,1
"cg22858749",0,0,0,1,1
"cg22859054",2,0,0,0,2
"cg22859135",0,0,1,0,1
"cg22860195",0,1,0,0,1
"cg22860534",5,0,0,0,5
"cg22860848",0,1,0,0,1
"cg22861794",1,0,0,0,1
"cg22861832",0,1,0,0,1
"cg22862656",1,0,0,0,1
"cg22863347",0,1,0,0,1
"cg22863700",0,0,1,0,1
"cg22864052",7,0,0,0,7
"cg22864077",0,0,2,0,2
"cg22864168",29,0,0,0,29
"cg22864244",0,0,1,0,1
"cg22865700",0,1,0,0,1
"cg22865737",9,4,0,0,13
"cg22865769",0,0,2,0,2
"cg22866147",4,0,0,0,4
"cg22867154",6,1,0,0,7
"cg22867162",14,0,0,0,14
"cg22868425",11,3,0,0,14
"cg22869224",39,4,0,0,43
"cg22869804",0,0,2,0,2
"cg22870596",0,1,0,0,1
"cg22870667",0,1,0,0,1
"cg22871566",0,0,3,0,3
"cg22871659",86,2,0,0,88
"cg22872002",3,2,0,0,5
"cg22872349",0,0,1,0,1
"cg22872448",1,1,0,0,2
"cg22874828",0,0,15,0,15
"cg22875855",352,44,1,0,397
"cg22876699",231,225,38,0,494
"cg22876713",0,0,1,0,1
"cg22877925",1,2,0,0,3
"cg22878469",0,2,0,0,2
"cg22878786",7,1,0,0,8
"cg22879057",0,4,0,0,4
"cg22879316",2,0,0,0,2
"cg22880202",2,4,0,0,6
"cg22881325",3,7,21,0,31
"cg22884029",1,0,0,0,1
"cg22884857",1,1,0,0,2
"cg22885136",0,0,1,0,1
"cg22885278",1,0,0,0,1
"cg22885407",0,3,0,0,3
"cg22885628",14,1,0,0,15
"cg22886985",0,2,1,0,3
"cg22887215",1,0,0,0,1
"cg22887748",0,2,0,0,2
"cg22888781",0,1,0,0,1
"cg22889570",0,0,1,0,1
"cg22890705",1,0,0,0,1
"cg22891099",0,0,1,0,1
"cg22891500",0,0,2,0,2
"cg22892485",583,698,11,0,1292
"cg22893532",0,0,1,0,1
"cg22894161",1,3,0,0,4
"cg22895305",0,1,0,0,1
"cg22896703",0,2,1,0,3
"cg22897634",1,1,0,0,2
"cg22898527",0,1,0,0,1
"cg22898871",0,0,2,0,2
"cg22899037",1,0,0,0,1
"cg22900217",0,0,1,0,1
"cg22900519",41,10,0,0,51
"cg22901294",1,0,0,0,1
"cg22901940",0,1,1,0,2
"cg22902358",0,1,0,0,1
"cg22902400",0,0,2,0,2
"cg22903528",1,0,0,0,1
"cg22905859",1,4,0,0,5
"cg22906692",1,0,0,0,1
"cg22906924",4,0,0,0,4
"cg22907277",3,4,1,0,8
"cg22907692",1,0,0,0,1
"cg22909083",0,0,2,0,2
"cg22909226",5,0,0,0,5
"cg22909383",281,17,1,0,299
"cg22913354",5,0,0,0,5
"cg22914125",0,0,1,0,1
"cg22914762",4,6,10,0,20
"cg22914764",0,0,1,0,1
"cg22916593",6,3,0,0,9
"cg22918356",0,0,1,0,1
"cg22918695",1,1,0,0,2
"cg22919657",52,4,0,0,56
"cg22919686",687,61,0,0,748
"cg22919784",0,0,1,0,1
"cg22923319",4,2,2,0,8
"cg22923487",6,3,0,0,9
"cg22924269",30,2,0,0,32
"cg22925103",3,0,0,0,3
"cg22926554",0,0,1,0,1
"cg22926824",1,0,0,0,1
"cg22928580",1,0,0,0,1
"cg22929209",0,0,1,0,1
"cg22929793",9,4,0,0,13
"cg22929840",0,1,0,0,1
"cg22932195",1,0,0,0,1
"cg22932223",0,0,1,0,1
"cg22933020",1,0,0,0,1
"cg22933232",2,0,0,0,2
"cg22933396",0,0,1,0,1
"cg22933439",25,0,0,0,25
"cg22933538",27,3,0,0,30
"cg22933630",6,0,0,0,6
"cg22934006",3,2,6,0,11
"cg22934824",14,2,1,0,17
"cg22935762",1,0,0,0,1
"cg22936376",0,1,0,0,1
"cg22937375",1,0,0,0,1
"cg22937462",1,0,0,0,1
"cg22939219",0,1,0,0,1
"cg22940263",84,75,10,0,169
"cg22940953",2,1,1,2,6
"cg22941025",1,4,0,0,5
"cg22941064",0,0,2,0,2
"cg22941403",1,0,3,0,4
"cg22941588",0,0,1,0,1
"cg22942169",144,83,8,0,235
"cg22942245",1,2,1,0,4
"cg22945471",3,10,7,0,20
"cg22946582",0,0,5,0,5
"cg22946761",1,3,3,0,7
"cg22947402",12,9,2,0,23
"cg22947481",0,1,0,0,1
"cg22948085",42,9,0,0,51
"cg22949229",0,0,1,0,1
"cg22949345",4,2,0,0,6
"cg22949767",0,0,1,0,1
"cg22949881",0,1,0,0,1
"cg22950376",0,0,0,1,1
"cg22950493",0,0,4,0,4
"cg22950933",160,44,14,0,218
"cg22951229",1,0,1,0,2
"cg22952017",225,22,0,0,247
"cg22952341",14,1,0,0,15
"cg22953510",0,1,0,0,1
"cg22954265",4,5,1,0,10
"cg22954818",0,1,0,0,1
"cg22956023",0,1,0,0,1
"cg22956063",0,0,1,0,1
"cg22956257",0,1,0,0,1
"cg22956811",207,62,2,0,271
"cg22956922",1,0,0,0,1
"cg22957752",0,0,1,0,1
"cg22958118",6,7,2,0,15
"cg22958243",0,0,1,0,1
"cg22958262",0,0,1,0,1
"cg22958715",0,1,0,0,1
"cg22959578",0,1,0,0,1
"cg22959894",0,1,0,0,1
"cg22960051",196,4,0,0,200
"cg22960187",0,0,2,0,2
"cg22960236",0,1,0,0,1
"cg22960289",1,1,1,0,3
"cg22961716",0,1,1,0,2
"cg22961747",0,1,1,0,2
"cg22961815",2,9,4,0,15
"cg22962106",0,3,1,0,4
"cg22963027",0,1,0,0,1
"cg22963191",222,303,12,0,537
"cg22963343",0,1,0,0,1
"cg22963587",12,19,9,0,40
"cg22963979",0,1,0,0,1
"cg22964044",0,0,1,0,1
"cg22964396",0,1,5,0,6
"cg22964768",0,0,1,0,1
"cg22964775",4,1,0,0,5
"cg22964985",18,3,0,0,21
"cg22967383",12,0,0,0,12
"cg22972262",1,1,1,0,3
"cg22972402",13,4,0,0,17
"cg22973026",4,15,21,0,40
"cg22973068",0,0,1,0,1
"cg22973236",1,2,0,0,3
"cg22973246",1,0,0,0,1
"cg22974100",0,0,2,0,2
"cg22974161",192,4,0,0,196
"cg22974462",10,16,9,0,35
"cg22974505",8,4,0,0,12
"cg22976708",0,0,2,0,2
"cg22978316",4,4,0,0,8
"cg22979356",0,1,14,0,15
"cg22979531",1,0,0,0,1
"cg22979546",0,1,0,0,1
"cg22979992",0,0,1,0,1
"cg22979996",3,1,0,0,4
"cg22980046",1,0,0,0,1
"cg22980453",1,4,4,0,9
"cg22980697",0,1,0,0,1
"cg22980834",1,0,0,0,1
"cg22980863",2,1,0,0,3
"cg22981687",0,2,1,0,3
"cg22982884",0,1,0,0,1
"cg22983641",18,5,0,0,23
"cg22983677",0,1,0,0,1
"cg22985595",2,0,0,0,2
"cg22986597",0,1,0,0,1
"cg22988865",14,0,0,0,14
"cg22989463",1,0,0,0,1
"cg22989659",4,13,20,0,37
"cg22990875",4,11,0,0,15
"cg22991163",1,0,0,0,1
"cg22992057",0,0,11,0,11
"cg22992591",0,1,0,0,1
"cg22992904",3,0,1,0,4
"cg22993358",8,11,9,0,28
"cg22995176",2,0,0,0,2
"cg22996045",0,0,1,0,1
"cg22997906",1,0,0,0,1
"cg22998206",0,0,1,0,1
"cg22998353",0,0,3,0,3
"cg22998534",2,0,0,0,2
"cg22998811",1,0,0,0,1
"cg22998840",2,0,0,0,2
"cg23001457",0,0,1,0,1
"cg23002439",1,0,0,0,1
"cg23003872",337,193,13,0,543
"cg23003934",0,2,0,0,2
"cg23004387",1,0,0,0,1
"cg23005103",0,1,0,0,1
"cg23005179",0,0,1,0,1
"cg23006541",1,0,0,0,1
"cg23007076",0,0,1,0,1
"cg23007804",0,2,0,0,2
"cg23009007",0,0,1,0,1
"cg23010062",8,3,0,0,11
"cg23010765",2,0,0,0,2
"cg23011899",7,3,0,0,10
"cg23012243",0,1,0,0,1
"cg23012288",0,0,1,0,1
"cg23013475",3,0,0,0,3
"cg23013894",1,1,0,0,2
"cg23014672",148,37,14,0,199
"cg23014800",0,0,3,0,3
"cg23015691",1,1,0,0,2
"cg23015949",0,0,1,0,1
"cg23016632",2,0,0,0,2
"cg23017753",0,1,0,0,1
"cg23019315",3,0,0,0,3
"cg23019996",1,0,0,0,1
"cg23021237",91,1,0,0,92
"cg23023044",0,1,0,0,1
"cg23023255",1,0,0,0,1
"cg23023870",1,0,1,0,2
"cg23024233",1,0,0,0,1
"cg23024913",3,0,0,0,3
"cg23025198",38,3,0,0,41
"cg23025654",0,1,3,0,4
"cg23027817",0,1,0,0,1
"cg23028840",0,2,0,0,2
"cg23029185",46,111,3,0,160
"cg23029285",0,0,1,0,1
"cg23029519",0,0,1,0,1
"cg23030486",1,0,0,0,1
"cg23032200",75,14,0,0,89
"cg23032391",0,1,0,0,1
"cg23034265",63,2,0,0,65
"cg23034757",0,1,0,0,1
"cg23035602",3,0,0,0,3
"cg23036232",3,0,0,0,3
"cg23037019",407,885,21,0,1313
"cg23037186",0,0,1,0,1
"cg23037537",0,2,0,0,2
"cg23040554",0,5,2,0,7
"cg23042796",0,0,1,0,1
"cg23043218",0,0,1,0,1
"cg23044169",19,2,0,0,21
"cg23045470",0,0,1,0,1
"cg23047033",0,1,0,0,1
"cg23047079",309,17,0,0,326
"cg23047322",0,0,1,0,1
"cg23047397",0,2,0,0,2
"cg23049312",0,1,0,0,1
"cg23050340",168,200,5,0,373
"cg23051632",10,1,0,0,11
"cg23051859",180,34,2,0,216
"cg23052267",0,2,0,0,2
"cg23053516",1,0,3,0,4
"cg23053723",0,1,0,0,1
"cg23054647",0,1,0,0,1
"cg23055064",288,3,0,0,291
"cg23055199",1,1,0,0,2
"cg23055377",0,1,0,0,1
"cg23055499",1,0,0,0,1
"cg23055754",0,0,2,0,2
"cg23057621",15,0,0,0,15
"cg23058109",1,0,0,0,1
"cg23058129",1,0,0,0,1
"cg23058731",0,0,2,0,2
"cg23058911",146,2,0,0,148
"cg23059376",0,0,1,0,1
"cg23060646",0,1,0,0,1
"cg23061114",1,2,0,0,3
"cg23063364",0,0,1,0,1
"cg23063945",1,2,0,0,3
"cg23064501",0,1,0,0,1
"cg23065415",0,0,1,0,1
"cg23065487",697,738,20,0,1455
"cg23066221",0,0,1,0,1
"cg23067256",1,0,0,0,1
"cg23068623",0,0,1,0,1
"cg23068800",1,1,0,0,2
"cg23070485",0,0,1,0,1
"cg23070487",1,0,0,0,1
"cg23070665",0,1,1,0,2
"cg23071053",5,5,2,0,12
"cg23071256",7,0,0,0,7
"cg23071408",6,0,0,0,6
"cg23071497",0,0,1,0,1
"cg23071740",1,1,1,1,4
"cg23071791",0,1,0,0,1
"cg23073111",1,0,0,0,1
"cg23074704",0,1,2,1,4
"cg23075026",0,1,0,0,1
"cg23075771",1,0,0,0,1
"cg23076474",0,0,11,0,11
"cg23076711",1,0,0,0,1
"cg23076826",11,17,12,0,40
"cg23078522",0,0,1,0,1
"cg23079120",1,0,0,0,1
"cg23079226",0,0,1,0,1
"cg23080427",1,0,0,0,1
"cg23080563",0,0,1,0,1
"cg23081488",252,286,50,0,588
"cg23081754",1,0,0,0,1
"cg23082401",0,1,1,0,2
"cg23082620",1,0,2,0,3
"cg23082766",0,0,1,0,1
"cg23082773",1,2,3,0,6
"cg23082794",0,0,1,0,1
"cg23083514",0,0,1,0,1
"cg23084402",1,0,0,0,1
"cg23085500",1,0,0,0,1
"cg23086647",0,0,1,0,1
"cg23087798",1,0,0,0,1
"cg23087961",0,4,4,0,8
"cg23088286",1,2,5,0,8
"cg23088403",2,1,6,0,9
"cg23088904",6,0,0,0,6
"cg23089436",66,4,0,0,70
"cg23089764",0,1,1,0,2
"cg23090671",24,3,5,0,32
"cg23090776",0,1,0,1,2
"cg23090860",0,0,2,0,2
"cg23091181",0,0,1,0,1
"cg23091656",0,0,1,0,1
"cg23092040",1,0,0,0,1
"cg23092381",0,2,0,0,2
"cg23095043",274,354,3,0,631
"cg23095732",37,497,174,0,708
"cg23096272",134,308,286,0,728
"cg23096558",0,1,0,0,1
"cg23098053",1,0,0,0,1
"cg23099145",1,0,0,0,1
"cg23099740",1,0,0,0,1
"cg23100370",2,0,0,0,2
"cg23100493",0,0,1,0,1
"cg23100591",2,0,0,0,2
"cg23100810",1,0,3,0,4
"cg23101093",37,2,0,0,39
"cg23101138",1,1,5,0,7
"cg23101686",2,0,0,0,2
"cg23102129",1,0,0,0,1
"cg23102197",1,0,1,0,2
"cg23102388",0,0,1,0,1
"cg23103346",1,0,0,0,1
"cg23103406",0,1,0,0,1
"cg23105099",62,1,0,0,63
"cg23105183",0,0,5,0,5
"cg23105237",20,6,1,0,27
"cg23106865",2,4,1,0,7
"cg23107144",2,0,1,0,3
"cg23108435",14,0,0,0,14
"cg23109174",0,1,0,1,2
"cg23110108",0,0,1,0,1
"cg23111146",1,0,0,0,1
"cg23112651",0,1,0,0,1
"cg23114772",0,0,1,0,1
"cg23115173",5,1,1,0,7
"cg23117204",0,1,1,0,2
"cg23117530",19,14,5,0,38
"cg23117565",0,0,1,0,1
"cg23117592",0,0,1,0,1
"cg23118139",0,1,0,0,1
"cg23121777",0,4,0,0,4
"cg23122320",0,0,1,0,1
"cg23123267",0,1,0,0,1
"cg23123918",0,0,1,0,1
"cg23125249",0,1,1,0,2
"cg23128056",1,0,0,0,1
"cg23129217",0,1,0,0,1
"cg23129643",0,0,1,0,1
"cg23131131",0,2,0,0,2
"cg23133198",0,1,0,0,1
"cg23134100",0,1,0,0,1
"cg23135850",0,0,4,0,4
"cg23136799",0,0,1,0,1
"cg23137666",0,1,1,0,2
"cg23137845",2,1,0,0,3
"cg23138720",10,3,0,0,13
"cg23138872",3,0,0,0,3
"cg23139792",32,3,0,0,35
"cg23140076",0,0,1,0,1
"cg23140396",0,0,1,0,1
"cg23141987",1,0,5,0,6
"cg23143208",12,11,0,0,23
"cg23144563",0,0,1,0,1
"cg23146713",1,0,0,0,1
"cg23147443",1,0,0,0,1
"cg23148631",0,0,2,0,2
"cg23148701",0,1,2,0,3
"cg23149064",1,2,0,0,3
"cg23149573",37,12,0,0,49
"cg23149822",1,0,0,0,1
"cg23149845",0,1,1,0,2
"cg23150814",0,0,1,0,1
"cg23150842",0,0,1,0,1
"cg23151401",3,0,0,0,3
"cg23151636",0,1,1,0,2
"cg23152667",0,1,0,0,1
"cg23153338",0,0,1,0,1
"cg23153615",0,0,4,0,4
"cg23154064",34,1,0,0,35
"cg23154636",0,1,0,0,1
"cg23154747",0,0,1,0,1
"cg23155281",1122,171,5,0,1298
"cg23155339",1,7,3,0,11
"cg23155459",1,0,2,0,3
"cg23155606",2,3,0,0,5
"cg23156245",1,0,0,0,1
"cg23156439",18,35,0,0,53
"cg23156486",0,1,0,0,1
"cg23156630",0,1,1,0,2
"cg23156804",1,0,0,0,1
"cg23157449",1,1,0,0,2
"cg23158658",66,9,1,0,76
"cg23158892",3,2,9,0,14
"cg23159493",0,0,1,0,1
"cg23159693",1,1,2,0,4
"cg23160376",10,0,0,0,10
"cg23161251",6,0,0,0,6
"cg23161318",0,1,0,0,1
"cg23161769",8,1,0,0,9
"cg23162087",2,1,0,0,3
"cg23162686",335,45,0,0,380
"cg23163644",0,1,0,0,1
"cg23165431",1,0,0,0,1
"cg23166047",0,0,1,0,1
"cg23166258",0,0,1,0,1
"cg23166445",3,0,0,0,3
"cg23166740",0,1,0,0,1
"cg23166787",29,5,0,0,34
"cg23167528",16,87,19,0,122
"cg23169388",1,0,0,0,1
"cg23169605",1,0,0,0,1
"cg23170036",1,0,0,0,1
"cg23170959",1,0,0,0,1
"cg23171179",1,0,0,0,1
"cg23172907",13,2,0,0,15
"cg23173817",0,1,2,0,3
"cg23174483",3,0,0,0,3
"cg23175428",3,0,0,0,3
"cg23176388",0,1,0,0,1
"cg23176663",0,0,3,0,3
"cg23176931",0,1,0,0,1
"cg23177995",1,0,0,0,1
"cg23178809",0,0,1,0,1
"cg23179570",1,3,0,0,4
"cg23181283",1,0,0,0,1
"cg23182239",4,0,0,0,4
"cg23182836",0,0,1,0,1
"cg23183922",0,0,0,2,2
"cg23184125",0,0,0,1,1
"cg23184503",0,0,4,0,4
"cg23185262",3,0,0,0,3
"cg23185401",0,3,0,0,3
"cg23186743",1,2,0,0,3
"cg23187015",2,1,0,0,3
"cg23187160",15,23,1,0,39
"cg23188282",79,2,0,0,81
"cg23189949",1,0,0,0,1
"cg23190054",8,1,0,0,9
"cg23190402",145,2,0,0,147
"cg23190472",1,0,0,0,1
"cg23191009",3,1,1,0,5
"cg23191072",0,0,1,0,1
"cg23191632",0,0,1,0,1
"cg23191740",1,0,0,0,1
"cg23193730",0,0,0,1,1
"cg23195619",1,2,1,0,4
"cg23196302",3,1,1,0,5
"cg23198529",0,1,0,0,1
"cg23198759",0,1,1,0,2
"cg23199403",1,0,0,0,1
"cg23200354",0,0,1,0,1
"cg23200466",0,0,1,0,1
"cg23200509",1,0,1,0,2
"cg23201419",2,0,0,0,2
"cg23201676",0,0,1,0,1
"cg23202090",0,0,1,0,1
"cg23203338",0,1,0,0,1
"cg23203755",0,1,0,0,1
"cg23204577",1,1,0,0,2
"cg23205400",1,0,0,0,1
"cg23206289",1,1,0,0,2
"cg23207324",1,0,0,0,1
"cg23211470",1,1,0,0,2
"cg23212786",12,1,0,0,13
"cg23213018",0,0,1,0,1
"cg23214207",1,1,1,0,3
"cg23215084",0,0,1,0,1
"cg23215275",0,4,2,0,6
"cg23215483",2,0,0,0,2
"cg23216004",0,0,1,0,1
"cg23216292",2,0,0,0,2
"cg23217935",0,0,1,0,1
"cg23217946",3,1,0,0,4
"cg23218535",245,278,18,0,541
"cg23219332",0,1,0,0,1
"cg23219925",3,13,0,0,16
"cg23219933",255,20,0,0,275
"cg23220418",1,0,0,0,1
"cg23220420",1,1,0,0,2
"cg23221139",0,0,1,0,1
"cg23221431",1,1,2,0,4
"cg23221506",525,946,104,0,1575
"cg23221681",4,2,0,0,6
"cg23222247",0,0,1,0,1
"cg23222745",0,0,1,0,1
"cg23222930",0,1,0,0,1
"cg23223550",1,1,0,0,2
"cg23224356",0,1,1,0,2
"cg23224458",0,0,2,0,2
"cg23224752",0,0,1,0,1
"cg23225234",863,446,5,0,1314
"cg23225699",0,4,7,0,11
"cg23226307",0,0,2,0,2
"cg23226387",733,76,0,0,809
"cg23227259",0,0,1,0,1
"cg23227285",0,0,1,0,1
"cg23228779",24,25,1,0,50
"cg23229652",0,1,0,0,1
"cg23230014",0,0,1,0,1
"cg23231093",10,0,0,0,10
"cg23231902",0,0,1,0,1
"cg23231910",2,0,0,0,2
"cg23232056",3,1,15,0,19
"cg23232915",1,0,2,0,3
"cg23233680",0,1,0,0,1
"cg23234602",1,0,0,0,1
"cg23234741",0,0,1,0,1
"cg23235004",1,0,0,0,1
"cg23235069",2,0,0,0,2
"cg23235870",0,1,0,0,1
"cg23236165",1,0,0,0,1
"cg23236169",2,4,0,0,6
"cg23237733",0,6,3,0,9
"cg23238501",0,0,2,0,2
"cg23238918",0,3,1,0,4
"cg23239533",809,640,23,0,1472
"cg23241950",614,6,0,0,620
"cg23242503",18,8,0,0,26
"cg23242561",3,0,0,0,3
"cg23242649",1,0,0,0,1
"cg23243012",1,0,0,0,1
"cg23244452",0,1,0,0,1
"cg23245192",57,2,0,0,59
"cg23246360",2,2,4,1,9
"cg23247842",86,145,61,0,292
"cg23249367",0,0,1,0,1
"cg23249872",1,0,0,0,1
"cg23250039",37,2,0,0,39
"cg23253399",2,6,3,0,11
"cg23253583",0,0,1,0,1
"cg23253988",0,1,0,0,1
"cg23254024",1,0,0,0,1
"cg23254662",0,0,1,0,1
"cg23255774",1,0,0,0,1
"cg23256235",0,0,1,0,1
"cg23257220",0,1,0,0,1
"cg23257859",0,0,2,0,2
"cg23259711",0,1,0,0,1
"cg23259713",0,0,1,0,1
"cg23259851",0,1,0,0,1
"cg23260966",0,1,0,0,1
"cg23261204",1,2,1,0,4
"cg23261420",0,0,1,0,1
"cg23261608",1,0,0,0,1
"cg23261820",35,1,0,0,36
"cg23263791",29,3,0,0,32
"cg23264236",0,0,1,0,1
"cg23264413",2,5,0,0,7
"cg23264738",18,1,0,0,19
"cg23266398",93,18,0,0,111
"cg23266597",1,0,0,0,1
"cg23267110",0,0,1,0,1
"cg23267224",12,1,0,0,13
"cg23267450",0,0,2,0,2
"cg23267513",0,1,0,0,1
"cg23267554",167,44,0,0,211
"cg23267872",314,14,0,0,328
"cg23268879",0,1,1,0,2
"cg23269513",1,1,0,0,2
"cg23270103",595,35,1,0,631
"cg23270808",13,13,0,0,26
"cg23271575",0,0,0,2,2
"cg23272378",0,0,6,0,6
"cg23272695",0,0,1,0,1
"cg23272822",0,1,2,0,3
"cg23272880",0,2,2,0,4
"cg23273834",0,2,2,0,4
"cg23274244",1,0,0,0,1
"cg23274691",0,0,1,0,1
"cg23275263",0,3,1,0,4
"cg23275764",0,2,1,0,3
"cg23276445",0,0,1,0,1
"cg23276502",1,0,0,0,1
"cg23276631",3,0,0,0,3
"cg23277788",0,0,2,0,2
"cg23278815",0,2,0,0,2
"cg23279058",0,0,1,0,1
"cg23280213",2,0,0,0,2
"cg23281861",1,0,0,0,1
"cg23283288",141,466,10,0,617
"cg23283362",1,0,0,0,1
"cg23283474",3,5,3,0,11
"cg23283621",1,0,0,0,1
"cg23284292",0,0,4,0,4
"cg23284476",140,9,0,0,149
"cg23284921",6,1,0,0,7
"cg23285059",8,0,0,0,8
"cg23285599",3,0,4,0,7
"cg23285750",0,0,1,0,1
"cg23286105",0,1,0,0,1
"cg23286756",1,9,0,0,10
"cg23288275",1,0,0,0,1
"cg23289734",3,1,0,0,4
"cg23290146",0,0,2,0,2
"cg23290573",1,0,0,0,1
"cg23291682",0,0,1,0,1
"cg23291865",0,0,1,0,1
"cg23292770",1,0,0,0,1
"cg23293787",0,0,1,0,1
"cg23294302",0,1,1,0,2
"cg23297089",0,0,2,0,2
"cg23299156",5,0,0,0,5
"cg23299385",101,19,0,0,120
"cg23300961",3,0,1,0,4
"cg23302991",0,0,0,1,1
"cg23303070",7,0,0,0,7
"cg23303505",0,0,1,0,1
"cg23303855",0,0,2,0,2
"cg23304267",0,0,1,0,1
"cg23306239",2,0,0,0,2
"cg23306641",3,0,0,0,3
"cg23306755",6,9,2,0,17
"cg23308437",2,0,0,0,2
"cg23308441",0,3,0,0,3
"cg23308914",1049,108,1,0,1158
"cg23309128",19,19,1,0,39
"cg23309203",0,1,0,0,1
"cg23309342",0,0,1,0,1
"cg23310835",3,0,0,0,3
"cg23311108",0,1,0,0,1
"cg23313274",1,0,0,0,1
"cg23313644",1,1,0,0,2
"cg23313963",1,3,0,0,4
"cg23315518",3,0,3,0,6
"cg23316161",0,0,0,1,1
"cg23316923",0,0,2,0,2
"cg23317501",0,0,1,0,1
"cg23318459",6,0,0,0,6
"cg23319012",1,0,4,0,5
"cg23319365",0,1,0,0,1
"cg23319982",0,0,1,0,1
"cg23320334",0,3,5,0,8
"cg23320550",0,0,1,0,1
"cg23322934",2,0,0,0,2
"cg23323395",1,0,1,0,2
"cg23323468",0,0,1,0,1
"cg23323926",0,0,1,0,1
"cg23323948",1,0,0,0,1
"cg23324149",0,0,1,0,1
"cg23325483",1,0,0,0,1
"cg23325997",0,0,1,0,1
"cg23327556",0,0,1,0,1
"cg23327851",0,1,0,0,1
"cg23328109",0,0,11,0,11
"cg23328335",0,2,0,0,2
"cg23329543",1,9,5,0,15
"cg23330503",0,1,0,0,1
"cg23331626",0,1,0,0,1
"cg23331837",0,0,1,0,1
"cg23334559",0,4,0,0,4
"cg23335195",1,0,0,0,1
"cg23335329",5,2,1,0,8
"cg23336323",0,1,0,0,1
"cg23336561",0,0,2,0,2
"cg23336892",23,1,0,0,24
"cg23337631",0,1,0,0,1
"cg23338640",0,0,1,0,1
"cg23338752",231,134,2,0,367
"cg23339448",0,1,0,0,1
"cg23339482",0,3,0,0,3
"cg23339709",0,1,0,0,1
"cg23340286",10,16,11,0,37
"cg23341970",9,1,0,0,10
"cg23343739",0,0,0,1,1
"cg23344069",1,0,0,0,1
"cg23344097",1,0,0,0,1
"cg23344121",0,1,0,0,1
"cg23345515",4,0,0,0,4
"cg23347058",15,0,0,0,15
"cg23348290",0,0,1,0,1
"cg23348575",1,0,0,0,1
"cg23349349",0,2,0,0,2
"cg23349634",6,0,0,0,6
"cg23350580",0,3,5,0,8
"cg23351290",1,0,0,0,1
"cg23351707",1,0,0,0,1
"cg23352145",0,1,0,0,1
"cg23353281",667,77,1,0,745
"cg23353952",0,1,0,0,1
"cg23354745",7,0,0,0,7
"cg23355166",0,0,2,0,2
"cg23355197",0,2,4,0,6
"cg23355250",0,0,5,0,5
"cg23355997",0,1,0,0,1
"cg23356121",1,0,0,0,1
"cg23359717",3,0,0,0,3
"cg23359932",52,45,0,0,97
"cg23360102",4,0,1,0,5
"cg23360635",0,0,1,0,1
"cg23361609",1,0,0,0,1
"cg23361614",2,1,1,0,4
"cg23363202",4,1,0,0,5
"cg23363484",3,0,0,0,3
"cg23363526",0,1,1,0,2
"cg23363818",3,0,0,0,3
"cg23365275",0,0,1,0,1
"cg23365392",0,1,0,0,1
"cg23365513",20,16,12,0,48
"cg23366930",102,26,0,0,128
"cg23367112",1,0,0,0,1
"cg23369114",0,0,1,0,1
"cg23369608",0,0,1,0,1
"cg23370167",0,0,1,0,1
"cg23371371",1,0,0,0,1
"cg23371542",0,1,0,0,1
"cg23371567",2,15,1,0,18
"cg23371570",0,0,1,0,1
"cg23371720",1,0,0,0,1
"cg23371800",0,0,1,0,1
"cg23372072",323,12,0,0,335
"cg23372178",0,0,6,0,6
"cg23372297",0,2,0,0,2
"cg23372773",0,0,1,0,1
"cg23373087",0,0,1,0,1
"cg23374864",0,1,1,0,2
"cg23375282",0,1,0,0,1
"cg23375379",2,2,0,0,4
"cg23375972",2,1,0,0,3
"cg23376467",100,4,0,0,104
"cg23376562",3,0,0,0,3
"cg23376757",1,0,0,0,1
"cg23377852",0,0,2,0,2
"cg23378108",0,0,1,0,1
"cg23378142",0,1,0,0,1
"cg23380039",0,2,0,0,2
"cg23380307",0,0,1,0,1
"cg23380440",0,1,0,0,1
"cg23381598",0,1,0,0,1
"cg23382101",0,0,1,0,1
"cg23383151",0,0,1,0,1
"cg23387874",310,11,0,0,321
"cg23388086",5,0,1,0,6
"cg23388451",0,0,2,0,2
"cg23389807",13,1,0,0,14
"cg23390488",2,5,5,0,12
"cg23392434",16,17,1,0,34
"cg23393076",0,0,3,0,3
"cg23393701",2,0,0,0,2
"cg23394916",0,1,0,0,1
"cg23395228",5,0,0,0,5
"cg23395298",0,0,2,0,2
"cg23396155",1,0,0,0,1
"cg23396751",0,0,9,0,9
"cg23397427",1,0,0,0,1
"cg23398073",0,0,2,0,2
"cg23402901",0,0,0,1,1
"cg23403072",1,0,2,0,3
"cg23404366",8,0,0,0,8
"cg23404902",0,1,0,0,1
"cg23405271",0,3,0,0,3
"cg23405364",0,0,1,0,1
"cg23405764",1,0,0,0,1
"cg23406436",0,1,0,0,1
"cg23406815",2,1,0,0,3
"cg23409145",0,0,1,0,1
"cg23409147",1,0,0,0,1
"cg23409835",0,0,0,2,2
"cg23410056",0,1,0,0,1
"cg23410145",1,0,0,0,1
"cg23411121",0,0,1,0,1
"cg23411274",0,0,1,0,1
"cg23411529",0,0,1,0,1
"cg23411654",0,3,1,0,4
"cg23412112",5,0,0,0,5
"cg23413001",1,0,0,0,1
"cg23413494",0,1,0,0,1
"cg23413547",0,0,4,0,4
"cg23413924",0,1,0,0,1
"cg23414149",341,19,1,0,361
"cg23414580",0,0,6,0,6
"cg23414734",0,0,1,0,1
"cg23416333",21,26,1,0,48
"cg23416777",0,0,1,0,1
"cg23417585",135,41,1,0,177
"cg23417643",1,0,1,0,2
"cg23417871",22,4,0,0,26
"cg23419974",39,4,0,0,43
"cg23420085",0,0,1,0,1
"cg23420331",0,1,0,0,1
"cg23421713",211,247,8,0,466
"cg23421923",0,1,0,0,1
"cg23422583",9,1,0,0,10
"cg23422587",1,0,0,0,1
"cg23423423",0,1,0,0,1
"cg23424035",0,0,1,0,1
"cg23424357",0,0,1,0,1
"cg23424400",1,0,0,0,1
"cg23424510",0,0,1,0,1
"cg23427408",0,1,1,0,2
"cg23427945",3,1,0,0,4
"cg23427973",0,4,1,0,5
"cg23429534",1,0,0,0,1
"cg23429664",1,3,0,0,4
"cg23431550",1,0,0,0,1
"cg23436167",1,1,0,0,2
"cg23437684",0,0,2,0,2
"cg23438371",23,9,0,0,32
"cg23438516",1,0,1,0,2
"cg23439361",0,0,1,0,1
"cg23439516",0,0,1,0,1
"cg23439947",0,0,0,1,1
"cg23440265",0,0,1,0,1
"cg23441030",10,1,0,0,11
"cg23441673",0,1,3,0,4
"cg23443853",0,0,1,0,1
"cg23444578",1,0,0,0,1
"cg23445828",0,2,3,0,5
"cg23445858",0,0,1,0,1
"cg23446055",7,0,0,0,7
"cg23448139",1,0,0,0,1
"cg23448249",0,1,0,0,1
"cg23448850",0,0,1,0,1
"cg23448937",0,0,1,0,1
"cg23448938",0,1,0,0,1
"cg23449122",0,0,1,0,1
"cg23450451",2,2,0,0,4
"cg23451423",1,0,0,0,1
"cg23453618",160,539,15,0,714
"cg23454512",0,0,3,0,3
"cg23455148",55,4,0,0,59
"cg23455651",3,3,0,0,6
"cg23455843",6,1,0,0,7
"cg23455982",1071,169,6,0,1246
"cg23456619",0,1,0,0,1
"cg23456642",3,0,0,0,3
"cg23458892",0,0,1,0,1
"cg23459174",4,2,0,0,6
"cg23459350",0,0,1,0,1
"cg23459416",2,0,0,0,2
"cg23461432",0,1,0,0,1
"cg23462071",1,0,0,0,1
"cg23462428",111,152,4,0,267
"cg23463205",1,0,0,0,1
"cg23463631",0,0,1,0,1
"cg23463700",0,0,1,0,1
"cg23464269",0,1,0,0,1
"cg23464504",6,12,0,0,18
"cg23464510",0,0,1,0,1
"cg23465426",1,0,0,0,1
"cg23465864",30,1,0,0,31
"cg23465967",0,1,0,0,1
"cg23466005",0,1,0,0,1
"cg23466054",3,0,0,0,3
"cg23466163",0,0,1,0,1
"cg23466339",3,0,0,0,3
"cg23466623",7,13,4,0,24
"cg23466887",5,13,0,0,18
"cg23468678",17,18,0,0,35
"cg23468845",3,1,1,0,5
"cg23469219",0,0,1,0,1
"cg23469230",3,5,7,0,15
"cg23470729",1,0,1,0,2
"cg23471770",0,0,1,0,1
"cg23472714",0,0,19,0,19
"cg23474036",1,0,0,0,1
"cg23474801",1,0,0,0,1
"cg23477241",28,15,2,0,45
"cg23478605",0,1,1,0,2
"cg23478979",0,0,1,0,1
"cg23479303",16,2,0,0,18
"cg23480097",5,0,0,0,5
"cg23480284",14,1,0,0,15
"cg23481024",0,1,0,0,1
"cg23481661",0,0,1,0,1
"cg23481735",34,13,0,0,47
"cg23481795",1,7,0,0,8
"cg23481825",0,2,0,0,2
"cg23482426",1,0,1,0,2
"cg23483790",1,0,0,0,1
"cg23484454",0,0,2,0,2
"cg23484912",0,3,1,0,4
"cg23485537",0,0,1,0,1
"cg23486105",1,0,0,0,1
"cg23486179",1,0,0,0,1
"cg23486661",1,0,0,0,1
"cg23488190",0,1,2,0,3
"cg23488509",11,17,13,0,41
"cg23488641",931,731,15,0,1677
"cg23489587",0,0,1,0,1
"cg23490161",0,0,1,0,1
"cg23492258",2,0,0,0,2
"cg23492413",22,0,0,0,22
"cg23492617",4,0,0,0,4
"cg23493464",7,0,0,0,7
"cg23493751",1,0,0,0,1
"cg23494069",0,0,1,0,1
"cg23495982",0,0,3,0,3
"cg23496534",2,2,0,0,4
"cg23497306",0,1,11,0,12
"cg23497529",220,6,0,0,226
"cg23499616",17,1,0,0,18
"cg23499789",2,3,0,0,5
"cg23499977",1,0,0,0,1
"cg23502888",4,6,2,0,12
"cg23502934",2,0,0,0,2
"cg23503388",0,1,0,0,1
"cg23504415",0,1,0,0,1
"cg23506313",4,2,1,0,7
"cg23506979",0,0,2,0,2
"cg23508885",12,0,1,0,13
"cg23509780",3,1,1,0,5
"cg23509850",1,0,0,0,1
"cg23510537",0,1,0,0,1
"cg23511179",1,0,0,0,1
"cg23512360",11,0,0,0,11
"cg23513318",1,0,0,0,1
"cg23513360",1,0,0,0,1
"cg23513686",0,1,0,0,1
"cg23514400",1,0,0,0,1
"cg23514410",1,0,0,0,1
"cg23515125",0,0,1,0,1
"cg23515556",12,5,17,0,34
"cg23516121",4,3,1,0,8
"cg23516537",1,0,0,0,1
"cg23518452",12,10,1,0,23
"cg23519421",48,1,0,0,49
"cg23520090",1,0,0,0,1
"cg23520458",4,7,0,0,11
"cg23524021",0,1,0,0,1
"cg23524047",0,6,0,0,6
"cg23524667",0,1,1,0,2
"cg23524765",4,1,0,0,5
"cg23525200",0,0,1,0,1
"cg23525377",3,6,4,0,13
"cg23525477",0,2,0,0,2
"cg23526104",1,0,0,0,1
"cg23526135",3,1,0,0,4
"cg23526435",1072,145,1,0,1218
"cg23526879",3,6,2,0,11
"cg23527984",0,0,1,0,1
"cg23528025",0,0,2,0,2
"cg23528105",1,0,0,0,1
"cg23528288",0,0,1,0,1
"cg23528715",0,1,0,0,1
"cg23528741",1,0,0,0,1
"cg23529010",0,1,0,0,1
"cg23529269",45,6,0,0,51
"cg23530473",0,2,0,0,2
"cg23530972",3,2,0,0,5
"cg23531150",1,0,0,0,1
"cg23531154",10,0,0,0,10
"cg23531592",194,218,12,0,424
"cg23531772",18,3,0,0,21
"cg23531828",8,1,3,0,12
"cg23534651",387,10,0,0,397
"cg23535429",6,2,0,0,8
"cg23536681",1,0,0,0,1
"cg23536856",1,0,0,0,1
"cg23538344",31,10,0,0,41
"cg23538468",0,0,10,0,10
"cg23539464",1,0,0,0,1
"cg23540282",2,2,6,0,10
"cg23541013",0,1,0,0,1
"cg23542414",78,123,726,0,927
"cg23542509",0,1,0,0,1
"cg23543596",0,0,2,0,2
"cg23544066",0,0,1,0,1
"cg23544957",1,0,0,0,1
"cg23546843",262,204,34,0,500
"cg23547515",0,1,2,0,3
"cg23548842",3,0,0,0,3
"cg23549579",0,2,9,0,11
"cg23550366",0,0,1,0,1
"cg23550962",1,0,0,0,1
"cg23551505",56,3,0,0,59
"cg23553720",1,0,2,0,3
"cg23556866",0,0,1,0,1
"cg23557769",0,2,1,0,3
"cg23558227",3,2,2,0,7
"cg23559062",2,14,0,0,16
"cg23559165",14,10,2,0,26
"cg23561971",1,0,0,0,1
"cg23562927",0,0,11,0,11
"cg23563014",1,0,0,0,1
"cg23563234",1,0,0,0,1
"cg23564257",567,194,2,0,763
"cg23564260",0,0,2,0,2
"cg23564907",2,0,0,0,2
"cg23565561",0,0,1,0,1
"cg23565563",1,0,0,0,1
"cg23566245",0,1,2,0,3
"cg23567315",1,0,0,0,1
"cg23567366",0,0,1,0,1
"cg23568068",0,0,3,0,3
"cg23571457",0,0,1,0,1
"cg23572163",0,0,1,0,1
"cg23573114",0,0,1,0,1
"cg23574899",0,1,0,0,1
"cg23580679",0,1,0,0,1
"cg23583168",1,1,1,0,3
"cg23583400",8,0,0,0,8
"cg23583777",0,0,1,0,1
"cg23585187",1,0,1,0,2
"cg23585624",0,1,0,0,1
"cg23585803",3,1,0,0,4
"cg23586012",2,0,0,0,2
"cg23586254",0,1,0,0,1
"cg23587005",0,0,1,0,1
"cg23587292",1,0,0,0,1
"cg23588782",0,2,0,0,2
"cg23589071",1,0,0,0,1
"cg23589419",0,0,4,0,4
"cg23589927",0,7,2,0,9
"cg23590916",0,1,1,0,2
"cg23591536",1,4,0,0,5
"cg23591595",0,0,2,0,2
"cg23592953",157,2,0,0,159
"cg23593208",1,0,0,0,1
"cg23593387",0,0,1,0,1
"cg23596249",0,1,0,0,1
"cg23596501",0,2,1,0,3
"cg23596986",0,1,0,0,1
"cg23597178",97,170,188,0,455
"cg23597244",0,2,17,0,19
"cg23597288",0,1,0,0,1
"cg23597907",21,3,0,0,24
"cg23599683",0,0,1,0,1
"cg23599878",0,1,2,0,3
"cg23599973",1,0,2,0,3
"cg23601035",0,1,1,0,2
"cg23601866",3,0,1,0,4
"cg23601891",0,0,1,0,1
"cg23606381",103,12,2,0,117
"cg23606417",814,39,0,0,853
"cg23608428",2,0,0,0,2
"cg23608469",0,0,1,0,1
"cg23609528",0,0,2,0,2
"cg23609713",1,0,0,0,1
"cg23610064",1,0,1,0,2
"cg23610820",1,1,3,0,5
"cg23611477",0,1,0,0,1
"cg23612095",3,11,8,0,22
"cg23612222",75,91,36,0,202
"cg23612484",0,0,1,0,1
"cg23613784",2,0,1,0,3
"cg23614652",1,1,0,0,2
"cg23616223",0,0,1,0,1
"cg23616241",2,0,1,0,3
"cg23616527",0,1,0,0,1
"cg23617640",8,0,0,0,8
"cg23617947",0,0,1,0,1
"cg23618179",6,5,0,0,11
"cg23618632",395,91,9,0,495
"cg23618658",0,1,0,0,1
"cg23619346",2,0,0,0,2
"cg23619461",1,0,0,0,1
"cg23619575",84,26,2,0,112
"cg23621212",1,0,0,0,1
"cg23621438",25,0,0,0,25
"cg23622026",4,0,0,0,4
"cg23622141",1,2,2,0,5
"cg23622369",0,0,1,0,1
"cg23622731",63,14,1,0,78
"cg23623364",0,0,1,0,1
"cg23624929",1,0,0,0,1
"cg23625514",0,0,1,0,1
"cg23625728",0,0,1,0,1
"cg23625753",1,0,0,0,1
"cg23626683",0,0,2,0,2
"cg23627057",2,2,0,0,4
"cg23627475",2,0,0,0,2
"cg23629561",3,2,3,0,8
"cg23630443",24,2,0,0,26
"cg23630926",2,4,2,0,8
"cg23631578",0,0,2,0,2
"cg23632029",0,1,0,0,1
"cg23633158",0,0,1,0,1
"cg23633556",0,0,0,1,1
"cg23633802",8,0,0,0,8
"cg23634177",0,1,6,0,7
"cg23636375",11,1,0,0,12
"cg23636994",0,1,1,0,2
"cg23637233",4,0,0,0,4
"cg23637327",0,0,1,0,1
"cg23638686",0,1,1,0,2
"cg23638725",0,0,2,0,2
"cg23639917",0,1,0,0,1
"cg23641672",113,381,252,0,746
"cg23641964",0,0,1,0,1
"cg23642334",236,223,2,0,461
"cg23642833",3,0,0,0,3
"cg23643565",8,5,0,0,13
"cg23643835",0,8,0,0,8
"cg23643973",0,1,1,0,2
"cg23644017",2,0,0,0,2
"cg23644437",3,0,0,0,3
"cg23644680",4,0,0,0,4
"cg23645639",3,1,0,0,4
"cg23645648",0,1,0,0,1
"cg23646337",1,0,0,0,1
"cg23647076",0,0,1,0,1
"cg23647744",300,26,1,0,327
"cg23648015",0,3,0,0,3
"cg23650813",2,0,0,0,2
"cg23653242",0,0,1,0,1
"cg23653724",0,0,1,0,1
"cg23654002",12,1,0,0,13
"cg23654767",0,3,0,0,3
"cg23655210",0,1,0,0,1
"cg23655658",0,0,1,0,1
"cg23655957",0,1,0,0,1
"cg23656485",1,0,0,0,1
"cg23657834",9,9,8,0,26
"cg23658814",0,1,0,0,1
"cg23659044",1,0,3,0,4
"cg23659863",1,0,0,0,1
"cg23660082",1,0,0,0,1
"cg23661676",0,0,1,0,1
"cg23662276",0,4,1,0,5
"cg23662411",0,1,0,0,1
"cg23663318",1,2,0,0,3
"cg23664334",0,0,1,0,1
"cg23664579",2,0,0,0,2
"cg23665147",0,1,0,0,1
"cg23668014",99,217,6,0,322
"cg23670121",3,1,0,0,4
"cg23670365",2,0,0,0,2
"cg23670387",1,0,0,0,1
"cg23670766",0,3,1,0,4
"cg23671051",0,0,7,0,7
"cg23671082",0,0,1,0,1
"cg23673147",0,0,1,0,1
"cg23673919",0,2,6,0,8
"cg23674217",1,0,0,0,1
"cg23675441",0,4,1,0,5
"cg23675807",1,1,0,0,2
"cg23678918",5,0,0,0,5
"cg23679141",0,1,0,0,1
"cg23679260",4,4,4,0,12
"cg23679434",0,0,2,0,2
"cg23680086",1,0,0,0,1
"cg23680099",0,0,1,0,1
"cg23682142",1,0,0,0,1
"cg23682255",1,0,0,0,1
"cg23682822",0,0,1,0,1
"cg23683290",0,1,0,0,1
"cg23683442",1,0,0,0,1
"cg23685102",1,1,0,0,2
"cg23685885",431,114,7,0,552
"cg23685953",15,3,2,0,20
"cg23685967",0,2,0,0,2
"cg23686303",5,2,2,0,9
"cg23686516",0,1,0,0,1
"cg23686976",7,0,0,0,7
"cg23687169",3,0,0,0,3
"cg23687958",1,0,0,0,1
"cg23688799",1,0,0,0,1
"cg23688809",1,0,0,0,1
"cg23689220",115,30,1,0,146
"cg23689419",39,2,1,0,42
"cg23689720",0,0,1,0,1
"cg23690077",1,1,1,1,4
"cg23691514",1,0,0,0,1
"cg23691873",2,0,0,0,2
"cg23691946",9,4,0,0,13
"cg23691995",0,0,1,0,1
"cg23693365",2,0,0,0,2
"cg23693380",3,0,2,0,5
"cg23694113",1,1,0,0,2
"cg23694799",1,0,0,0,1
"cg23697418",2,4,1,0,7
"cg23698017",0,0,2,0,2
"cg23698393",0,0,2,0,2
"cg23698832",2,0,0,0,2
"cg23698897",1,7,0,0,8
"cg23699046",0,0,0,1,1
"cg23699148",7,2,0,0,9
"cg23699309",0,2,0,0,2
"cg23699386",0,1,0,0,1
"cg23700513",2,2,3,0,7
"cg23702321",0,0,7,0,7
"cg23703347",5,0,0,0,5
"cg23705502",1,2,0,0,3
"cg23706161",2,0,4,0,6
"cg23706824",1,3,2,0,6
"cg23707091",3,0,0,0,3
"cg23707579",0,0,1,0,1
"cg23707912",4,0,0,0,4
"cg23708179",0,1,0,0,1
"cg23708569",0,0,1,0,1
"cg23709913",0,1,0,0,1
"cg23710475",2,0,0,0,2
"cg23710764",0,0,0,1,1
"cg23711139",0,0,1,0,1
"cg23711760",0,3,0,0,3
"cg23712884",116,382,94,0,592
"cg23714043",2,0,0,0,2
"cg23714184",29,10,1,0,40
"cg23717254",6,0,0,0,6
"cg23717539",0,1,0,0,1
"cg23717764",1,3,1,0,5
"cg23718351",4,0,0,0,4
"cg23719039",8,16,18,0,42
"cg23719124",0,0,1,0,1
"cg23720125",0,0,1,0,1
"cg23720519",49,3,0,0,52
"cg23721179",1,0,0,0,1
"cg23723262",1,0,0,0,1
"cg23726945",259,222,30,0,511
"cg23727081",1,0,0,0,1
"cg23727927",2,2,0,0,4
"cg23729681",0,0,1,0,1
"cg23730575",0,0,1,0,1
"cg23731934",2,0,0,0,2
"cg23732198",43,44,12,0,99
"cg23732631",0,3,0,0,3
"cg23733386",2,0,0,0,2
"cg23733502",5,0,0,0,5
"cg23734514",0,0,1,0,1
"cg23735973",0,1,0,0,1
"cg23737366",0,1,0,0,1
"cg23738083",0,0,1,0,1
"cg23738424",1,1,0,0,2
"cg23738842",1,0,0,0,1
"cg23739034",0,1,0,0,1
"cg23740417",0,0,1,0,1
"cg23740802",0,0,2,0,2
"cg23741255",1,9,0,0,10
"cg23741639",1,0,0,0,1
"cg23743428",0,0,1,0,1
"cg23743670",0,0,1,0,1
"cg23743911",0,0,1,0,1
"cg23746801",5,0,0,0,5
"cg23747461",1,0,0,0,1
"cg23748771",1,4,0,0,5
"cg23749091",1,0,0,0,1
"cg23750078",0,0,2,0,2
"cg23750200",0,0,10,0,10
"cg23750433",0,0,1,0,1
"cg23750895",0,1,9,0,10
"cg23751729",1,0,0,0,1
"cg23753502",25,6,0,0,31
"cg23754493",0,0,1,0,1
"cg23754712",1,0,0,0,1
"cg23756049",1,0,0,0,1
"cg23756238",0,0,1,0,1
"cg23757661",0,1,0,0,1
"cg23757773",0,1,0,0,1
"cg23758878",1,0,0,0,1
"cg23759214",1,0,0,0,1
"cg23759847",10,9,7,0,26
"cg23760102",275,135,9,0,419
"cg23762487",1,2,0,0,3
"cg23765027",0,2,7,0,9
"cg23766948",0,1,0,0,1
"cg23767242",1,0,0,0,1
"cg23767554",692,23,1,0,716
"cg23768702",1,1,0,0,2
"cg23769070",0,0,1,0,1
"cg23770008",1,1,0,0,2
"cg23770419",5,0,0,0,5
"cg23771530",0,1,0,0,1
"cg23772392",1,0,0,0,1
"cg23772463",1,1,0,0,2
"cg23773680",0,3,2,0,5
"cg23775961",2,17,0,0,19
"cg23776522",0,0,1,0,1
"cg23777559",0,1,0,0,1
"cg23777797",2,1,0,0,3
"cg23777848",0,2,0,0,2
"cg23779421",4,4,0,0,8
"cg23779567",0,0,1,0,1
"cg23780049",4,1,0,0,5
"cg23780294",1,0,0,0,1
"cg23781307",7,1,0,0,8
"cg23782119",4,0,1,0,5
"cg23782591",0,1,1,0,2
"cg23784912",0,0,1,0,1
"cg23785172",0,0,1,0,1
"cg23785275",0,1,0,0,1
"cg23787009",0,0,2,0,2
"cg23787163",1,0,0,0,1
"cg23787577",0,1,0,0,1
"cg23789769",2,0,0,0,2
"cg23790246",0,0,2,1,3
"cg23790942",0,6,0,0,6
"cg23792952",1,0,0,0,1
"cg23794753",1,0,1,0,2
"cg23796179",17,12,8,0,37
"cg23797424",0,0,2,0,2
"cg23797910",8,10,23,0,41
"cg23799056",1,0,0,0,1
"cg23800248",2,0,0,0,2
"cg23800437",345,97,2,0,444
"cg23801396",0,0,2,0,2
"cg23801674",10,1,0,0,11
"cg23804607",5,0,0,0,5
"cg23804649",0,0,2,0,2
"cg23806014",165,4,0,0,169
"cg23806097",1,0,0,0,1
"cg23806196",1,0,0,0,1
"cg23806261",31,28,5,0,64
"cg23807496",8,3,0,0,11
"cg23808165",0,0,0,1,1
"cg23808948",2,0,0,0,2
"cg23809030",1,1,0,0,2
"cg23809586",1,0,0,0,1
"cg23811995",1,0,0,0,1
"cg23812886",0,2,6,0,8
"cg23813556",0,0,2,0,2
"cg23814184",0,0,3,0,3
"cg23814273",8,0,0,0,8
"cg23815383",0,0,1,0,1
"cg23818307",0,2,1,0,3
"cg23819257",0,3,0,0,3
"cg23820090",0,0,4,0,4
"cg23820302",2,0,5,0,7
"cg23821145",1,0,0,0,1
"cg23821337",60,11,0,0,71
"cg23821590",1,0,0,0,1
"cg23821945",545,43,1,0,589
"cg23824488",2,0,0,0,2
"cg23824549",0,0,1,0,1
"cg23826320",364,80,3,0,447
"cg23826579",11,1,1,0,13
"cg23827787",0,0,1,0,1
"cg23827972",0,3,7,0,10
"cg23827991",0,0,2,0,2
"cg23828630",3,0,0,0,3
"cg23829256",0,0,1,0,1
"cg23829584",2,0,0,0,2
"cg23830023",1,0,0,0,1
"cg23830052",0,1,0,0,1
"cg23830984",0,1,0,0,1
"cg23831893",0,0,1,2,3
"cg23832113",0,0,1,0,1
"cg23832895",2,0,0,0,2
"cg23833009",698,415,6,0,1119
"cg23833371",1,0,0,0,1
"cg23834813",133,87,14,0,234
"cg23835034",1,0,0,0,1
"cg23835686",0,1,0,0,1
"cg23835821",1,0,0,0,1
"cg23836113",27,2,0,0,29
"cg23836357",0,1,0,0,1
"cg23836413",86,396,37,0,519
"cg23837211",1,4,3,0,8
"cg23839938",0,0,0,1,1
"cg23840115",1,0,0,0,1
"cg23840738",0,0,1,0,1
"cg23840854",0,3,0,0,3
"cg23841280",0,1,0,0,1
"cg23841538",111,90,2,0,203
"cg23841726",0,1,0,0,1
"cg23841786",0,1,1,0,2
"cg23841836",0,0,1,0,1
"cg23842532",7,0,0,0,7
"cg23843045",5,0,0,0,5
"cg23845206",0,0,1,0,1
"cg23845534",0,1,0,0,1
"cg23846235",84,3,0,0,87
"cg23846461",1,0,0,0,1
"cg23846955",0,0,1,0,1
"cg23847534",0,0,2,0,2
"cg23847908",0,0,1,0,1
"cg23848152",0,0,1,0,1
"cg23848624",1,0,0,0,1
"cg23849327",0,1,0,0,1
"cg23850283",0,0,1,0,1
"cg23850360",0,1,0,0,1
"cg23850361",0,1,0,0,1
"cg23850453",0,0,1,0,1
"cg23851043",286,714,67,0,1067
"cg23851409",0,1,0,0,1
"cg23852248",0,0,1,0,1
"cg23854246",0,1,0,0,1
"cg23855365",1,2,2,0,5
"cg23855879",5,0,0,0,5
"cg23857447",706,97,1,0,804
"cg23858752",0,0,1,0,1
"cg23859703",0,0,1,0,1
"cg23859931",1,0,0,0,1
"cg23859944",0,1,0,0,1
"cg23860436",1,1,0,0,2
"cg23861101",110,285,285,0,680
"cg23862395",7,0,1,0,8
"cg23862978",0,3,1,0,4
"cg23863769",11,3,0,0,14
"cg23864372",1,0,0,0,1
"cg23866840",579,291,6,0,876
"cg23867978",0,0,3,0,3
"cg23871133",3,3,1,0,7
"cg23871248",0,0,1,0,1
"cg23871533",199,75,2,0,276
"cg23871563",0,0,1,0,1
"cg23872116",1,0,2,0,3
"cg23873027",0,0,1,0,1
"cg23873662",3,0,0,0,3
"cg23873735",0,0,1,0,1
"cg23874587",53,41,1,0,95
"cg23876894",0,0,0,1,1
"cg23877512",10,1,0,0,11
"cg23877734",0,0,1,0,1
"cg23877765",1,0,0,0,1
"cg23877906",1,0,0,0,1
"cg23877998",4,0,0,0,4
"cg23878768",1,1,0,0,2
"cg23878917",271,11,0,0,282
"cg23879355",1,0,0,0,1
"cg23880151",0,3,0,0,3
"cg23880781",0,1,0,0,1
"cg23881884",2,0,0,0,2
"cg23882815",2,0,1,0,3
"cg23883036",134,3,0,0,137
"cg23883265",6,13,0,0,19
"cg23884502",4,0,1,0,5
"cg23884954",0,1,0,0,1
"cg23885865",1,1,0,0,2
"cg23885971",72,143,1,0,216
"cg23887125",2,0,0,0,2
"cg23887326",0,0,1,0,1
"cg23887819",1,0,0,0,1
"cg23888345",5,0,0,0,5
"cg23888776",1,0,1,0,2
"cg23889301",58,1,0,0,59
"cg23889914",0,0,1,0,1
"cg23889940",2,0,0,0,2
"cg23890008",0,1,0,0,1
"cg23892025",1,0,0,0,1
"cg23893792",111,22,0,0,133
"cg23894227",2,19,0,0,21
"cg23894579",454,17,0,0,471
"cg23894755",604,44,1,0,649
"cg23895439",0,0,1,0,1
"cg23896876",10,5,1,0,16
"cg23898292",0,3,1,0,4
"cg23899274",1,0,0,0,1
"cg23899377",1,0,0,0,1
"cg23899527",1,0,0,0,1
"cg23899649",0,1,0,0,1
"cg23900279",0,2,0,0,2
"cg23902621",1,0,0,0,1
"cg23903123",0,1,0,0,1
"cg23903809",0,2,0,0,2
"cg23903856",0,0,1,0,1
"cg23904010",1,5,2,0,8
"cg23905232",1,1,0,0,2
"cg23905618",0,0,1,0,1
"cg23906085",45,6,0,0,51
"cg23907424",0,0,1,0,1
"cg23907453",3,0,0,0,3
"cg23909158",0,0,1,0,1
"cg23909368",86,361,260,0,707
"cg23909930",2,0,0,0,2
"cg23910324",1,0,0,0,1
"cg23911553",0,1,0,0,1
"cg23912465",1,1,0,0,2
"cg23913018",0,1,0,0,1
"cg23913123",0,1,0,0,1
"cg23917638",0,1,0,0,1
"cg23917680",35,50,0,0,85
"cg23918954",1,2,1,0,4
"cg23919038",0,1,0,0,1
"cg23919534",1,0,0,0,1
"cg23919830",2,2,0,0,4
"cg23919924",0,1,3,0,4
"cg23920325",0,0,1,0,1
"cg23920423",72,12,0,0,84
"cg23920748",0,0,1,0,1
"cg23921249",1,0,2,0,3
"cg23921860",0,3,0,0,3
"cg23921928",2,0,0,0,2
"cg23922973",0,0,2,0,2
"cg23924241",36,2,0,0,38
"cg23924753",40,15,1,0,56
"cg23924911",0,2,0,0,2
"cg23924977",0,2,1,0,3
"cg23925185",1,0,0,0,1
"cg23925199",2,0,0,0,2
"cg23925370",0,1,1,0,2
"cg23925558",499,757,39,0,1295
"cg23925613",0,1,0,0,1
"cg23926889",1,2,0,0,3
"cg23927014",0,1,0,0,1
"cg23928032",0,0,1,0,1
"cg23928118",2,0,0,0,2
"cg23928292",6,0,0,0,6
"cg23928333",2,0,0,0,2
"cg23928360",1,0,0,0,1
"cg23929269",1,0,0,0,1
"cg23930030",2,0,0,0,2
"cg23930763",1,0,0,0,1
"cg23931180",1,2,0,0,3
"cg23931629",0,0,1,0,1
"cg23931755",0,0,0,1,1
"cg23932674",1,0,0,0,1
"cg23933179",420,53,3,0,476
"cg23935361",4,0,0,0,4
"cg23935447",0,0,1,0,1
"cg23936196",0,1,0,0,1
"cg23936476",1,0,1,0,2
"cg23936681",69,32,1,0,102
"cg23937387",0,1,1,0,2
"cg23938892",0,1,0,0,1
"cg23938975",1,0,0,0,1
"cg23940486",1,0,0,0,1
"cg23940568",0,1,0,0,1
"cg23942599",0,1,2,0,3
"cg23942717",6,23,1,0,30
"cg23942884",1,0,0,0,1
"cg23943207",3,1,0,0,4
"cg23944005",1,2,0,0,3
"cg23944232",0,0,1,0,1
"cg23944409",0,0,2,0,2
"cg23944440",3,2,0,0,5
"cg23944790",1,1,3,6,11
"cg23946919",1,0,1,0,2
"cg23948876",3,5,2,0,10
"cg23949078",0,1,0,0,1
"cg23949925",0,0,1,0,1
"cg23950232",0,0,2,0,2
"cg23950473",0,1,0,0,1
"cg23950881",0,1,0,0,1
"cg23951861",0,0,1,0,1
"cg23952253",38,17,0,0,55
"cg23952581",13,9,5,0,27
"cg23952643",0,1,0,0,1
"cg23952687",658,24,1,0,683
"cg23954518",20,4,0,0,24
"cg23955495",13,5,1,0,19
"cg23955979",2,1,2,0,5
"cg23957397",1,2,0,0,3
"cg23957525",10,0,0,0,10
"cg23959118",0,1,0,0,1
"cg23959252",0,1,2,0,3
"cg23959482",0,0,1,1,2
"cg23960781",156,28,0,0,184
"cg23961091",1,1,0,0,2
"cg23961865",614,828,120,0,1562
"cg23962872",0,5,25,0,30
"cg23963038",0,0,1,0,1
"cg23963224",0,0,1,0,1
"cg23965289",0,1,0,0,1
"cg23965634",0,1,0,0,1
"cg23965712",0,0,1,0,1
"cg23966068",1,0,0,0,1
"cg23967193",3,2,2,0,7
"cg23967505",0,0,1,0,1
"cg23967850",1,0,0,0,1
"cg23969987",1,0,0,0,1
"cg23970028",0,1,2,0,3
"cg23972347",3,0,0,0,3
"cg23974065",0,1,3,0,4
"cg23975564",33,18,4,0,55
"cg23976142",0,1,2,0,3
"cg23976179",55,16,1,0,72
"cg23976192",0,1,1,0,2
"cg23976274",0,1,0,0,1
"cg23978390",1,5,0,0,6
"cg23978449",0,0,3,0,3
"cg23979481",2,2,8,0,12
"cg23982617",0,0,1,0,1
"cg23983136",6,6,0,0,12
"cg23983334",0,0,1,0,1
"cg23983438",38,5,0,0,43
"cg23984305",38,4,0,0,42
"cg23984728",2,1,0,0,3
"cg23985239",0,0,1,0,1
"cg23986148",0,0,1,0,1
"cg23986219",1,0,0,0,1
"cg23986375",0,3,0,0,3
"cg23986376",1,0,0,0,1
"cg23986550",0,2,1,0,3
"cg23987345",0,0,1,0,1
"cg23989244",5,0,1,0,6
"cg23989579",0,0,1,0,1
"cg23989712",5,0,0,0,5
"cg23989737",0,1,1,0,2
"cg23990641",0,2,1,0,3
"cg23990929",4,0,0,0,4
"cg23991057",3,3,0,0,6
"cg23992568",11,0,0,0,11
"cg23994509",0,1,0,0,1
"cg23994622",1,0,0,0,1
"cg23994624",1,0,0,0,1
"cg23994646",1,0,0,0,1
"cg23994802",0,0,1,0,1
"cg23995231",0,1,5,0,6
"cg23995666",1,2,0,0,3
"cg23995738",0,0,1,0,1
"cg23995933",3,4,2,0,9
"cg23996704",0,0,1,0,1
"cg23996873",1,3,1,0,5
"cg23997034",0,2,1,0,3
"cg23997508",0,1,2,0,3
"cg23997782",0,1,0,0,1
"cg23998414",0,0,1,0,1
"cg23998645",2,0,0,0,2
"cg23998654",0,0,1,0,1
"cg23999337",91,3,0,0,94
"cg24000259",0,1,0,0,1
"cg24000829",3,0,0,0,3
"cg24000912",3,1,2,0,6
"cg24002847",0,0,1,0,1
"cg24002907",68,24,7,0,99
"cg24003001",0,3,0,0,3
"cg24003221",46,2,0,0,48
"cg24003292",0,0,5,0,5
"cg24003539",24,15,0,0,39
"cg24003666",1,0,0,0,1
"cg24004178",0,1,0,0,1
"cg24004449",2,0,1,0,3
"cg24004547",9,0,0,0,9
"cg24005360",0,0,1,0,1
"cg24005701",0,0,3,0,3
"cg24005950",0,0,1,0,1
"cg24006078",0,0,1,0,1
"cg24006695",2,0,0,0,2
"cg24006991",0,0,1,0,1
"cg24007638",0,0,1,0,1
"cg24008280",0,0,1,0,1
"cg24008510",1,0,0,0,1
"cg24008516",253,11,0,0,264
"cg24008668",2,0,0,0,2
"cg24009255",1,3,8,0,12
"cg24009274",1,0,0,0,1
"cg24009707",81,39,0,0,120
"cg24010276",0,0,3,0,3
"cg24011046",0,1,0,0,1
"cg24011256",1,0,0,0,1
"cg24011405",0,1,0,0,1
"cg24012574",0,0,1,0,1
"cg24013697",4,5,0,0,9
"cg24013779",1,0,0,0,1
"cg24014743",1,1,0,0,2
"cg24015022",1,1,0,0,2
"cg24015802",1,0,0,0,1
"cg24016444",0,1,0,0,1
"cg24016617",188,12,0,0,200
"cg24016855",1,0,0,0,1
"cg24017580",0,0,23,0,23
"cg24018232",0,0,1,0,1
"cg24021850",0,2,0,0,2
"cg24023039",1,0,0,0,1
"cg24023157",40,21,0,0,61
"cg24023553",3,0,0,0,3
"cg24024783",1,0,0,0,1
"cg24025801",67,6,0,0,73
"cg24025825",0,29,0,0,29
"cg24026092",9,0,0,0,9
"cg24026570",1,0,0,0,1
"cg24026732",0,1,0,0,1
"cg24028141",0,1,0,0,1
"cg24029715",0,1,1,0,2
"cg24030277",0,2,2,0,4
"cg24030609",0,1,0,0,1
"cg24030996",3,1,0,0,4
"cg24031245",0,0,1,0,1
"cg24031524",1,7,3,0,11
"cg24033278",0,0,1,0,1
"cg24033841",0,0,1,0,1
"cg24034957",664,746,35,0,1445
"cg24036126",1,0,0,0,1
"cg24037831",3,1,0,0,4
"cg24037897",0,1,0,0,1
"cg24038745",0,2,1,0,3
"cg24039314",2,0,0,0,2
"cg24039603",138,522,15,0,675
"cg24040106",29,1,0,0,30
"cg24040115",1,2,0,0,3
"cg24040502",0,0,1,0,1
"cg24040725",0,1,0,0,1
"cg24041246",0,0,2,0,2
"cg24041663",1,0,0,0,1
"cg24043861",2,0,4,0,6
"cg24044254",2,2,1,0,5
"cg24044654",0,1,0,0,1
"cg24044776",0,1,0,0,1
"cg24045270",0,1,0,0,1
"cg24047214",0,0,20,0,20
"cg24047905",3,0,0,0,3
"cg24048209",365,102,4,0,471
"cg24048283",0,1,0,0,1
"cg24048585",1,0,0,0,1
"cg24049294",1,0,0,0,1
"cg24050109",0,1,0,0,1
"cg24050307",0,0,1,0,1
"cg24051456",0,0,1,0,1
"cg24052097",0,1,0,0,1
"cg24052263",0,0,1,0,1
"cg24053148",123,22,0,0,145
"cg24054275",1,0,0,0,1
"cg24055852",0,0,0,1,1
"cg24056123",0,1,0,0,1
"cg24057255",1,1,1,0,3
"cg24057491",0,0,1,0,1
"cg24058013",0,3,3,0,6
"cg24060571",0,0,1,0,1
"cg24060917",0,0,1,0,1
"cg24061048",1,0,0,0,1
"cg24062536",0,0,1,0,1
"cg24063594",259,208,2,0,469
"cg24063645",0,0,3,0,3
"cg24064581",1,0,0,0,1
"cg24065991",3,0,0,0,3
"cg24066045",2,0,3,0,5
"cg24066601",4,0,0,0,4
"cg24066680",1,0,0,0,1
"cg24068053",297,36,13,0,346
"cg24068095",67,4,0,0,71
"cg24069048",0,1,0,0,1
"cg24069489",0,0,1,0,1
"cg24070014",0,1,0,0,1
"cg24070292",1,1,1,0,3
"cg24072202",4,5,1,0,10
"cg24073023",0,0,2,0,2
"cg24073060",194,838,20,0,1052
"cg24073418",20,0,0,0,20
"cg24073546",0,1,0,0,1
"cg24073653",2,0,0,0,2
"cg24073712",1,0,0,0,1
"cg24074054",37,2,0,0,39
"cg24074253",0,1,0,0,1
"cg24075136",0,0,1,0,1
"cg24075208",0,0,2,0,2
"cg24077076",0,2,1,0,3
"cg24077401",0,1,0,0,1
"cg24077584",1,0,0,0,1
"cg24078043",19,12,1,0,32
"cg24078359",251,20,1,0,272
"cg24078387",1,0,0,0,1
"cg24078767",3,0,0,0,3
"cg24079051",1,0,0,0,1
"cg24079250",7,0,0,0,7
"cg24079853",1,0,0,0,1
"cg24080274",1,0,0,0,1
"cg24081553",422,183,18,0,623
"cg24082676",19,2,0,0,21
"cg24082840",0,0,1,0,1
"cg24083614",0,0,0,1,1
"cg24083627",0,1,0,0,1
"cg24084128",0,0,1,0,1
"cg24084815",0,1,0,0,1
"cg24084951",0,0,1,0,1
"cg24085207",1,0,0,0,1
"cg24085570",0,0,1,0,1
"cg24087515",86,8,0,0,94
"cg24088323",1,0,0,0,1
"cg24090399",0,1,0,0,1
"cg24090696",0,0,5,0,5
"cg24090872",0,1,0,0,1
"cg24091270",2,1,0,0,3
"cg24091472",1,0,0,0,1
"cg24091498",0,0,6,0,6
"cg24091810",1,0,0,0,1
"cg24092914",9,0,0,0,9
"cg24093429",1,0,0,0,1
"cg24094460",335,30,2,0,367
"cg24094762",0,0,1,0,1
"cg24095222",0,1,1,0,2
"cg24095864",0,4,8,0,12
"cg24096925",1,0,0,0,1
"cg24098530",0,1,0,0,1
"cg24098859",0,0,1,0,1
"cg24099067",0,0,2,0,2
"cg24101933",1,0,0,0,1
"cg24101945",186,39,5,0,230
"cg24102163",0,0,1,0,1
"cg24102457",0,2,0,0,2
"cg24102491",137,17,2,0,156
"cg24102570",0,0,1,0,1
"cg24102959",0,0,4,0,4
"cg24103302",0,2,0,0,2
"cg24104241",0,0,1,0,1
"cg24104262",1,0,0,0,1
"cg24104268",0,1,0,0,1
"cg24104528",0,1,0,0,1
"cg24104569",2,1,0,0,3
"cg24104623",1,1,0,0,2
"cg24104627",271,109,4,0,384
"cg24105207",1,0,0,0,1
"cg24107165",4,0,0,0,4
"cg24107674",102,56,7,0,165
"cg24107732",6,4,0,0,10
"cg24108215",0,2,0,0,2
"cg24110570",1,0,0,0,1
"cg24113449",1,0,0,0,1
"cg24113503",2,4,0,0,6
"cg24114762",0,1,0,0,1
"cg24117185",1,0,1,0,2
"cg24117372",81,237,53,0,371
"cg24118895",9,15,13,0,37
"cg24120822",0,1,0,0,1
"cg24123679",3,0,0,0,3
"cg24124284",19,4,1,0,24
"cg24124420",1,0,0,0,1
"cg24124798",0,1,0,0,1
"cg24125489",26,6,2,0,34
"cg24125705",0,1,0,0,1
"cg24126491",0,0,1,0,1
"cg24126888",0,0,11,0,11
"cg24126931",0,1,0,0,1
"cg24127592",0,0,1,0,1
"cg24127965",1,1,1,0,3
"cg24129471",0,1,0,0,1
"cg24129904",0,0,1,0,1
"cg24130055",1,10,0,0,11
"cg24131116",9,1,1,0,11
"cg24132523",0,1,0,0,1
"cg24132580",0,1,0,0,1
"cg24132800",26,1,0,0,27
"cg24134056",0,5,1,0,6
"cg24134481",0,1,1,0,2
"cg24134504",0,0,2,0,2
"cg24134672",0,0,1,0,1
"cg24134789",88,6,0,0,94
"cg24134880",26,0,0,0,26
"cg24134935",0,1,1,0,2
"cg24135336",0,0,1,0,1
"cg24135682",0,0,1,0,1
"cg24136255",0,0,1,0,1
"cg24136288",1,0,0,0,1
"cg24138476",2,1,0,0,3
"cg24140182",0,2,0,0,2
"cg24140801",12,4,0,0,16
"cg24140860",1,0,0,0,1
"cg24141198",1,0,0,0,1
"cg24142503",9,3,0,0,12
"cg24142958",0,0,1,0,1
"cg24145845",0,0,1,0,1
"cg24146297",0,0,2,0,2
"cg24146830",68,7,1,0,76
"cg24147024",4,0,0,0,4
"cg24147258",0,1,0,0,1
"cg24147830",4,1,0,0,5
"cg24147915",1,1,1,0,3
"cg24148337",0,1,0,0,1
"cg24148699",0,2,1,0,3
"cg24148757",32,0,0,0,32
"cg24148920",195,25,0,0,220
"cg24150548",0,0,1,0,1
"cg24152238",0,0,1,0,1
"cg24152390",1,0,0,0,1
"cg24154465",1,0,0,0,1
"cg24154625",1,0,0,0,1
"cg24155309",8,2,0,0,10
"cg24155748",0,0,3,0,3
"cg24156054",1,0,0,0,1
"cg24156149",4,0,0,0,4
"cg24156307",0,0,1,0,1
"cg24156524",2,0,0,0,2
"cg24156537",0,0,1,0,1
"cg24156785",3,1,0,0,4
"cg24157008",35,0,0,0,35
"cg24157219",28,7,0,0,35
"cg24157984",0,0,1,0,1
"cg24159447",1,0,0,0,1
"cg24159721",0,0,0,1,1
"cg24159934",0,1,0,0,1
"cg24160009",0,1,1,0,2
"cg24161812",1,1,1,0,3
"cg24162465",31,9,0,0,40
"cg24162965",1,1,0,0,2
"cg24163448",1,0,0,0,1
"cg24166144",5,0,0,0,5
"cg24168083",1,0,0,0,1
"cg24168484",0,0,1,0,1
"cg24169503",10,20,8,0,38
"cg24169816",4,0,0,0,4
"cg24170212",1,0,0,0,1
"cg24170566",33,5,0,0,38
"cg24171934",3,4,3,0,10
"cg24172675",1,0,0,0,1
"cg24173282",4,0,0,0,4
"cg24173584",10,0,0,0,10
"cg24174281",7,1,0,0,8
"cg24174925",181,17,0,0,198
"cg24175288",0,1,0,0,1
"cg24176009",0,2,1,0,3
"cg24176680",0,3,7,0,10
"cg24177690",0,3,0,0,3
"cg24178134",1,1,1,0,3
"cg24180121",1,0,0,0,1
"cg24180805",14,0,0,0,14
"cg24180901",45,0,0,0,45
"cg24181763",0,0,1,0,1
"cg24182618",10,2,0,0,12
"cg24183504",0,1,8,0,9
"cg24183816",1,0,0,0,1
"cg24185124",2,4,1,0,7
"cg24185531",89,14,0,0,103
"cg24186711",0,0,12,0,12
"cg24188954",0,0,1,0,1
"cg24189264",0,0,1,0,1
"cg24191049",1,0,0,0,1
"cg24192264",0,0,1,0,1
"cg24192671",0,0,1,0,1
"cg24193669",1,3,0,0,4
"cg24193797",4,0,0,0,4
"cg24193946",1,0,0,0,1
"cg24194093",50,3,0,0,53
"cg24194756",8,0,0,0,8
"cg24194998",0,1,0,0,1
"cg24195169",4,1,0,0,5
"cg24197059",1,1,0,0,2
"cg24198990",0,0,1,0,1
"cg24200137",5,4,1,0,10
"cg24201129",4,0,0,0,4
"cg24202520",3,1,0,0,4
"cg24202638",460,1207,153,0,1820
"cg24203192",4,0,0,0,4
"cg24203741",0,0,1,0,1
"cg24203821",6,2,0,0,8
"cg24203960",12,2,0,0,14
"cg24206978",0,0,1,0,1
"cg24209550",1,0,0,0,1
"cg24209723",1,0,1,0,2
"cg24209994",743,24,1,0,768
"cg24210742",118,9,0,0,127
"cg24211775",0,0,3,0,3
"cg24211779",0,1,0,0,1
"cg24212302",222,10,0,0,232
"cg24212677",5,3,0,0,8
"cg24216326",0,0,2,0,2
"cg24216862",0,0,1,0,1
"cg24217980",377,21,0,0,398
"cg24218753",5,5,0,0,10
"cg24218935",0,0,1,0,1
"cg24219033",3,0,0,0,3
"cg24220283",0,0,1,0,1
"cg24221398",13,3,1,0,17
"cg24221633",1,0,0,0,1
"cg24221642",0,0,1,0,1
"cg24222992",118,30,0,0,148
"cg24225658",1,0,0,0,1
"cg24226414",0,1,0,0,1
"cg24228583",5,0,1,0,6
"cg24229146",11,0,0,0,11
"cg24232343",25,4,0,0,29
"cg24232660",0,1,0,0,1
"cg24232869",0,1,0,0,1
"cg24233487",1,0,0,0,1
"cg24234827",18,6,1,0,25
"cg24235774",0,0,0,1,1
"cg24236146",0,0,1,0,1
"cg24236654",7,11,14,0,32
"cg24237397",0,2,1,0,3
"cg24238441",1,0,0,0,1
"cg24239030",477,42,1,0,520
"cg24239056",4,2,0,0,6
"cg24239123",1,0,1,0,2
"cg24239266",0,1,0,0,1
"cg24240169",0,0,1,0,1
"cg24241281",0,0,1,0,1
"cg24241282",0,0,1,0,1
"cg24242768",0,1,1,0,2
"cg24242856",2,0,0,0,2
"cg24243406",0,1,0,0,1
"cg24243790",5,4,0,0,9
"cg24244695",1,0,0,0,1
"cg24244718",1,0,0,0,1
"cg24245352",0,0,1,0,1
"cg24245742",2,2,0,0,4
"cg24245773",1,0,0,0,1
"cg24246174",58,40,3,0,101
"cg24247577",94,109,16,0,219
"cg24247883",0,0,1,0,1
"cg24248083",42,2,0,0,44
"cg24251119",41,9,0,0,50
"cg24252809",0,0,0,1,1
"cg24253099",0,0,1,0,1
"cg24255159",1,1,0,0,2
"cg24255324",221,36,2,0,259
"cg24255556",0,1,0,0,1
"cg24256249",0,0,1,0,1
"cg24256637",0,1,0,0,1
"cg24256836",0,0,3,0,3
"cg24256839",0,0,1,0,1
"cg24258005",0,1,0,0,1
"cg24258588",0,0,1,0,1
"cg24260627",0,1,0,0,1
"cg24261289",2,1,0,0,3
"cg24261594",281,22,1,0,304
"cg24262335",0,0,1,0,1
"cg24262715",0,0,1,0,1
"cg24262941",1,0,0,0,1
"cg24264239",0,0,1,0,1
"cg24265865",0,0,2,0,2
"cg24266656",0,1,0,0,1
"cg24267378",0,0,1,0,1
"cg24267734",12,0,0,0,12
"cg24268446",2,0,0,0,2
"cg24268663",0,1,0,0,1
"cg24270624",0,0,1,0,1
"cg24273318",0,3,0,0,3
"cg24274053",1,2,1,0,4
"cg24274354",1,0,4,0,5
"cg24275100",9,3,6,0,18
"cg24275195",2,0,0,0,2
"cg24276040",3,0,0,0,3
"cg24277147",0,0,5,0,5
"cg24277262",0,0,6,0,6
"cg24278033",0,0,1,0,1
"cg24278634",10,1,0,0,11
"cg24278733",457,14,1,0,472
"cg24279914",1,1,0,0,2
"cg24280512",0,1,0,0,1
"cg24281117",3,4,1,0,8
"cg24281965",0,0,1,0,1
"cg24282829",21,10,3,0,34
"cg24283289",0,0,2,0,2
"cg24285721",4,1,0,0,5
"cg24285811",0,0,1,0,1
"cg24288751",2,2,0,0,4
"cg24289553",0,0,1,0,1
"cg24290878",1,0,0,0,1
"cg24290980",1,2,1,0,4
"cg24291318",0,2,0,0,2
"cg24291485",1,0,0,0,1
"cg24291718",0,0,1,0,1
"cg24291991",1,0,0,0,1
"cg24292057",0,0,1,0,1
"cg24292204",0,0,1,0,1
"cg24292235",0,0,1,0,1
"cg24293145",2,1,0,0,3
"cg24293898",10,1,0,0,11
"cg24294672",0,0,1,0,1
"cg24296250",0,0,0,1,1
"cg24296440",1,0,0,0,1
"cg24296569",1,0,0,0,1
"cg24296621",0,1,0,0,1
"cg24297421",2,1,0,0,3
"cg24297800",3,3,1,0,7
"cg24298329",9,2,3,0,14
"cg24298514",264,114,18,0,396
"cg24298822",0,1,0,0,1
"cg24299149",169,388,31,0,588
"cg24299647",2,1,0,0,3
"cg24299847",19,9,1,0,29
"cg24299929",6,3,1,0,10
"cg24300030",0,1,0,0,1
"cg24300033",0,0,1,0,1
"cg24300962",212,350,69,0,631
"cg24301534",0,0,0,1,1
"cg24303232",2,0,0,0,2
"cg24304733",10,1,0,0,11
"cg24305127",4,3,2,0,9
"cg24305683",1,0,0,0,1
"cg24305993",2,2,0,0,4
"cg24306047",0,0,3,0,3
"cg24307449",0,1,0,0,1
"cg24307649",1,0,0,0,1
"cg24307703",24,6,0,0,30
"cg24309076",8,0,0,0,8
"cg24309263",2,0,0,0,2
"cg24309748",79,3,0,0,82
"cg24309859",1,1,2,0,4
"cg24309905",0,0,1,0,1
"cg24312321",0,1,0,0,1
"cg24312492",0,0,1,0,1
"cg24312588",15,17,7,0,39
"cg24312896",1,0,0,0,1
"cg24313473",2,4,2,0,8
"cg24314300",1,0,0,0,1
"cg24314430",0,1,0,0,1
"cg24315257",11,0,0,0,11
"cg24315833",0,0,1,0,1
"cg24316231",1,0,0,0,1
"cg24317935",0,1,0,0,1
"cg24317979",0,0,1,0,1
"cg24318365",0,4,4,0,8
"cg24319167",1,0,1,0,2
"cg24320065",67,444,20,0,531
"cg24320113",1,0,0,0,1
"cg24322057",3,0,0,0,3
"cg24322131",0,1,0,0,1
"cg24322668",0,0,1,0,1
"cg24323340",0,0,3,0,3
"cg24324738",0,2,6,0,8
"cg24324942",4,0,0,0,4
"cg24325275",0,0,1,0,1
"cg24327389",1,6,4,0,11
"cg24327491",618,127,4,0,749
"cg24327542",22,22,3,0,47
"cg24328279",0,0,1,0,1
"cg24328884",0,1,0,0,1
"cg24329374",1,0,0,0,1
"cg24331317",70,21,0,0,91
"cg24332017",0,0,2,0,2
"cg24332298",1,0,0,0,1
"cg24332921",2,1,0,0,3
"cg24333290",16,3,1,0,20
"cg24333798",0,0,1,0,1
"cg24334002",2,0,0,0,2
"cg24334391",1,0,0,0,1
"cg24334438",1,0,0,0,1
"cg24334838",0,0,1,0,1
"cg24335620",0,12,0,0,12
"cg24336590",1,3,0,0,4
"cg24337310",1,1,0,0,2
"cg24337318",0,1,0,0,1
"cg24338076",1,1,0,0,2
"cg24338513",77,52,5,0,134
"cg24338756",0,1,0,0,1
"cg24340333",1,0,0,0,1
"cg24340453",0,2,0,0,2
"cg24340556",1,0,0,0,1
"cg24341028",0,0,1,0,1
"cg24341236",0,0,1,0,1
"cg24341406",18,5,1,0,24
"cg24343131",0,0,1,0,1
"cg24344406",2,0,1,0,3
"cg24344787",10,6,5,0,21
"cg24345070",2,1,0,0,3
"cg24345166",84,6,0,0,90
"cg24346124",0,0,2,0,2
"cg24346335",0,0,1,0,1
"cg24347508",0,1,0,0,1
"cg24347842",7,2,2,0,11
"cg24348466",175,1,0,0,176
"cg24348786",562,206,3,0,771
"cg24349399",1,1,0,0,2
"cg24349414",119,178,4,0,301
"cg24350202",0,1,0,0,1
"cg24350395",0,1,0,0,1
"cg24351819",13,13,1,0,27
"cg24351867",0,1,0,0,1
"cg24353151",0,1,1,0,2
"cg24353945",2,0,0,0,2
"cg24354208",0,0,1,0,1
"cg24354368",1,0,0,0,1
"cg24354652",91,8,0,0,99
"cg24354958",5,3,0,0,8
"cg24356473",0,0,1,0,1
"cg24356742",4,1,0,0,5
"cg24357081",0,0,2,0,2
"cg24357557",227,70,0,0,297
"cg24357770",0,3,26,0,29
"cg24358047",0,0,1,0,1
"cg24358397",0,0,1,0,1
"cg24358567",0,0,2,0,2
"cg24359387",0,0,1,0,1
"cg24359624",1,3,0,0,4
"cg24360269",0,1,3,0,4
"cg24361447",2,0,0,0,2
"cg24362813",0,0,1,0,1
"cg24365013",1,0,0,0,1
"cg24365306",0,0,1,0,1
"cg24367548",1,2,1,0,4
"cg24367741",18,2,5,0,25
"cg24368130",0,1,0,0,1
"cg24368203",2,5,1,0,8
"cg24368507",0,0,1,0,1
"cg24368998",0,1,0,0,1
"cg24369857",1,1,1,0,3
"cg24370090",5,2,10,0,17
"cg24370615",1,0,0,0,1
"cg24371216",0,3,0,0,3
"cg24372174",0,1,2,0,3
"cg24372808",0,0,1,0,1
"cg24373193",17,18,4,0,39
"cg24373735",3,0,0,0,3
"cg24374583",0,0,1,0,1
"cg24375591",51,35,7,0,93
"cg24375607",1,2,0,0,3
"cg24375659",0,1,0,0,1
"cg24375999",0,0,1,0,1
"cg24376286",3,6,1,0,10
"cg24377062",0,1,7,0,8
"cg24377340",13,4,4,0,21
"cg24377560",6,0,0,0,6
"cg24377729",0,1,1,0,2
"cg24378009",94,399,48,0,541
"cg24379995",1,0,0,0,1
"cg24380079",1,0,0,0,1
"cg24380673",15,21,0,0,36
"cg24380977",1,0,0,0,1
"cg24383069",0,1,0,0,1
"cg24384051",0,0,1,0,1
"cg24385450",0,0,1,0,1
"cg24385513",2,0,1,0,3
"cg24385568",1,1,0,0,2
"cg24387800",0,0,1,0,1
"cg24388069",1,0,0,0,1
"cg24388153",1,0,0,0,1
"cg24388263",1,0,0,0,1
"cg24388789",0,0,1,0,1
"cg24388927",0,0,2,0,2
"cg24389465",19,0,0,0,19
"cg24389961",1,0,0,0,1
"cg24392013",1,0,0,0,1
"cg24392606",0,0,6,0,6
"cg24393100",0,10,1,0,11
"cg24394670",1,1,3,0,5
"cg24394771",0,1,0,0,1
"cg24395999",14,0,0,0,14
"cg24396631",1,0,0,0,1
"cg24396709",2,0,0,0,2
"cg24397084",0,1,5,0,6
"cg24397884",2,0,3,0,5
"cg24397936",0,1,0,0,1
"cg24399972",0,0,11,0,11
"cg24400806",2,9,3,0,14
"cg24400943",0,1,0,0,1
"cg24401020",0,0,1,2,3
"cg24401595",0,1,0,0,1
"cg24402070",0,0,1,0,1
"cg24402128",0,0,1,0,1
"cg24402990",2,0,0,0,2
"cg24405568",0,2,0,0,2
"cg24406496",9,87,2,0,98
"cg24406728",0,1,0,0,1
"cg24407243",4,0,0,0,4
"cg24407873",4,3,0,0,7
"cg24408706",0,1,0,0,1
"cg24409625",3,0,0,0,3
"cg24410782",0,0,3,0,3
"cg24411296",2,0,0,0,2
"cg24411817",0,0,1,0,1
"cg24412659",1,0,0,0,1
"cg24412809",0,1,0,0,1
"cg24413339",0,0,1,0,1
"cg24414679",0,2,0,0,2
"cg24414899",1,0,0,0,1
"cg24415895",0,0,1,0,1
"cg24418005",3,0,0,0,3
"cg24420867",0,1,0,0,1
"cg24421521",0,0,1,0,1
"cg24422316",2,0,0,0,2
"cg24423329",7,1,0,0,8
"cg24423424",0,1,0,0,1
"cg24425350",0,0,1,0,1
"cg24425553",1,1,0,0,2
"cg24425968",0,0,1,0,1
"cg24426329",860,30,0,0,890
"cg24426536",0,0,1,0,1
"cg24427029",1,0,0,0,1
"cg24429622",1,0,0,0,1
"cg24429726",5,1,0,0,6
"cg24430287",0,0,0,1,1
"cg24430637",8,1,0,0,9
"cg24432158",32,47,18,0,97
"cg24433156",2,0,0,0,2
"cg24435025",4,0,0,0,4
"cg24435534",14,13,2,0,29
"cg24435971",5,0,0,0,5
"cg24436365",6,1,0,0,7
"cg24437737",2,0,2,0,4
"cg24441383",1,0,0,0,1
"cg24442760",2,2,2,0,6
"cg24443178",70,2,0,0,72
"cg24444810",37,30,1,0,68
"cg24445752",5,2,1,0,8
"cg24446127",0,1,0,0,1
"cg24446148",2,1,1,0,4
"cg24446166",4,1,0,0,5
"cg24447291",3,1,0,0,4
"cg24447341",2,1,1,0,4
"cg24447866",0,1,0,0,1
"cg24448272",0,1,0,0,1
"cg24448633",0,1,1,0,2
"cg24449001",38,0,0,0,38
"cg24449463",0,1,0,0,1
"cg24450631",0,1,0,0,1
"cg24451138",6,0,0,0,6
"cg24452588",145,18,0,0,163
"cg24453123",52,5,1,0,58
"cg24453527",1,2,0,0,3
"cg24453742",0,1,0,0,1
"cg24453767",1,0,0,0,1
"cg24454285",0,0,1,0,1
"cg24455192",0,0,1,0,1
"cg24455945",0,0,3,0,3
"cg24456094",13,4,0,0,17
"cg24456165",0,0,1,0,1
"cg24456346",3,6,0,0,9
"cg24456744",2,0,17,0,19
"cg24456842",0,0,1,0,1
"cg24457158",0,1,0,0,1
"cg24457611",0,1,1,0,2
"cg24457728",0,1,1,0,2
"cg24458315",0,1,0,0,1
"cg24458328",0,0,1,0,1
"cg24459467",4,0,0,0,4
"cg24459556",0,0,1,0,1
"cg24461062",2,0,0,0,2
"cg24462263",389,14,0,0,403
"cg24462453",0,0,1,0,1
"cg24463318",0,1,0,0,1
"cg24464673",2,4,5,0,11
"cg24465133",0,1,0,0,1
"cg24465197",0,0,1,0,1
"cg24468357",9,0,0,0,9
"cg24470206",1,1,0,0,2
"cg24470657",1,0,1,0,2
"cg24470693",0,0,1,0,1
"cg24471073",2,0,0,0,2
"cg24471620",0,0,1,0,1
"cg24473407",0,0,1,0,1
"cg24473586",0,0,1,0,1
"cg24475016",134,78,12,0,224
"cg24476158",0,0,1,0,1
"cg24478030",4,6,4,0,14
"cg24478779",1,0,0,0,1
"cg24480146",1,0,0,0,1
"cg24481578",16,3,5,0,24
"cg24481802",0,0,1,0,1
"cg24481813",4,4,0,0,8
"cg24482578",0,0,1,0,1
"cg24483346",1,0,0,0,1
"cg24483487",0,0,2,0,2
"cg24484047",0,0,1,0,1
"cg24484296",0,0,1,0,1
"cg24484378",0,0,1,0,1
"cg24486235",5,14,4,0,23
"cg24486244",0,0,1,0,1
"cg24487639",5,1,0,0,6
"cg24487695",1,1,0,0,2
"cg24487856",0,1,0,0,1
"cg24490964",6,8,1,0,15
"cg24492022",1,0,0,0,1
"cg24492884",258,17,0,0,275
"cg24493004",1,0,0,0,1
"cg24493553",4,3,0,0,7
"cg24493925",54,3,0,0,57
"cg24494114",0,0,1,0,1
"cg24494643",4,0,0,0,4
"cg24494707",9,0,0,0,9
"cg24494791",485,23,0,0,508
"cg24495373",2,0,0,0,2
"cg24496154",0,0,2,0,2
"cg24496645",0,0,1,0,1
"cg24498488",542,33,0,0,575
"cg24498658",74,417,2,0,493
"cg24499059",1,2,2,0,5
"cg24499764",1,0,0,0,1
"cg24500232",0,0,1,0,1
"cg24500304",33,1,0,0,34
"cg24502025",149,31,0,0,180
"cg24502297",1,4,0,0,5
"cg24503244",7,11,6,0,24
"cg24504288",1,0,0,0,1
"cg24504463",57,1,0,0,58
"cg24504573",6,4,0,0,10
"cg24504601",2,0,0,0,2
"cg24505167",0,1,0,0,1
"cg24505778",41,23,4,0,68
"cg24505974",3,0,0,0,3
"cg24506662",0,1,0,0,1
"cg24507423",1,7,1,0,9
"cg24507644",0,0,1,0,1
"cg24507868",3,0,0,0,3
"cg24508028",2,9,0,0,11
"cg24508280",1,0,0,0,1
"cg24509591",31,3,0,0,34
"cg24509916",0,1,2,0,3
"cg24511167",836,588,5,0,1429
"cg24512770",67,16,0,0,83
"cg24512897",4,0,0,0,4
"cg24515054",0,0,3,0,3
"cg24515868",0,0,1,0,1
"cg24516912",284,38,0,0,322
"cg24517925",0,1,0,0,1
"cg24518264",15,0,0,0,15
"cg24518267",1,1,0,0,2
"cg24518640",22,1,0,0,23
"cg24519394",46,16,0,0,62
"cg24519990",4,0,0,0,4
"cg24521010",1,0,2,0,3
"cg24521542",2,0,0,0,2
"cg24521882",69,12,0,0,81
"cg24522277",5,2,0,0,7
"cg24522305",19,0,0,0,19
"cg24522499",61,6,0,0,67
"cg24522611",0,0,1,0,1
"cg24524735",415,81,4,0,500
"cg24525480",0,0,1,0,1
"cg24525563",0,0,1,0,1
"cg24526694",984,362,8,0,1354
"cg24527776",0,1,0,0,1
"cg24527964",1,0,0,0,1
"cg24528829",1,0,0,0,1
"cg24529011",24,4,2,0,30
"cg24529288",1,0,0,0,1
"cg24529392",180,165,62,0,407
"cg24530025",2,4,10,0,16
"cg24530608",0,0,1,0,1
"cg24531141",614,26,1,0,641
"cg24531355",1,0,0,0,1
"cg24531568",305,63,3,0,371
"cg24532743",0,0,5,0,5
"cg24533007",1,0,0,0,1
"cg24533060",8,3,0,0,11
"cg24534135",1,0,0,0,1
"cg24534731",44,17,2,0,63
"cg24534767",1,0,0,0,1
"cg24534875",0,1,0,0,1
"cg24535108",0,0,1,0,1
"cg24536114",2,1,0,0,3
"cg24536474",264,489,6,0,759
"cg24538155",0,0,1,0,1
"cg24538512",2,2,0,0,4
"cg24539569",7,6,0,0,13
"cg24540120",0,1,0,0,1
"cg24540754",2,0,0,0,2
"cg24541392",11,3,0,0,14
"cg24541798",0,0,1,0,1
"cg24542046",2,4,2,0,8
"cg24542766",0,2,2,0,4
"cg24544003",16,3,0,0,19
"cg24544275",45,5,0,0,50
"cg24544798",0,1,4,0,5
"cg24544876",10,0,0,0,10
"cg24545324",0,0,1,0,1
"cg24545908",9,3,0,0,12
"cg24545937",0,1,0,0,1
"cg24546550",677,526,13,0,1216
"cg24547104",0,2,2,0,4
"cg24547565",0,2,0,0,2
"cg24547840",0,0,1,0,1
"cg24547869",7,6,0,0,13
"cg24547873",0,1,1,0,2
"cg24548048",0,1,0,0,1
"cg24549179",0,0,1,0,1
"cg24549702",0,1,0,0,1
"cg24551902",1,1,0,0,2
"cg24552802",39,0,0,0,39
"cg24553332",0,1,1,0,2
"cg24553966",0,0,1,0,1
"cg24554558",0,2,0,0,2
"cg24556754",1,0,1,0,2
"cg24556854",450,56,2,0,508
"cg24557620",1,2,0,0,3
"cg24558112",4,0,0,0,4
"cg24558436",0,1,0,0,1
"cg24562165",1,0,0,0,1
"cg24562777",86,30,2,0,118
"cg24562943",0,0,1,0,1
"cg24563639",1,0,0,0,1
"cg24564534",0,1,0,0,1
"cg24566249",0,1,1,0,2
"cg24566293",0,1,1,0,2
"cg24566516",7,2,0,0,9
"cg24567600",0,0,1,0,1
"cg24568126",0,0,0,1,1
"cg24568548",2,1,0,0,3
"cg24568796",0,0,1,0,1
"cg24569030",0,0,1,0,1
"cg24570058",4,0,0,0,4
"cg24570159",0,0,2,0,2
"cg24570716",0,0,1,0,1
"cg24571395",2,0,0,0,2
"cg24573207",0,0,0,1,1
"cg24574478",3,0,0,0,3
"cg24574495",0,1,6,0,7
"cg24574859",0,0,1,0,1
"cg24575638",27,2,0,0,29
"cg24576285",1,0,0,0,1
"cg24577167",0,0,2,0,2
"cg24577220",0,1,1,0,2
"cg24577609",0,1,0,0,1
"cg24577699",1,0,1,0,2
"cg24579099",23,1,0,0,24
"cg24579407",0,0,2,0,2
"cg24579615",1,0,0,0,1
"cg24579705",15,2,0,0,17
"cg24580203",0,1,0,0,1
"cg24580635",1,2,1,0,4
"cg24581183",4,0,0,0,4
"cg24581826",0,0,1,0,1
"cg24581845",0,0,1,0,1
"cg24582137",3,1,0,0,4
"cg24582541",1,0,1,0,2
"cg24582925",0,0,5,0,5
"cg24583766",2,0,2,0,4
"cg24587185",0,0,1,0,1
"cg24588058",0,0,1,0,1
"cg24588571",0,0,0,1,1
"cg24589627",4,0,0,0,4
"cg24590990",125,14,0,0,139
"cg24591118",220,13,0,0,233
"cg24592527",0,0,1,0,1
"cg24592621",1,0,0,0,1
"cg24595525",2,0,0,0,2
"cg24595704",4,0,0,0,4
"cg24596526",0,0,2,0,2
"cg24596576",0,0,1,0,1
"cg24597578",0,0,1,0,1
"cg24597895",0,0,1,0,1
"cg24598513",0,0,1,0,1
"cg24598700",1,0,0,0,1
"cg24599650",1,1,0,0,2
"cg24600274",257,533,14,0,804
"cg24601011",727,42,0,0,769
"cg24602093",0,0,1,0,1
"cg24602560",0,1,0,0,1
"cg24604172",2,2,0,0,4
"cg24604258",4,0,0,0,4
"cg24604641",0,0,1,0,1
"cg24606370",76,21,0,0,97
"cg24606371",0,1,3,0,4
"cg24606529",0,0,2,0,2
"cg24606595",0,1,0,0,1
"cg24606768",1,1,1,0,3
"cg24607783",0,1,0,0,1
"cg24609041",0,0,1,0,1
"cg24609424",1,1,1,0,3
"cg24609471",57,7,0,0,64
"cg24609573",1,1,7,0,9
"cg24610690",136,72,16,0,224
"cg24610901",1,0,0,0,1
"cg24612893",0,1,0,0,1
"cg24612945",0,0,1,0,1
"cg24612990",0,1,0,0,1
"cg24614200",0,2,0,0,2
"cg24614951",10,20,2,0,32
"cg24618748",0,1,1,0,2
"cg24620463",283,90,3,0,376
"cg24620592",14,2,0,0,16
"cg24621228",0,0,4,0,4
"cg24621754",0,0,1,0,1
"cg24621831",0,1,0,0,1
"cg24621922",1,2,0,0,3
"cg24623649",3,4,0,0,7
"cg24624624",0,1,0,0,1
"cg24624873",28,6,0,0,34
"cg24625832",0,0,1,0,1
"cg24627262",1,0,0,0,1
"cg24627948",1,14,0,0,15
"cg24629232",53,28,2,0,83
"cg24629511",1,0,0,0,1
"cg24629850",1,0,0,0,1
"cg24631672",1,0,0,0,1
"cg24632637",4,2,4,0,10
"cg24632967",33,32,13,0,78
"cg24634009",1,0,0,0,1
"cg24634165",0,0,1,0,1
"cg24634935",0,0,5,0,5
"cg24636244",1,0,0,0,1
"cg24636510",6,3,0,0,9
"cg24638335",1,0,0,0,1
"cg24638667",0,0,1,0,1
"cg24640586",2,1,0,0,3
"cg24640746",2,0,0,0,2
"cg24640821",1,0,0,0,1
"cg24641201",10,0,0,0,10
"cg24643461",7,7,1,0,15
"cg24643709",0,0,2,0,2
"cg24644026",1,0,0,0,1
"cg24644110",0,2,3,0,5
"cg24644448",0,0,1,0,1
"cg24644689",0,1,0,0,1
"cg24644691",0,0,1,0,1
"cg24645778",0,0,1,0,1
"cg24650114",0,0,5,0,5
"cg24651080",4,2,2,0,8
"cg24651226",2,3,2,0,7
"cg24651708",177,202,7,0,386
"cg24651828",0,0,1,0,1
"cg24652361",2,0,1,0,3
"cg24652590",1,8,0,0,9
"cg24652842",2,7,2,0,11
"cg24653167",0,0,1,0,1
"cg24653967",0,1,0,0,1
"cg24654094",0,0,1,0,1
"cg24655310",0,1,0,0,1
"cg24655476",0,0,1,0,1
"cg24655570",0,4,0,0,4
"cg24655777",0,1,2,0,3
"cg24656594",2,1,0,0,3
"cg24657473",1,0,0,0,1
"cg24657816",1,0,0,0,1
"cg24658321",0,1,0,0,1
"cg24659437",1,0,0,0,1
"cg24659646",3,3,0,0,6
"cg24661457",1,0,0,0,1
"cg24661740",76,0,0,0,76
"cg24663683",0,0,1,0,1
"cg24664470",0,1,0,0,1
"cg24665000",37,9,0,0,46
"cg24665632",0,0,1,0,1
"cg24666103",0,1,0,0,1
"cg24666178",0,0,1,0,1
"cg24667407",0,0,1,0,1
"cg24668618",0,1,0,0,1
"cg24669311",0,0,7,0,7
"cg24671185",0,0,1,0,1
"cg24671229",1,0,0,0,1
"cg24671524",4,2,2,0,8
"cg24671530",0,4,7,0,11
"cg24671810",0,1,0,0,1
"cg24672186",1,0,0,0,1
"cg24674674",1,0,0,0,1
"cg24676349",1,0,0,0,1
"cg24676538",0,0,1,0,1
"cg24676664",1,0,0,0,1
"cg24676839",0,0,1,0,1
"cg24678241",0,0,1,0,1
"cg24679876",16,2,0,0,18
"cg24680320",0,1,0,0,1
"cg24680742",35,1,0,0,36
"cg24681442",8,2,0,0,10
"cg24682370",0,0,1,0,1
"cg24682944",0,0,1,0,1
"cg24683103",47,71,4,0,122
"cg24683922",0,0,1,0,1
"cg24684033",2,0,0,0,2
"cg24684394",1,0,0,0,1
"cg24685298",1,0,0,0,1
"cg24686187",4,1,0,0,5
"cg24686469",1,0,0,0,1
"cg24686486",1,0,0,0,1
"cg24687055",1,0,0,0,1
"cg24687100",1,0,0,0,1
"cg24688365",0,0,1,0,1
"cg24688425",575,745,104,0,1424
"cg24688574",0,0,1,0,1
"cg24688977",1,0,0,0,1
"cg24690882",0,2,0,0,2
"cg24690924",1,0,0,0,1
"cg24692154",0,0,1,0,1
"cg24692386",1,0,0,0,1
"cg24693218",0,0,1,0,1
"cg24693227",0,2,0,0,2
"cg24693463",3,2,0,0,5
"cg24693803",3,0,0,0,3
"cg24694766",1,0,0,0,1
"cg24695042",0,1,0,0,1
"cg24695890",1,0,1,0,2
"cg24695950",0,0,1,0,1
"cg24696268",1,1,6,0,8
"cg24696735",277,27,1,0,305
"cg24697501",1,0,4,0,5
"cg24698881",0,3,0,0,3
"cg24699430",0,0,1,0,1
"cg24699520",0,0,3,0,3
"cg24699830",0,1,0,0,1
"cg24699876",0,1,0,0,1
"cg24699920",236,21,1,0,258
"cg24700494",24,1,0,0,25
"cg24700999",0,1,2,0,3
"cg24701725",0,0,1,0,1
"cg24701809",7,3,3,0,13
"cg24701843",1,0,0,0,1
"cg24703449",0,2,5,0,7
"cg24703468",2,4,1,0,7
"cg24704015",0,1,0,0,1
"cg24704248",68,2,0,0,70
"cg24704635",42,3,0,0,45
"cg24705178",0,0,1,0,1
"cg24707098",115,92,20,0,227
"cg24707616",1,0,0,0,1
"cg24707684",0,0,1,0,1
"cg24708480",3,2,0,0,5
"cg24708674",12,1,0,0,13
"cg24708854",0,1,1,0,2
"cg24709167",41,13,1,0,55
"cg24709276",0,0,1,0,1
"cg24710520",1,0,0,0,1
"cg24710749",0,1,0,0,1
"cg24710870",1,1,0,0,2
"cg24712122",1,0,0,0,1
"cg24713076",7,0,4,1,12
"cg24714831",0,0,1,0,1
"cg24714859",0,1,0,0,1
"cg24715185",1,0,0,0,1
"cg24715298",0,0,1,0,1
"cg24715682",0,1,2,0,3
"cg24717964",0,0,1,0,1
"cg24718437",1,7,5,0,13
"cg24718699",3,4,0,0,7
"cg24719587",0,1,0,0,1
"cg24720291",1,2,0,0,3
"cg24720580",0,0,1,0,1
"cg24722619",0,3,1,0,4
"cg24724460",46,51,3,0,100
"cg24724471",4,0,0,0,4
"cg24724937",1,0,3,0,4
"cg24725360",0,0,1,0,1
"cg24726333",0,1,0,0,1
"cg24726503",14,1,0,0,15
"cg24726571",1,0,0,0,1
"cg24726661",1,0,0,0,1
"cg24726716",8,3,2,0,13
"cg24726781",9,3,0,0,12
"cg24728005",0,0,1,0,1
"cg24728468",1,2,2,0,5
"cg24728683",0,1,0,0,1
"cg24729486",0,1,0,0,1
"cg24729617",6,0,0,0,6
"cg24729792",0,1,0,0,1
"cg24729955",0,3,0,0,3
"cg24730328",1,0,0,0,1
"cg24730368",1,0,0,0,1
"cg24730425",70,15,0,0,85
"cg24731279",0,0,1,0,1
"cg24731511",29,8,0,0,37
"cg24732062",268,154,15,0,437
"cg24732878",0,0,1,0,1
"cg24733093",16,4,2,0,22
"cg24733258",6,1,0,0,7
"cg24733553",0,0,1,0,1
"cg24733757",0,0,1,0,1
"cg24734176",0,0,1,0,1
"cg24734347",1,0,0,0,1
"cg24734399",0,1,0,0,1
"cg24734715",0,2,0,0,2
"cg24735225",0,1,0,0,1
"cg24736559",0,0,1,0,1
"cg24736891",1,0,0,0,1
"cg24737094",2,2,0,0,4
"cg24737418",0,0,1,0,1
"cg24737806",0,1,0,1,2
"cg24738257",311,7,1,0,319
"cg24739672",0,1,0,0,1
"cg24743682",4,8,4,0,16
"cg24744250",6,0,0,0,6
"cg24747539",11,0,5,0,16
"cg24747780",0,0,1,0,1
"cg24747866",0,1,0,0,1
"cg24747937",0,1,0,0,1
"cg24748294",1,0,0,0,1
"cg24748945",0,1,0,0,1
"cg24749726",0,4,0,0,4
"cg24750912",0,0,2,0,2
"cg24751730",3,0,0,0,3
"cg24755485",0,0,1,0,1
"cg24755562",1,0,0,0,1
"cg24756864",0,1,0,0,1
"cg24758019",0,0,1,0,1
"cg24758055",9,13,11,0,33
"cg24758201",1,0,0,0,1
"cg24759101",1,2,1,0,4
"cg24759859",0,1,0,0,1
"cg24760581",1,0,0,0,1
"cg24761421",0,0,1,0,1
"cg24762029",24,32,4,0,60
"cg24763166",0,1,0,0,1
"cg24764620",2,1,1,0,4
"cg24764669",0,0,1,0,1
"cg24766207",1,0,0,0,1
"cg24766690",0,0,1,0,1
"cg24767131",0,1,0,0,1
"cg24767573",1,0,0,0,1
"cg24767731",1,1,0,0,2
"cg24768916",6,1,0,0,7
"cg24771769",0,3,0,0,3
"cg24772760",2,0,0,0,2
"cg24773373",1,0,0,0,1
"cg24773848",3,3,0,0,6
"cg24774182",3,1,4,0,8
"cg24775814",5,0,0,0,5
"cg24775861",5,0,4,0,9
"cg24779195",0,0,1,0,1
"cg24785433",0,1,2,0,3
"cg24785642",1,0,0,0,1
"cg24789143",3,0,0,0,3
"cg24789503",1,1,1,0,3
"cg24790878",137,73,12,0,222
"cg24792739",0,0,1,0,1
"cg24793052",2,0,0,0,2
"cg24794408",0,1,2,1,4
"cg24795100",3,0,0,0,3
"cg24797931",750,802,287,0,1839
"cg24797967",2,0,4,0,6
"cg24798853",0,1,0,0,1
"cg24799710",0,0,1,0,1
"cg24799729",0,1,1,0,2
"cg24800365",34,188,5,0,227
"cg24800616",1,0,0,0,1
"cg24800862",11,2,0,0,13
"cg24800883",0,1,0,0,1
"cg24801067",0,0,3,0,3
"cg24802193",0,0,4,0,4
"cg24802567",0,0,1,0,1
"cg24803289",376,11,2,0,389
"cg24803778",0,3,2,0,5
"cg24803796",23,2,0,0,25
"cg24803906",2,1,0,0,3
"cg24804388",0,0,1,0,1
"cg24805270",0,1,0,0,1
"cg24805681",1,0,0,0,1
"cg24806176",0,0,1,0,1
"cg24806893",91,183,6,0,280
"cg24807516",14,14,18,0,46
"cg24808024",2,0,0,0,2
"cg24808122",2,1,0,0,3
"cg24808545",67,3,0,0,70
"cg24808966",0,1,3,0,4
"cg24811378",0,0,1,0,1
"cg24812416",0,0,1,0,1
"cg24812946",0,1,0,0,1
"cg24814153",0,2,0,0,2
"cg24814380",1,0,0,0,1
"cg24816563",9,1,0,0,10
"cg24816578",0,0,1,0,1
"cg24817154",5,9,0,0,14
"cg24817345",4,1,0,0,5
"cg24818905",1,0,0,0,1
"cg24820292",1,0,0,0,1
"cg24820982",2,2,0,0,4
"cg24822182",0,0,1,0,1
"cg24823308",0,1,0,0,1
"cg24823310",1,1,0,0,2
"cg24824082",1,2,3,0,6
"cg24824492",5,3,1,0,9
"cg24826636",0,0,1,0,1
"cg24826644",0,1,0,0,1
"cg24827550",0,4,0,0,4
"cg24828683",0,1,1,0,2
"cg24828975",3,0,0,0,3
"cg24829460",1,0,0,0,1
"cg24829633",2,0,0,0,2
"cg24831305",2,0,0,0,2
"cg24833071",2,0,0,0,2
"cg24834263",1,0,0,0,1
"cg24834575",2,0,0,0,2
"cg24834599",18,42,11,0,71
"cg24835831",20,3,0,0,23
"cg24836822",0,1,0,0,1
"cg24838661",35,8,0,0,43
"cg24839520",1,13,3,0,17
"cg24840848",9,4,0,0,13
"cg24841193",1,0,0,0,1
"cg24841909",30,7,5,0,42
"cg24844047",1,0,0,0,1
"cg24844429",0,3,0,0,3
"cg24845234",0,1,0,0,1
"cg24845246",1,0,0,0,1
"cg24845267",9,18,0,0,27
"cg24845535",81,32,22,0,135
"cg24846049",18,2,0,0,20
"cg24847254",138,166,6,0,310
"cg24847259",1,3,1,0,5
"cg24847587",0,0,2,0,2
"cg24848015",29,12,5,0,46
"cg24848764",0,0,1,0,1
"cg24849182",4,1,0,0,5
"cg24849267",1,0,0,0,1
"cg24849831",29,30,5,0,64
"cg24850280",0,0,0,1,1
"cg24850323",1,4,0,0,5
"cg24851083",1,0,0,0,1
"cg24851153",4,1,0,0,5
"cg24851260",1,0,0,0,1
"cg24851262",0,1,0,0,1
"cg24853977",0,1,0,0,1
"cg24854435",0,0,1,0,1
"cg24854914",0,0,1,0,1
"cg24856140",1,2,0,0,3
"cg24856171",0,2,0,0,2
"cg24856606",1,1,0,0,2
"cg24856756",3,6,1,0,10
"cg24857958",3,0,0,0,3
"cg24859343",1,0,0,0,1
"cg24859568",6,0,0,0,6
"cg24859593",8,0,2,0,10
"cg24860332",0,1,0,0,1
"cg24861585",1,4,5,0,10
"cg24862340",4,0,0,0,4
"cg24862395",1,0,0,0,1
"cg24862879",16,3,0,0,19
"cg24863734",19,3,0,0,22
"cg24863745",0,1,0,0,1
"cg24864382",0,1,0,0,1
"cg24866308",0,2,3,1,6
"cg24867640",2,0,0,0,2
"cg24868047",1,0,0,0,1
"cg24868054",0,1,0,0,1
"cg24868365",2,1,0,0,3
"cg24869327",17,0,0,0,17
"cg24871371",302,100,3,0,405
"cg24872268",1,5,0,0,6
"cg24873886",0,0,2,0,2
"cg24873959",0,0,1,0,1
"cg24874236",2,0,0,0,2
"cg24874705",1,0,0,0,1
"cg24874828",0,3,15,0,18
"cg24875415",0,0,1,0,1
"cg24876837",0,1,3,0,4
"cg24877190",0,1,4,0,5
"cg24877963",1,0,0,0,1
"cg24877964",0,1,0,0,1
"cg24879209",0,1,0,0,1
"cg24882290",3,2,0,0,5
"cg24883413",1,0,0,0,1
"cg24883861",1,0,0,0,1
"cg24884343",1,0,1,0,2
"cg24884360",0,0,1,0,1
"cg24884698",0,3,1,0,4
"cg24884887",0,1,1,0,2
"cg24885246",13,5,0,0,18
"cg24885403",0,0,5,0,5
"cg24886033",0,0,1,0,1
"cg24886414",2,1,1,0,4
"cg24886597",0,2,8,0,10
"cg24886812",17,8,0,0,25
"cg24887111",0,0,1,0,1
"cg24887352",0,0,0,1,1
"cg24888170",4,7,24,0,35
"cg24888588",7,16,21,0,44
"cg24889352",0,2,2,0,4
"cg24889441",9,21,3,0,33
"cg24890999",2,0,19,0,21
"cg24892148",16,1,0,0,17
"cg24892602",16,11,6,0,33
"cg24892918",1,0,0,0,1
"cg24893198",0,6,1,0,7
"cg24893562",0,0,1,0,1
"cg24893618",0,1,0,0,1
"cg24894518",0,1,0,0,1
"cg24895660",39,31,2,0,72
"cg24895862",1,2,1,0,4
"cg24895977",0,0,1,0,1
"cg24896805",1,0,0,0,1
"cg24897127",0,0,1,0,1
"cg24897636",0,4,0,0,4
"cg24897754",8,13,0,0,21
"cg24898144",0,0,1,0,1
"cg24899846",0,2,0,0,2
"cg24901609",1,0,0,0,1
"cg24901939",0,1,0,0,1
"cg24902362",270,68,0,0,338
"cg24903159",228,19,0,0,247
"cg24903485",5,1,0,0,6
"cg24904084",0,2,0,0,2
"cg24904103",0,0,1,0,1
"cg24904925",0,1,1,0,2
"cg24905370",0,0,1,0,1
"cg24906999",0,1,2,0,3
"cg24907569",275,44,0,0,319
"cg24908058",1,1,2,0,4
"cg24909667",5,2,0,0,7
"cg24909783",1,0,0,0,1
"cg24910303",1,0,0,0,1
"cg24910739",0,0,1,0,1
"cg24911837",0,0,1,0,1
"cg24912340",598,31,1,0,630
"cg24912531",0,1,0,0,1
"cg24912560",1,0,0,0,1
"cg24913110",7,5,2,0,14
"cg24914077",0,1,1,0,2
"cg24914379",2,3,0,0,5
"cg24914661",0,0,3,0,3
"cg24916688",1,0,0,0,1
"cg24916890",151,4,0,0,155
"cg24918062",2,1,0,0,3
"cg24919522",2,5,0,0,7
"cg24921240",0,0,2,0,2
"cg24921912",0,0,1,0,1
"cg24922090",2,0,0,0,2
"cg24922281",0,1,1,0,2
"cg24922969",1,0,0,0,1
"cg24922980",1,1,0,0,2
"cg24923511",13,0,0,0,13
"cg24924572",210,115,6,0,331
"cg24924731",216,10,0,0,226
"cg24925593",0,1,0,0,1
"cg24925801",0,0,2,0,2
"cg24926253",480,27,0,0,507
"cg24926531",0,1,0,0,1
"cg24926677",0,1,0,0,1
"cg24926780",0,1,0,0,1
"cg24927174",0,1,0,0,1
"cg24927207",0,0,1,0,1
"cg24927843",0,0,4,0,4
"cg24928572",0,2,4,16,22
"cg24929938",11,2,0,0,13
"cg24931839",2,0,0,0,2
"cg24932163",0,0,2,0,2
"cg24933755",0,1,0,0,1
"cg24934803",2,0,0,0,2
"cg24934804",1,1,1,0,3
"cg24935651",1,0,2,0,3
"cg24935943",0,0,1,0,1
"cg24935976",1,0,0,0,1
"cg24936757",1,0,0,0,1
"cg24937473",0,1,1,0,2
"cg24937681",174,612,7,0,793
"cg24938077",1,1,0,0,2
"cg24938100",3,0,0,0,3
"cg24938825",0,1,0,0,1
"cg24939943",2,0,0,0,2
"cg24940828",50,27,2,0,79
"cg24941343",0,0,1,0,1
"cg24941469",11,3,0,0,14
"cg24942465",7,2,0,0,9
"cg24943514",0,0,8,0,8
"cg24944500",5,2,0,0,7
"cg24945223",2,0,0,0,2
"cg24947694",2,0,0,0,2
"cg24948189",0,0,1,0,1
"cg24948492",41,8,0,0,49
"cg24948505",3,0,0,0,3
"cg24948782",1,0,0,0,1
"cg24949133",0,0,1,0,1
"cg24949242",99,52,10,0,161
"cg24949750",1,0,0,0,1
"cg24950506",1,0,0,0,1
"cg24951257",25,3,0,0,28
"cg24951603",1,0,1,0,2
"cg24954204",0,2,0,0,2
"cg24954453",0,0,1,0,1
"cg24954590",0,0,1,0,1
"cg24954696",123,279,43,0,445
"cg24955026",2,0,0,0,2
"cg24955546",1,0,0,0,1
"cg24955592",0,1,0,0,1
"cg24955660",0,1,0,0,1
"cg24955731",1,0,1,0,2
"cg24955955",0,1,0,0,1
"cg24956239",1,0,0,0,1
"cg24957628",0,1,0,0,1
"cg24958247",16,2,0,0,18
"cg24958366",0,0,1,0,1
"cg24959901",1,0,0,0,1
"cg24962573",0,0,1,0,1
"cg24962643",2,1,0,0,3
"cg24962873",104,34,0,0,138
"cg24963067",0,0,1,0,1
"cg24963756",0,0,1,0,1
"cg24964711",1,0,0,0,1
"cg24965888",0,1,0,0,1
"cg24967690",15,0,0,0,15
"cg24968730",4,1,0,0,5
"cg24968968",1,0,0,0,1
"cg24969022",0,0,1,0,1
"cg24969036",0,3,0,0,3
"cg24969443",0,2,0,0,2
"cg24970119",545,92,3,0,640
"cg24972202",0,1,0,0,1
"cg24973886",0,0,2,0,2
"cg24974430",1,0,0,0,1
"cg24975244",0,1,0,0,1
"cg24975723",2,0,0,0,2
"cg24976321",7,0,0,0,7
"cg24977981",34,32,1,0,67
"cg24978686",3,2,2,0,7
"cg24978909",0,0,2,0,2
"cg24979495",0,2,0,0,2
"cg24979558",5,13,9,0,27
"cg24979893",2,0,0,0,2
"cg24980648",1,0,0,0,1
"cg24982565",0,0,4,0,4
"cg24983477",9,2,0,0,11
"cg24984646",1,2,0,0,3
"cg24985372",0,7,4,0,11
"cg24986655",2,0,0,0,2
"cg24986971",1,1,11,0,13
"cg24988178",5,0,0,0,5
"cg24988436",0,0,1,0,1
"cg24988584",0,1,1,0,2
"cg24990022",16,2,0,0,18
"cg24990321",0,0,3,0,3
"cg24990923",0,0,1,0,1
"cg24991198",1,0,0,0,1
"cg24991432",28,2,0,0,30
"cg24991692",1,0,0,0,1
"cg24991780",5,4,5,0,14
"cg24992581",0,0,1,0,1
"cg24993790",2,0,0,0,2
"cg24993859",1,0,0,0,1
"cg24994648",1384,75,2,0,1461
"cg24994755",0,0,1,0,1
"cg24994894",1,0,0,0,1
"cg24996200",52,0,0,0,52
"cg24997359",0,0,0,1,1
"cg24998105",173,42,1,0,216
"cg24998464",0,1,0,0,1
"cg24999679",0,2,0,0,2
"cg24999890",0,2,1,0,3
"cg25000491",6,1,0,0,7
"cg25000592",1,2,0,0,3
"cg25000594",2,1,1,0,4
"cg25001246",0,0,1,0,1
"cg25001845",4,0,0,0,4
"cg25002191",1,0,0,0,1
"cg25002347",3,4,1,0,8
"cg25002505",2,0,0,0,2
"cg25002551",604,49,1,0,654
"cg25002570",31,22,3,0,56
"cg25002968",0,0,2,0,2
"cg25004478",9,3,1,0,13
"cg25004689",3,0,0,0,3
"cg25004693",0,0,2,0,2
"cg25004737",9,23,1,0,33
"cg25005135",0,0,1,0,1
"cg25005868",3,2,0,0,5
"cg25006509",0,2,0,0,2
"cg25006998",4,3,0,0,7
"cg25008015",0,1,0,0,1
"cg25009258",5,0,0,0,5
"cg25009896",0,0,1,0,1
"cg25010057",0,0,1,0,1
"cg25011540",0,0,5,0,5
"cg25011921",0,1,0,0,1
"cg25012029",1,0,0,0,1
"cg25012556",1,0,0,0,1
"cg25012739",0,2,1,0,3
"cg25012833",0,0,1,0,1
"cg25013451",105,51,2,0,158
"cg25013586",0,0,1,0,1
"cg25016964",0,0,1,0,1
"cg25018832",0,0,0,1,1
"cg25019549",20,5,1,0,26
"cg25020191",0,2,0,0,2
"cg25020232",14,1,0,0,15
"cg25020699",3,2,0,0,5
"cg25021182",0,1,0,0,1
"cg25021638",17,0,0,0,17
"cg25021660",1,0,0,0,1
"cg25021681",12,1,4,0,17
"cg25021706",0,1,1,0,2
"cg25023822",0,1,0,0,1
"cg25024980",4,0,0,0,4
"cg25025494",0,1,0,0,1
"cg25026157",5,0,0,0,5
"cg25026767",0,0,0,2,2
"cg25027798",0,3,0,0,3
"cg25027799",0,2,1,0,3
"cg25028901",0,0,1,0,1
"cg25030549",2,0,0,0,2
"cg25032756",0,1,0,0,1
"cg25033470",0,2,0,0,2
"cg25034625",7,1,1,0,9
"cg25035200",6,1,0,0,7
"cg25035498",4,1,0,0,5
"cg25035511",0,0,5,0,5
"cg25035662",0,1,2,0,3
"cg25035988",1,1,0,0,2
"cg25036341",0,1,0,0,1
"cg25036758",0,1,0,0,1
"cg25036886",302,67,2,0,371
"cg25037043",0,2,0,0,2
"cg25038305",58,2,0,0,60
"cg25039417",0,0,1,0,1
"cg25039762",56,386,271,0,713
"cg25039837",1,1,0,0,2
"cg25039902",642,17,0,0,659
"cg25040805",0,0,1,0,1
"cg25042112",10,5,4,0,19
"cg25042489",0,0,0,1,1
"cg25042586",0,0,3,0,3
"cg25042801",0,1,2,0,3
"cg25042892",0,0,1,0,1
"cg25044130",0,0,1,0,1
"cg25045666",1,2,0,0,3
"cg25045882",8,9,0,0,17
"cg25046429",1,0,0,0,1
"cg25046571",1,0,0,0,1
"cg25046866",515,10,1,0,526
"cg25047058",81,49,5,0,135
"cg25049941",0,0,1,0,1
"cg25051052",0,1,0,0,1
"cg25052526",2,1,0,0,3
"cg25052737",2,0,0,0,2
"cg25052933",0,1,1,0,2
"cg25053275",1,0,0,0,1
"cg25054736",90,2,0,0,92
"cg25054890",12,14,0,0,26
"cg25056259",1,0,0,0,1
"cg25056510",0,0,3,0,3
"cg25057035",0,0,1,0,1
"cg25058662",0,0,1,0,1
"cg25059445",2,0,0,0,2
"cg25060243",1,0,0,0,1
"cg25060765",3,0,0,0,3
"cg25061969",0,0,1,0,1
"cg25062533",2,0,0,0,2
"cg25064747",0,2,0,0,2
"cg25068991",1,0,0,0,1
"cg25069181",0,1,0,0,1
"cg25069796",0,1,0,0,1
"cg25070822",0,1,3,0,4
"cg25071634",0,1,7,0,8
"cg25072319",2,0,0,0,2
"cg25072962",0,1,0,0,1
"cg25074289",0,0,1,0,1
"cg25074461",0,1,4,0,5
"cg25076678",2,4,0,0,6
"cg25077865",0,1,0,0,1
"cg25078755",2,0,0,0,2
"cg25079771",8,4,0,0,12
"cg25080078",6,7,10,0,23
"cg25080115",18,10,0,0,28
"cg25082785",213,158,42,0,413
"cg25083596",23,15,0,0,38
"cg25083782",0,0,1,0,1
"cg25083874",10,0,0,0,10
"cg25085729",0,0,2,0,2
"cg25086738",6,10,3,0,19
"cg25086957",0,1,0,0,1
"cg25087499",1,0,0,0,1
"cg25088833",1,0,0,0,1
"cg25088843",1,0,0,0,1
"cg25089685",0,1,0,0,1
"cg25089982",4,1,0,0,5
"cg25092473",0,1,0,0,1
"cg25093859",0,0,1,0,1
"cg25095351",1,7,0,0,8
"cg25095587",1,0,0,0,1
"cg25095589",0,5,9,0,14
"cg25095623",0,1,0,0,1
"cg25095697",0,0,2,0,2
"cg25095934",3,3,12,0,18
"cg25096107",0,3,1,0,4
"cg25096313",0,0,1,0,1
"cg25097266",42,6,1,0,49
"cg25097892",64,13,1,0,78
"cg25098030",2,0,0,0,2
"cg25098401",1,0,0,0,1
"cg25098644",0,0,1,0,1
"cg25099722",26,38,7,0,71
"cg25100279",0,1,0,0,1
"cg25101405",0,2,0,0,2
"cg25102002",1,0,0,0,1
"cg25102239",2,8,3,0,13
"cg25102872",0,0,1,0,1
"cg25103135",1,0,0,0,1
"cg25103766",0,0,2,0,2
"cg25104118",0,1,0,0,1
"cg25104430",1,2,1,0,4
"cg25104619",0,0,1,0,1
"cg25104868",3,5,1,0,9
"cg25105824",69,75,8,0,152
"cg25106304",0,0,1,0,1
"cg25106441",4,1,0,0,5
"cg25106500",2,0,0,0,2
"cg25107114",1,5,2,0,8
"cg25107788",2,0,0,0,2
"cg25108740",44,0,1,0,45
"cg25110857",8,10,2,0,20
"cg25112544",28,1,0,0,29
"cg25112853",0,1,0,0,1
"cg25113008",0,3,1,0,4
"cg25113053",0,1,0,0,1
"cg25113106",1,1,0,0,2
"cg25114299",49,28,1,0,78
"cg25114504",1,1,0,0,2
"cg25115148",0,0,1,0,1
"cg25117822",113,26,2,0,141
"cg25117975",0,1,0,0,1
"cg25120459",10,10,0,0,20
"cg25121589",0,0,1,0,1
"cg25122413",4,0,0,0,4
"cg25123442",11,1,0,0,12
"cg25123632",3,2,2,0,7
"cg25124584",0,0,1,0,1
"cg25124812",0,0,2,0,2
"cg25124891",5,0,0,0,5
"cg25126296",9,0,0,0,9
"cg25126301",0,1,0,0,1
"cg25127972",0,1,0,0,1
"cg25128583",0,0,1,0,1
"cg25130530",3,1,0,0,4
"cg25131296",1,0,0,0,1
"cg25132649",3,2,0,0,5
"cg25134529",0,2,0,0,2
"cg25135159",4,0,0,0,4
"cg25136310",0,2,1,0,3
"cg25136955",0,0,1,0,1
"cg25137968",0,1,1,0,2
"cg25138053",0,2,0,0,2
"cg25138327",1,0,0,0,1
"cg25138649",0,0,1,0,1
"cg25139826",0,0,1,0,1
"cg25141642",1,1,0,0,2
"cg25142905",0,1,0,0,1
"cg25143618",0,0,1,0,1
"cg25143706",0,1,1,0,2
"cg25144109",1,0,0,0,1
"cg25145679",4,0,0,0,4
"cg25147343",0,1,4,1,6
"cg25148117",3,2,2,2,9
"cg25148542",1,1,0,0,2
"cg25149140",0,0,4,0,4
"cg25149516",0,0,1,0,1
"cg25149637",1,2,1,0,4
"cg25151104",1,0,0,0,1
"cg25153205",1,0,0,0,1
"cg25153318",0,0,2,0,2
"cg25153483",313,25,1,0,339
"cg25154059",0,1,0,0,1
"cg25154270",7,6,2,0,15
"cg25154341",0,0,1,0,1
"cg25154363",99,10,0,0,109
"cg25154455",1,1,0,0,2
"cg25154733",13,5,0,0,18
"cg25155053",7,9,0,0,16
"cg25155766",3,0,0,0,3
"cg25156473",0,1,1,0,2
"cg25156528",0,3,0,0,3
"cg25156695",0,0,1,0,1
"cg25158289",0,0,1,0,1
"cg25159101",0,1,0,0,1
"cg25160829",118,41,10,0,169
"cg25161181",1,0,0,0,1
"cg25161882",1,0,0,0,1
"cg25162625",0,1,1,0,2
"cg25162822",0,0,1,0,1
"cg25164292",0,1,0,0,1
"cg25165049",0,1,1,0,2
"cg25165883",0,0,1,0,1
"cg25165969",0,1,0,0,1
"cg25166002",0,0,1,0,1
"cg25166271",1,0,0,0,1
"cg25167247",0,0,1,0,1
"cg25169384",0,1,1,0,2
"cg25169926",31,2,0,0,33
"cg25170019",0,1,0,0,1
"cg25170187",3,0,0,0,3
"cg25170850",1,2,0,0,3
"cg25170995",0,1,0,0,1
"cg25171014",0,1,2,0,3
"cg25171389",0,0,3,0,3
"cg25171798",1,0,0,0,1
"cg25172603",0,1,0,0,1
"cg25172788",0,1,0,0,1
"cg25172993",1,1,0,0,2
"cg25173401",0,3,1,0,4
"cg25174197",39,22,1,0,62
"cg25174637",1,0,0,0,1
"cg25176823",0,1,0,0,1
"cg25177444",1,0,0,0,1
"cg25178466",626,48,0,0,674
"cg25179963",0,1,0,0,1
"cg25180075",0,0,1,0,1
"cg25180228",0,1,0,0,1
"cg25180252",0,0,1,0,1
"cg25181710",1,0,0,0,1
"cg25181900",0,1,0,0,1
"cg25182211",0,0,1,0,1
"cg25184787",0,1,0,0,1
"cg25187463",0,1,0,0,1
"cg25187622",46,0,1,0,47
"cg25187648",0,1,1,0,2
"cg25187967",1,0,0,0,1
"cg25188298",0,0,1,0,1
"cg25189483",0,0,1,0,1
"cg25190513",0,1,0,0,1
"cg25190847",0,0,1,0,1
"cg25191195",0,0,1,0,1
"cg25192591",150,306,134,0,590
"cg25193157",0,0,1,0,1
"cg25193384",1,17,3,0,21
"cg25193606",1,0,0,0,1
"cg25194502",4,0,0,0,4
"cg25195193",0,0,2,0,2
"cg25195374",0,0,1,0,1
"cg25195643",3,2,0,0,5
"cg25195924",3,0,0,0,3
"cg25196296",1,0,0,0,1
"cg25196348",0,1,1,0,2
"cg25197698",151,5,0,0,156
"cg25198255",1,1,5,0,7
"cg25198656",0,0,1,0,1
"cg25199334",1,1,0,0,2
"cg25199538",0,1,0,0,1
"cg25201541",0,1,1,0,2
"cg25201707",645,41,0,0,686
"cg25203256",0,0,1,0,1
"cg25203356",15,0,0,0,15
"cg25203423",0,2,0,0,2
"cg25204233",0,1,1,0,2
"cg25204360",6,2,0,0,8
"cg25205384",21,1,0,0,22
"cg25206451",1,0,0,0,1
"cg25206565",2,1,1,0,4
"cg25207167",3,3,0,0,6
"cg25208681",0,1,0,0,1
"cg25209353",1,1,0,0,2
"cg25209499",0,0,6,0,6
"cg25210370",1,1,0,0,2
"cg25210378",0,1,0,0,1
"cg25211267",0,2,9,0,11
"cg25212186",24,3,0,0,27
"cg25212891",549,84,2,0,635
"cg25214138",0,0,1,0,1
"cg25214792",0,0,1,0,1
"cg25215021",1,0,0,0,1
"cg25217895",7,2,3,0,12
"cg25220428",2,3,1,0,6
"cg25220957",11,4,0,0,15
"cg25221332",2,0,0,0,2
"cg25221819",8,0,0,0,8
"cg25221954",1,0,0,0,1
"cg25222915",0,0,10,0,10
"cg25223191",0,2,1,0,3
"cg25223391",327,220,21,0,568
"cg25223567",0,1,5,1,7
"cg25225155",5,0,2,0,7
"cg25225483",0,0,1,0,1
"cg25227377",1,2,0,0,3
"cg25227480",1,3,0,0,4
"cg25227981",0,0,1,0,1
"cg25228126",2,2,0,0,4
"cg25228870",6,8,2,0,16
"cg25228986",3,5,0,0,8
"cg25229809",1,0,0,0,1
"cg25230736",1,0,0,0,1
"cg25230945",605,37,1,0,643
"cg25231832",38,3,0,0,41
"cg25234170",0,0,1,0,1
"cg25234434",0,0,1,0,1
"cg25234732",1,0,0,0,1
"cg25235094",1,0,0,0,1
"cg25235326",1,0,0,0,1
"cg25237204",1,0,0,0,1
"cg25237410",0,0,2,0,2
"cg25237545",1,0,0,0,1
"cg25241320",2,2,1,0,5
"cg25241399",0,0,1,0,1
"cg25242608",0,0,1,0,1
"cg25242824",2,10,1,0,13
"cg25243321",1,0,0,0,1
"cg25244102",1,0,0,0,1
"cg25244375",0,0,2,0,2
"cg25248593",0,0,1,0,1
"cg25249050",0,1,0,0,1
"cg25249541",1,0,0,0,1
"cg25250833",5,7,12,0,24
"cg25251249",0,0,1,0,1
"cg25254270",0,0,0,1,1
"cg25254763",1,0,0,0,1
"cg25255030",0,0,0,1,1
"cg25255429",0,1,0,0,1
"cg25255713",0,1,0,0,1
"cg25255897",0,0,4,0,4
"cg25256498",94,3,0,0,97
"cg25256538",0,1,0,0,1
"cg25257018",112,1,0,0,113
"cg25258847",549,30,0,0,579
"cg25259129",0,2,0,0,2
"cg25260061",0,0,1,0,1
"cg25261708",0,0,1,0,1
"cg25262631",4,2,0,0,6
"cg25263898",48,15,1,0,64
"cg25264779",15,3,1,0,19
"cg25264972",1,0,0,0,1
"cg25265300",0,2,0,0,2
"cg25265767",1,0,0,0,1
"cg25265769",229,390,18,0,637
"cg25265790",0,3,0,0,3
"cg25265805",4,1,0,0,5
"cg25265824",1,0,0,0,1
"cg25265930",1,0,0,0,1
"cg25266436",56,10,0,0,66
"cg25267768",0,1,0,0,1
"cg25268681",1,0,0,0,1
"cg25270186",0,0,1,0,1
"cg25270422",0,1,0,0,1
"cg25271804",2,2,3,0,7
"cg25271930",8,9,0,0,17
"cg25272121",0,1,3,0,4
"cg25272353",0,0,1,0,1
"cg25273161",1,3,3,0,7
"cg25273515",25,14,6,0,45
"cg25273625",0,1,0,0,1
"cg25273846",1,0,0,0,1
"cg25274141",0,0,1,0,1
"cg25274598",246,77,2,0,325
"cg25275860",0,0,1,0,1
"cg25276599",4,0,0,0,4
"cg25276655",1,0,0,0,1
"cg25278576",25,14,1,0,40
"cg25280040",0,1,10,0,11
"cg25280589",1,0,0,0,1
"cg25280791",0,0,1,0,1
"cg25281020",3,9,12,0,24
"cg25281824",0,1,0,0,1
"cg25281884",6,6,0,0,12
"cg25282271",1,0,0,0,1
"cg25282559",0,0,1,0,1
"cg25283205",31,5,0,0,36
"cg25283536",0,1,0,0,1
"cg25283966",1,0,0,0,1
"cg25284624",2,1,1,0,4
"cg25284710",0,1,1,0,2
"cg25285186",1,0,0,0,1
"cg25285383",26,1,0,0,27
"cg25286164",2,3,1,0,6
"cg25287199",0,0,2,0,2
"cg25287207",8,0,0,0,8
"cg25287247",0,0,1,0,1
"cg25287541",1,0,0,0,1
"cg25288433",1,0,1,0,2
"cg25288464",4,3,0,0,7
"cg25288627",520,43,0,0,563
"cg25288855",5,2,0,0,7
"cg25288962",0,0,1,0,1
"cg25289431",2,0,0,0,2
"cg25290098",8,0,1,0,9
"cg25290175",16,5,16,0,37
"cg25291980",0,3,0,0,3
"cg25292358",4,1,1,0,6
"cg25293221",3,0,0,0,3
"cg25293265",1,0,0,0,1
"cg25293675",1,0,2,0,3
"cg25294651",4,0,0,0,4
"cg25294910",1,0,0,0,1
"cg25295512",2,1,0,0,3
"cg25296477",0,0,1,0,1
"cg25298992",0,2,0,0,2
"cg25299176",0,1,0,0,1
"cg25299580",4,0,0,0,4
"cg25300318",0,1,0,0,1
"cg25300699",0,0,1,0,1
"cg25301064",4,9,3,1,17
"cg25302436",0,0,2,0,2
"cg25303477",0,1,0,0,1
"cg25305259",0,0,1,0,1
"cg25305750",1,0,0,0,1
"cg25307796",0,0,1,0,1
"cg25308044",3,0,0,0,3
"cg25310071",152,126,12,0,290
"cg25310762",0,1,0,0,1
"cg25312474",0,1,0,0,1
"cg25313464",164,4,0,0,168
"cg25314460",77,33,1,0,111
"cg25314548",1,0,0,0,1
"cg25314786",1,0,1,0,2
"cg25315731",8,7,0,0,15
"cg25316120",0,0,2,0,2
"cg25316428",0,1,0,0,1
"cg25316543",36,34,9,0,79
"cg25316624",0,2,4,0,6
"cg25317268",0,1,0,0,1
"cg25318415",1,0,0,0,1
"cg25318470",1,2,0,0,3
"cg25319543",0,0,1,0,1
"cg25319564",0,0,1,0,1
"cg25322451",4,1,1,0,6
"cg25323013",0,1,0,0,1
"cg25325615",183,37,0,0,220
"cg25325710",0,4,3,0,7
"cg25326090",527,70,0,0,597
"cg25326289",3,0,1,0,4
"cg25327092",0,0,1,0,1
"cg25327531",0,0,1,0,1
"cg25329164",0,0,2,0,2
"cg25329267",6,3,2,0,11
"cg25329269",0,0,1,0,1
"cg25331271",0,1,0,0,1
"cg25332207",9,7,1,0,17
"cg25332436",0,0,0,1,1
"cg25332820",1,0,0,0,1
"cg25333395",73,21,0,0,94
"cg25333602",1,0,0,0,1
"cg25334461",0,0,1,0,1
"cg25335190",0,0,1,0,1
"cg25335616",1,0,2,0,3
"cg25336021",0,1,5,0,6
"cg25336267",0,1,0,0,1
"cg25336748",1,0,0,0,1
"cg25338876",2,0,0,0,2
"cg25339449",0,0,2,0,2
"cg25339908",10,28,3,0,41
"cg25340429",0,0,3,0,3
"cg25341099",0,4,0,0,4
"cg25341635",2,0,0,0,2
"cg25341738",3,1,0,0,4
"cg25341923",0,0,1,0,1
"cg25342180",6,27,1,0,34
"cg25342686",1,0,0,0,1
"cg25342822",2,1,0,0,3
"cg25343008",0,0,2,0,2
"cg25344693",1,0,1,0,2
"cg25345528",1,0,0,0,1
"cg25345648",0,0,31,0,31
"cg25345787",0,1,0,0,1
"cg25346444",11,11,4,0,26
"cg25346843",1,0,0,0,1
"cg25347242",0,0,1,0,1
"cg25347615",0,3,6,0,9
"cg25347826",0,0,2,0,2
"cg25348940",0,0,1,0,1
"cg25349314",0,0,2,0,2
"cg25349623",15,3,0,0,18
"cg25349629",0,2,2,0,4
"cg25350294",0,0,1,0,1
"cg25350464",2,1,0,0,3
"cg25350872",0,0,2,0,2
"cg25351461",2,3,6,0,11
"cg25351687",0,2,0,0,2
"cg25352781",0,1,1,0,2
"cg25354655",60,24,7,0,91
"cg25355006",0,0,1,0,1
"cg25355159",0,0,1,0,1
"cg25355465",1,0,0,0,1
"cg25356886",0,1,2,0,3
"cg25356951",70,99,15,0,184
"cg25357359",0,0,1,0,1
"cg25357918",7,0,0,0,7
"cg25358230",0,0,3,0,3
"cg25359908",0,0,1,0,1
"cg25360788",0,3,0,0,3
"cg25361935",0,1,0,0,1
"cg25362525",3,4,8,0,15
"cg25363927",1,0,0,0,1
"cg25365370",47,9,0,0,56
"cg25365379",1,0,0,0,1
"cg25365565",2,3,1,0,6
"cg25366822",1,0,0,0,1
"cg25367323",1,0,0,0,1
"cg25367388",0,0,2,0,2
"cg25368049",2,10,13,0,25
"cg25368148",0,0,0,1,1
"cg25368212",0,1,0,0,1
"cg25368482",0,0,1,0,1
"cg25368581",3,1,0,0,4
"cg25370228",0,1,0,0,1
"cg25370414",1,0,1,0,2
"cg25370836",1,0,0,0,1
"cg25372354",1,0,0,0,1
"cg25372449",0,1,1,0,2
"cg25373401",0,0,1,0,1
"cg25373614",0,0,1,0,1
"cg25373794",0,0,1,0,1
"cg25373847",11,0,0,0,11
"cg25374028",1,0,0,0,1
"cg25374039",0,2,1,0,3
"cg25374040",39,1,0,0,40
"cg25374173",1,32,1,0,34
"cg25376393",0,0,1,0,1
"cg25376451",2,1,0,0,3
"cg25378574",0,0,1,0,1
"cg25378917",195,411,27,0,633
"cg25379012",0,2,2,0,4
"cg25380443",1,0,0,0,1
"cg25380979",0,0,1,0,1
"cg25381085",12,2,0,0,14
"cg25381800",39,4,0,0,43
"cg25381836",2,0,0,0,2
"cg25382025",34,12,0,0,46
"cg25382486",1,0,0,0,1
"cg25382606",0,1,0,0,1
"cg25383155",2,2,0,0,4
"cg25383242",104,11,0,0,115
"cg25384420",3,2,5,0,10
"cg25384477",0,1,0,0,1
"cg25384595",0,0,1,0,1
"cg25386688",926,224,3,0,1153
"cg25387410",0,0,2,0,2
"cg25388061",1,0,0,0,1
"cg25388157",5,4,1,0,10
"cg25390461",4,1,0,0,5
"cg25391162",3,3,0,0,6
"cg25391444",232,16,0,0,248
"cg25393388",0,3,1,0,4
"cg25393495",0,2,1,0,3
"cg25393574",5,6,3,0,14
"cg25394301",4,0,0,0,4
"cg25394461",0,0,1,0,1
"cg25394572",0,0,2,0,2
"cg25395581",172,89,3,0,264
"cg25395671",0,1,0,0,1
"cg25396185",2,5,2,0,9
"cg25396640",2,1,0,0,3
"cg25398223",0,4,1,0,5
"cg25398408",488,29,0,0,517
"cg25399504",18,3,0,0,21
"cg25399512",0,1,0,0,1
"cg25400753",789,94,0,0,883
"cg25400948",1,0,0,0,1
"cg25401219",2,2,0,0,4
"cg25401621",5,3,0,0,8
"cg25402281",29,15,1,0,45
"cg25402362",0,1,0,0,1
"cg25402667",1,0,0,0,1
"cg25403084",0,0,4,0,4
"cg25404033",3,1,0,0,4
"cg25405719",2,1,0,0,3
"cg25407053",4,2,2,0,8
"cg25407227",1,0,0,0,1
"cg25408325",0,5,0,0,5
"cg25409185",0,0,2,0,2
"cg25409448",0,0,1,0,1
"cg25409944",2,2,0,0,4
"cg25410739",0,0,1,0,1
"cg25411266",0,1,0,0,1
"cg25411465",1,0,0,0,1
"cg25411699",5,0,0,0,5
"cg25413125",63,4,0,0,67
"cg25413298",3,5,0,0,8
"cg25414858",0,0,1,0,1
"cg25418945",5,0,0,0,5
"cg25420018",10,0,0,0,10
"cg25420047",1,0,0,0,1
"cg25420101",0,1,0,0,1
"cg25420298",0,1,0,0,1
"cg25420507",0,0,1,0,1
"cg25420945",10,4,1,0,15
"cg25421209",0,1,0,0,1
"cg25421336",0,1,0,0,1
"cg25421423",589,59,2,0,650
"cg25421629",0,0,1,0,1
"cg25421663",0,2,4,0,6
"cg25422753",0,0,1,0,1
"cg25423520",12,7,0,0,19
"cg25424194",0,1,0,0,1
"cg25424250",3,4,6,0,13
"cg25424283",1,0,0,0,1
"cg25424373",0,0,1,0,1
"cg25425005",0,1,0,0,1
"cg25425642",1,0,0,0,1
"cg25426307",0,1,0,0,1
"cg25426892",1,1,0,0,2
"cg25427524",12,2,3,0,17
"cg25428146",0,0,2,0,2
"cg25428156",2,7,17,0,26
"cg25428263",0,0,2,0,2
"cg25428494",5,0,0,0,5
"cg25428810",47,4,1,0,52
"cg25429719",0,0,1,0,1
"cg25430350",1,0,0,0,1
"cg25431093",172,355,243,0,770
"cg25431479",53,3,0,0,56
"cg25431819",9,5,2,0,16
"cg25432807",0,1,5,0,6
"cg25433157",1,2,2,1,6
"cg25434113",0,0,1,0,1
"cg25435479",1,0,0,0,1
"cg25435594",0,0,2,0,2
"cg25436127",0,0,1,0,1
"cg25436507",0,0,1,0,1
"cg25437180",0,0,1,0,1
"cg25437259",0,0,1,0,1
"cg25438174",0,2,0,0,2
"cg25439735",0,0,2,0,2
"cg25439826",0,1,1,0,2
"cg25439845",1,1,1,0,3
"cg25440671",3,3,0,0,6
"cg25441176",107,485,20,0,612
"cg25441219",0,2,0,0,2
"cg25442363",5,5,11,0,21
"cg25443512",19,3,0,0,22
"cg25444208",0,1,0,0,1
"cg25444615",3,0,0,0,3
"cg25444811",0,0,1,0,1
"cg25445889",0,1,1,0,2
"cg25447019",0,0,1,0,1
"cg25448687",1,0,0,0,1
"cg25449862",2,0,0,0,2
"cg25450113",1071,176,1,0,1248
"cg25451745",1,0,0,0,1
"cg25452165",0,0,1,0,1
"cg25452172",0,1,0,0,1
"cg25452353",1,0,1,0,2
"cg25454681",1,0,0,0,1
"cg25455909",0,1,0,0,1
"cg25456204",1,1,0,0,2
"cg25456633",379,52,0,0,431
"cg25457607",1,0,0,0,1
"cg25457923",3,1,0,0,4
"cg25458713",0,1,6,0,7
"cg25459639",5,0,0,0,5
"cg25461240",0,0,1,0,1
"cg25461289",1,1,0,0,2
"cg25461326",0,0,2,0,2
"cg25462807",1,0,0,0,1
"cg25465548",0,0,1,0,1
"cg25467549",0,0,3,0,3
"cg25467746",0,1,0,0,1
"cg25468005",0,1,0,0,1
"cg25469171",6,10,0,0,16
"cg25469474",0,0,1,0,1
"cg25469714",0,1,0,0,1
"cg25469905",5,0,0,0,5
"cg25470051",0,0,1,0,1
"cg25470384",0,0,1,0,1
"cg25470479",4,3,2,0,9
"cg25472174",0,1,0,0,1
"cg25473018",4,1,0,0,5
"cg25473203",0,0,1,0,1
"cg25473487",0,0,1,0,1
"cg25473665",0,1,0,0,1
"cg25473949",1,0,0,0,1
"cg25475577",1,0,4,0,5
"cg25476096",0,0,1,0,1
"cg25476130",2,5,8,0,15
"cg25476713",27,0,0,0,27
"cg25477904",7,0,0,0,7
"cg25479093",501,11,1,0,513
"cg25479256",0,0,1,0,1
"cg25479535",2,0,0,0,2
"cg25479565",843,128,1,0,972
"cg25480799",0,0,1,0,1
"cg25481178",1,0,0,0,1
"cg25481201",3,0,0,0,3
"cg25481587",0,1,0,0,1
"cg25481888",0,2,1,0,3
"cg25482228",308,35,1,0,344
"cg25482247",3,0,1,0,4
"cg25482854",0,3,1,0,4
"cg25485091",0,0,1,0,1
"cg25485822",2,1,0,0,3
"cg25485994",0,1,0,0,1
"cg25487065",2,0,0,0,2
"cg25488749",0,2,1,1,4
"cg25489030",0,3,0,0,3
"cg25490276",1,0,0,0,1
"cg25491112",2,0,0,0,2
"cg25492440",1,0,0,0,1
"cg25492458",179,11,0,0,190
"cg25492985",3,0,0,0,3
"cg25494408",492,10,0,0,502
"cg25495572",2,2,1,0,5
"cg25496342",1,0,0,0,1
"cg25499021",151,23,0,0,174
"cg25500642",40,6,1,0,47
"cg25501224",1,1,10,0,12
"cg25502399",0,0,1,0,1
"cg25503115",15,0,1,0,16
"cg25503524",1,0,0,0,1
"cg25504143",29,2,0,0,31
"cg25504788",2,1,0,0,3
"cg25504966",2,3,2,0,7
"cg25505297",1,0,0,0,1
"cg25505785",0,2,0,0,2
"cg25506204",0,0,1,0,1
"cg25506220",1,1,0,0,2
"cg25507406",47,16,2,0,65
"cg25508472",0,0,1,0,1
"cg25509643",1,1,0,0,2
"cg25512667",0,0,0,1,1
"cg25512738",0,1,0,0,1
"cg25512848",5,0,1,0,6
"cg25513108",17,6,0,0,23
"cg25513665",0,5,2,0,7
"cg25514545",0,0,1,0,1
"cg25514554",6,9,7,0,22
"cg25514992",1,0,0,0,1
"cg25515140",0,1,0,0,1
"cg25515758",1,1,0,0,2
"cg25515776",0,2,10,0,12
"cg25517755",4,3,0,0,7
"cg25519281",0,0,1,0,1
"cg25519942",1,0,0,0,1
"cg25520068",0,1,0,0,1
"cg25520495",0,1,6,0,7
"cg25521682",0,3,1,0,4
"cg25522208",0,0,1,0,1
"cg25522795",1,1,0,0,2
"cg25523332",1,0,0,0,1
"cg25523522",9,0,0,0,9
"cg25525778",0,0,1,0,1
"cg25526498",12,0,0,0,12
"cg25528298",1,0,0,0,1
"cg25528339",0,0,1,0,1
"cg25528451",77,91,1,0,169
"cg25529026",1,0,0,0,1
"cg25529393",7,0,0,0,7
"cg25530730",0,0,1,0,1
"cg25531220",0,1,0,0,1
"cg25531363",0,1,0,0,1
"cg25532289",0,1,0,0,1
"cg25532503",0,0,1,0,1
"cg25533551",2,0,0,0,2
"cg25534009",0,0,1,0,1
"cg25535044",2,7,0,0,9
"cg25535652",49,26,0,0,75
"cg25536036",2,2,0,0,4
"cg25536256",1,0,0,0,1
"cg25536318",0,1,1,0,2
"cg25536467",0,0,1,0,1
"cg25537293",1,0,4,0,5
"cg25538103",0,0,1,0,1
"cg25538674",1,2,7,0,10
"cg25538713",3,5,2,0,10
"cg25538855",0,1,0,0,1
"cg25540004",207,34,1,0,242
"cg25541156",1,1,0,0,2
"cg25541738",2,3,2,0,7
"cg25542007",0,0,0,1,1
"cg25542053",0,1,0,0,1
"cg25542244",1,1,0,0,2
"cg25542337",12,0,0,0,12
"cg25542559",0,0,1,0,1
"cg25542636",0,0,1,0,1
"cg25543068",0,13,1,0,14
"cg25543190",137,327,101,0,565
"cg25543447",0,3,0,0,3
"cg25545036",1,0,0,0,1
"cg25545074",1,0,0,0,1
"cg25545917",0,0,1,0,1
"cg25546118",3,1,0,0,4
"cg25546612",0,1,0,0,1
"cg25546816",0,1,0,0,1
"cg25546901",0,1,0,0,1
"cg25547575",0,0,2,0,2
"cg25548455",1,0,0,0,1
"cg25549378",1,0,0,0,1
"cg25550279",0,0,1,0,1
"cg25551243",1,0,0,0,1
"cg25552629",0,0,1,0,1
"cg25553015",0,1,0,0,1
"cg25553128",0,0,1,0,1
"cg25553483",17,2,0,0,19
"cg25553843",0,2,5,0,7
"cg25556445",0,1,1,0,2
"cg25556464",6,0,0,0,6
"cg25558440",1,0,0,0,1
"cg25558531",1,0,0,0,1
"cg25559322",0,2,0,0,2
"cg25560268",1,4,0,0,5
"cg25560398",0,1,0,0,1
"cg25561821",0,1,0,0,1
"cg25562619",0,1,0,0,1
"cg25563532",1,0,0,0,1
"cg25563979",3,1,4,0,8
"cg25564392",0,0,1,0,1
"cg25566909",0,0,1,0,1
"cg25567021",1,0,0,0,1
"cg25567680",2,0,0,0,2
"cg25568745",0,1,0,0,1
"cg25568915",1,0,0,0,1
"cg25569624",0,1,0,0,1
"cg25569687",1,0,0,0,1
"cg25570096",0,0,1,0,1
"cg25570381",2,0,0,0,2
"cg25570486",0,0,1,0,1
"cg25570874",0,0,1,0,1
"cg25571432",13,0,0,0,13
"cg25571588",1,0,0,0,1
"cg25572189",0,0,4,0,4
"cg25574849",0,0,1,0,1
"cg25575260",1,0,0,0,1
"cg25575831",0,0,1,0,1
"cg25575889",0,0,1,0,1
"cg25577193",9,1,0,0,10
"cg25577272",0,1,0,0,1
"cg25577431",0,0,1,0,1
"cg25579854",13,1,0,0,14
"cg25581932",0,1,0,0,1
"cg25582168",1,2,0,0,3
"cg25582185",0,0,1,0,1
"cg25582303",0,0,3,0,3
"cg25582669",25,2,0,0,27
"cg25583180",0,0,1,0,1
"cg25583503",1,0,0,0,1
"cg25586516",0,1,0,0,1
"cg25588106",2,0,0,0,2
"cg25589521",0,1,0,0,1
"cg25590181",1,0,1,0,2
"cg25591519",1,0,0,0,1
"cg25591616",6,0,0,0,6
"cg25593380",0,1,0,0,1
"cg25593391",0,1,0,0,1
"cg25593510",0,0,0,1,1
"cg25593776",0,0,1,0,1
"cg25595637",1,0,0,0,1
"cg25598062",56,53,1,0,110
"cg25598083",0,0,0,1,1
"cg25598624",0,0,3,0,3
"cg25599786",0,0,1,0,1
"cg25600063",0,0,1,1,2
"cg25600478",0,1,0,0,1
"cg25600692",526,32,2,0,560
"cg25600823",0,0,1,0,1
"cg25600990",1,0,0,0,1
"cg25601501",2,1,3,0,6
"cg25601949",3,0,0,0,3
"cg25602653",2,0,0,0,2
"cg25602765",0,1,0,0,1
"cg25605038",245,33,1,0,279
"cg25605290",2,2,1,0,5
"cg25605360",18,0,0,0,18
"cg25605769",0,1,0,0,1
"cg25607032",5,3,5,0,13
"cg25607528",2,0,0,0,2
"cg25607754",1,0,0,0,1
"cg25610083",136,42,1,0,179
"cg25610245",1,1,2,0,4
"cg25611570",0,0,1,0,1
"cg25611787",4,4,0,0,8
"cg25612752",2,2,21,0,25
"cg25614269",1,0,0,0,1
"cg25614935",0,1,0,0,1
"cg25615540",0,0,2,0,2
"cg25615890",69,8,0,0,77
"cg25616771",25,2,0,0,27
"cg25617236",195,57,3,0,255
"cg25618439",1,0,0,0,1
"cg25618597",0,1,0,0,1
"cg25618765",0,0,3,0,3
"cg25619153",64,1,0,0,65
"cg25619312",8,0,0,0,8
"cg25619707",0,3,3,0,6
"cg25621343",1,2,0,0,3
"cg25623347",1,0,0,0,1
"cg25623886",0,1,0,0,1
"cg25624023",1,0,1,0,2
"cg25625600",0,1,0,0,1
"cg25625616",6,2,0,0,8
"cg25626264",0,0,1,0,1
"cg25626310",9,2,0,0,11
"cg25626488",1,3,2,0,6
"cg25628429",0,1,0,0,1
"cg25628762",0,1,0,0,1
"cg25629433",14,3,0,0,17
"cg25629694",1,0,0,0,1
"cg25630506",2,0,2,0,4
"cg25630601",0,0,1,0,1
"cg25630796",0,0,1,0,1
"cg25630850",1,2,0,0,3
"cg25631218",2,0,0,0,2
"cg25631436",130,193,208,0,531
"cg25632695",1,0,0,0,1
"cg25633045",4,1,0,0,5
"cg25633284",0,2,0,0,2
"cg25633553",0,1,1,0,2
"cg25634091",0,0,1,0,1
"cg25634536",11,2,6,0,19
"cg25634823",0,1,2,0,3
"cg25637520",2,0,1,0,3
"cg25638043",1,0,1,0,2
"cg25638186",1,1,0,0,2
"cg25638796",0,2,4,0,6
"cg25639245",6,0,0,0,6
"cg25640288",291,312,22,0,625
"cg25640389",2,1,2,0,5
"cg25640686",1,0,0,0,1
"cg25640740",0,1,0,0,1
"cg25641025",3,1,0,0,4
"cg25641243",1,0,0,0,1
"cg25641855",1,0,0,0,1
"cg25642880",344,224,29,0,597
"cg25644257",203,14,0,0,217
"cg25644317",0,0,1,0,1
"cg25644323",8,0,0,0,8
"cg25646649",111,222,2,0,335
"cg25649283",1,0,2,0,3
"cg25650185",1,2,0,0,3
"cg25650661",1,0,0,0,1
"cg25650811",5,1,0,0,6
"cg25651476",0,0,1,0,1
"cg25652293",2,3,0,0,5
"cg25652534",4,2,0,0,6
"cg25652551",10,7,0,0,17
"cg25652873",1,0,1,0,2
"cg25653296",0,0,3,0,3
"cg25653368",23,1,0,0,24
"cg25653886",622,129,4,0,755
"cg25653995",0,1,0,0,1
"cg25656881",7,0,0,0,7
"cg25657261",1,1,0,0,2
"cg25657615",1,0,0,0,1
"cg25658612",1,0,0,0,1
"cg25658641",13,9,1,0,23
"cg25659288",2,0,0,0,2
"cg25662991",0,2,0,0,2
"cg25663326",1,0,0,0,1
"cg25663603",1,0,0,0,1
"cg25663970",0,1,0,0,1
"cg25664234",4,0,0,0,4
"cg25666660",6,1,0,0,7
"cg25667070",1,0,0,0,1
"cg25667078",9,6,0,0,15
"cg25667860",0,0,1,0,1
"cg25668320",0,1,0,0,1
"cg25668777",254,467,6,0,727
"cg25669476",0,1,0,0,1
"cg25669697",0,1,0,0,1
"cg25670229",2,7,2,0,11
"cg25670930",0,1,0,0,1
"cg25671418",5,0,0,0,5
"cg25672513",0,0,1,0,1
"cg25673589",0,0,1,0,1
"cg25673945",247,29,1,0,277
"cg25674056",0,0,0,1,1
"cg25675940",0,1,0,0,1
"cg25676678",0,1,0,0,1
"cg25676890",0,0,1,0,1
"cg25677688",1,0,0,0,1
"cg25680105",1,0,0,0,1
"cg25680226",0,0,2,0,2
"cg25680598",12,0,0,0,12
"cg25680791",1,0,0,0,1
"cg25680808",0,1,0,0,1
"cg25681867",0,0,1,0,1
"cg25681945",3,1,0,0,4
"cg25682903",0,0,1,0,1
"cg25682929",0,0,1,0,1
"cg25683812",3,0,0,0,3
"cg25684934",2,0,0,0,2
"cg25685455",0,0,0,1,1
"cg25685524",0,1,0,0,1
"cg25685816",0,1,0,0,1
"cg25685928",0,0,1,0,1
"cg25687788",0,0,1,0,1
"cg25687825",10,3,0,0,13
"cg25687923",0,1,0,0,1
"cg25688027",0,1,0,0,1
"cg25689459",1,0,0,0,1
"cg25689647",171,31,0,0,202
"cg25690149",0,0,1,0,1
"cg25691436",0,1,0,0,1
"cg25691900",4,5,0,0,9
"cg25692323",1,0,1,0,2
"cg25692507",0,0,1,0,1
"cg25693265",4,0,0,0,4
"cg25695378",26,37,0,0,63
"cg25695722",1,0,0,0,1
"cg25696613",1,0,0,0,1
"cg25697004",0,0,1,0,1
"cg25697018",1,0,0,0,1
"cg25697998",0,1,2,0,3
"cg25698726",52,96,11,0,159
"cg25699136",4,0,0,0,4
"cg25699218",3,0,0,0,3
"cg25700293",0,0,1,0,1
"cg25700305",1,0,0,0,1
"cg25700851",0,1,0,0,1
"cg25701047",0,1,0,0,1
"cg25701114",2,0,4,0,6
"cg25701564",1,0,0,0,1
"cg25701710",1,0,0,0,1
"cg25703554",3,1,0,0,4
"cg25703864",0,1,0,0,1
"cg25704220",0,1,0,0,1
"cg25704368",2,1,7,0,10
"cg25705255",2,1,0,0,3
"cg25705492",0,1,8,0,9
"cg25705866",1,1,6,0,8
"cg25706358",0,0,4,0,4
"cg25706971",2,0,0,0,2
"cg25707767",0,0,1,0,1
"cg25708189",1,0,1,0,2
"cg25708755",0,0,3,0,3
"cg25708777",0,1,0,0,1
"cg25709073",2,0,0,0,2
"cg25710796",1,0,0,0,1
"cg25711786",0,0,1,0,1
"cg25712344",1,0,0,0,1
"cg25712819",1,2,0,0,3
"cg25714060",568,324,9,0,901
"cg25714381",0,0,1,0,1
"cg25714649",0,0,3,0,3
"cg25714766",7,15,4,0,26
"cg25715539",2,0,0,0,2
"cg25715949",1,0,0,0,1
"cg25717210",2,0,0,0,2
"cg25719081",1,0,0,0,1
"cg25720033",1,0,0,0,1
"cg25720114",0,0,1,0,1
"cg25720815",1,0,0,0,1
"cg25722616",2,0,0,0,2
"cg25722691",12,3,0,0,15
"cg25723959",0,0,2,0,2
"cg25724323",0,1,0,0,1
"cg25724499",763,652,12,0,1427
"cg25725872",637,53,1,0,691
"cg25726150",0,1,0,0,1
"cg25726864",656,71,2,0,729
"cg25727203",4,0,0,0,4
"cg25727614",1,1,0,0,2
"cg25728362",1,1,1,0,3
"cg25728543",323,227,27,0,577
"cg25729060",0,0,1,0,1
"cg25730666",5,0,0,0,5
"cg25731347",586,270,3,0,859
"cg25731960",0,1,3,0,4
"cg25732800",26,18,3,0,47
"cg25732889",3,0,0,0,3
"cg25733445",3,0,0,0,3
"cg25734107",7,0,0,0,7
"cg25734951",6,6,5,0,17
"cg25735039",1,0,0,0,1
"cg25736339",14,4,0,0,18
"cg25736465",0,1,1,0,2
"cg25737003",0,1,6,0,7
"cg25737737",0,0,1,0,1
"cg25738037",0,1,0,0,1
"cg25738236",0,1,0,0,1
"cg25741340",0,0,3,0,3
"cg25742365",0,1,0,0,1
"cg25742729",1,0,0,0,1
"cg25743234",1,0,0,0,1
"cg25744107",1,2,0,0,3
"cg25744450",0,0,0,1,1
"cg25744558",306,13,4,0,323
"cg25744776",1,0,0,0,1
"cg25745201",48,0,0,0,48
"cg25745244",120,12,1,0,133
"cg25745389",0,0,1,0,1
"cg25745773",0,0,1,0,1
"cg25747030",1,0,1,0,2
"cg25747059",0,0,3,0,3
"cg25748121",2,0,0,0,2
"cg25748542",1,1,0,0,2
"cg25749565",3,0,0,0,3
"cg25750148",0,0,1,0,1
"cg25750688",0,0,1,1,2
"cg25751054",0,0,0,1,1
"cg25752797",0,1,0,0,1
"cg25752975",1,0,0,0,1
"cg25757689",0,0,1,0,1
"cg25758315",1,0,1,0,2
"cg25758413",51,112,4,0,167
"cg25758537",2,1,1,0,4
"cg25758690",1,0,0,0,1
"cg25758979",0,1,1,0,2
"cg25760395",5,0,0,0,5
"cg25760776",0,0,5,0,5
"cg25761270",1,0,0,0,1
"cg25761686",2,1,0,0,3
"cg25763342",1,0,0,0,1
"cg25764340",1,0,0,0,1
"cg25764839",28,1,0,0,29
"cg25764957",0,0,1,0,1
"cg25765192",0,0,1,0,1
"cg25765275",0,1,0,0,1
"cg25765720",0,0,9,0,9
"cg25767054",7,0,0,0,7
"cg25767896",6,7,3,0,16
"cg25770948",1,0,0,0,1
"cg25770995",1,0,0,0,1
"cg25772474",42,1,0,0,43
"cg25777420",1,0,0,0,1
"cg25777540",1,0,0,0,1
"cg25777856",0,0,1,0,1
"cg25778076",0,1,1,0,2
"cg25778954",0,0,1,0,1
"cg25779302",1,1,0,0,2
"cg25779596",7,1,0,0,8
"cg25780551",1,0,2,0,3
"cg25780806",2,4,3,0,9
"cg25781258",0,1,0,0,1
"cg25783153",678,34,0,0,712
"cg25783315",1,0,0,0,1
"cg25784319",0,1,0,0,1
"cg25784633",0,0,1,0,1
"cg25784900",5,0,0,0,5
"cg25785155",79,8,0,0,87
"cg25785177",1,0,0,0,1
"cg25786265",4,1,0,0,5
"cg25787765",34,4,0,0,38
"cg25788250",0,0,4,1,5
"cg25788828",3,0,0,0,3
"cg25789162",3,0,0,0,3
"cg25790241",0,2,0,0,2
"cg25790274",0,4,0,0,4
"cg25790831",2,0,0,0,2
"cg25791875",0,0,3,0,3
"cg25792712",0,1,1,0,2
"cg25793197",0,0,1,0,1
"cg25793628",331,49,0,0,380
"cg25794311",0,0,1,0,1
"cg25794694",1,0,2,0,3
"cg25798711",2,0,0,0,2
"cg25801034",0,1,0,0,1
"cg25801502",0,1,0,0,1
"cg25801971",1,1,5,0,7
"cg25803242",2,0,0,0,2
"cg25805146",2,6,0,0,8
"cg25805946",0,2,0,0,2
"cg25806685",1,1,0,0,2
"cg25806808",0,1,0,0,1
"cg25807061",1,1,3,0,5
"cg25811465",0,1,0,0,1
"cg25811656",0,0,2,0,2
"cg25813193",11,0,0,0,11
"cg25813714",0,0,1,0,1
"cg25814432",482,33,1,0,516
"cg25814715",1,3,6,0,10
"cg25815065",0,6,0,0,6
"cg25815683",1,4,3,0,8
"cg25816268",0,0,2,0,2
"cg25816317",1,4,1,0,6
"cg25816806",42,1,0,0,43
"cg25817800",0,2,0,0,2
"cg25817973",28,1,0,0,29
"cg25818402",5,5,3,0,13
"cg25818642",7,3,0,0,10
"cg25818890",1,0,0,0,1
"cg25818915",2,0,4,0,6
"cg25819406",1,0,1,0,2
"cg25819424",0,1,0,0,1
"cg25820033",0,1,0,0,1
"cg25820791",0,0,1,0,1
"cg25820899",1,0,0,0,1
"cg25820971",0,1,0,0,1
"cg25821157",0,0,1,0,1
"cg25821974",0,1,0,0,1
"cg25822552",0,0,3,0,3
"cg25824209",90,17,3,0,110
"cg25825740",0,1,0,0,1
"cg25825810",3,1,0,0,4
"cg25827053",13,14,9,0,36
"cg25828381",0,0,1,0,1
"cg25828607",11,0,0,0,11
"cg25828806",0,1,0,0,1
"cg25830561",0,0,1,0,1
"cg25833800",6,5,13,0,24
"cg25834613",0,1,0,0,1
"cg25835819",30,0,0,0,30
"cg25837207",0,0,3,0,3
"cg25838590",4,0,0,0,4
"cg25838738",0,0,1,0,1
"cg25839342",11,3,0,0,14
"cg25840306",0,0,1,0,1
"cg25840850",0,0,1,0,1
"cg25841278",22,1,0,0,23
"cg25841923",0,1,1,0,2
"cg25843111",161,28,5,0,194
"cg25843602",2,5,2,0,9
"cg25844133",1,0,0,0,1
"cg25844366",11,8,0,0,19
"cg25844916",2,1,1,0,4
"cg25846302",0,3,2,0,5
"cg25849281",52,3,0,0,55
"cg25849332",1,0,0,0,1
"cg25849876",0,1,0,0,1
"cg25850599",1,0,0,0,1
"cg25851488",1008,484,4,0,1496
"cg25852074",1,0,0,0,1
"cg25852722",0,0,1,0,1
"cg25852745",1,0,0,0,1
"cg25852962",5,2,1,0,8
"cg25853612",6,2,0,0,8
"cg25854178",1,0,0,0,1
"cg25854649",1,0,0,0,1
"cg25855162",2,0,0,0,2
"cg25856530",1,0,0,0,1
"cg25861453",0,0,1,0,1
"cg25862002",3,0,0,0,3
"cg25862116",4,0,0,0,4
"cg25862422",0,0,1,0,1
"cg25863382",4,5,4,0,13
"cg25863503",0,0,1,0,1
"cg25863708",0,3,0,0,3
"cg25864187",0,0,1,0,1
"cg25864978",1,0,0,0,1
"cg25866738",0,1,0,0,1
"cg25866889",4,4,0,0,8
"cg25867820",0,8,0,0,8
"cg25867973",0,1,0,0,1
"cg25868624",7,3,0,0,10
"cg25868793",1,0,0,0,1
"cg25870010",1,1,3,0,5
"cg25870680",38,25,3,0,66
"cg25871696",203,334,14,0,551
"cg25871824",1,0,0,0,1
"cg25872198",1,0,0,0,1
"cg25872885",0,0,1,0,1
"cg25873532",0,0,0,1,1
"cg25874497",2,0,0,0,2
"cg25876469",0,2,1,0,3
"cg25877317",4,2,0,0,6
"cg25879477",2,0,0,0,2
"cg25880151",2,0,0,0,2
"cg25880358",199,77,5,0,281
"cg25880581",43,123,4,0,170
"cg25881432",0,0,1,0,1
"cg25883022",49,303,144,0,496
"cg25883465",1,0,0,0,1
"cg25883868",0,0,0,2,2
"cg25884094",635,229,8,0,872
"cg25884255",1,0,0,0,1
"cg25884566",0,0,2,0,2
"cg25887748",0,1,0,0,1
"cg25888914",2,1,0,0,3
"cg25891212",0,0,1,0,1
"cg25892639",1,3,11,0,15
"cg25892657",0,0,2,0,2
"cg25893857",1,0,0,0,1
"cg25894123",0,1,5,0,6
"cg25896418",0,0,1,0,1
"cg25896603",26,13,0,0,39
"cg25898729",3,0,0,0,3
"cg25899306",0,1,1,0,2
"cg25899582",0,0,0,1,1
"cg25902416",4,1,0,0,5
"cg25902693",2,0,0,0,2
"cg25902810",0,0,1,0,1
"cg25904166",44,8,0,0,52
"cg25904407",1,2,2,0,5
"cg25905040",1,0,1,0,2
"cg25905369",0,0,1,0,1
"cg25905578",39,1,0,0,40
"cg25906151",1,0,0,0,1
"cg25906247",54,2,0,0,56
"cg25907132",0,0,1,0,1
"cg25907334",0,1,1,0,2
"cg25907645",1,1,0,0,2
"cg25910647",1,26,1,0,28
"cg25911374",0,0,1,0,1
"cg25911451",1,0,0,0,1
"cg25911843",1,0,0,0,1
"cg25912870",1,0,0,0,1
"cg25913970",1,0,0,0,1
"cg25914476",2,0,0,0,2
"cg25915563",3,0,0,0,3
"cg25915758",77,27,2,0,106
"cg25917747",2,2,0,0,4
"cg25918347",1,0,3,0,4
"cg25919023",5,15,4,0,24
"cg25919098",0,1,0,0,1
"cg25919948",0,1,1,0,2
"cg25920743",1,0,1,0,2
"cg25921654",8,12,12,0,32
"cg25921736",15,6,0,0,21
"cg25921868",133,65,8,0,206
"cg25922610",0,0,1,0,1
"cg25923527",1,0,0,0,1
"cg25924032",4,0,2,0,6
"cg25924196",0,0,1,0,1
"cg25924884",0,0,2,0,2
"cg25924914",0,0,1,0,1
"cg25927822",44,43,1,0,88
"cg25930068",0,1,0,0,1
"cg25930639",1,0,1,0,2
"cg25932031",0,3,1,0,4
"cg25932066",1,0,0,0,1
"cg25932299",0,0,1,0,1
"cg25932496",1,0,0,0,1
"cg25932949",231,161,9,0,401
"cg25933015",14,2,0,0,16
"cg25933091",1,0,0,0,1
"cg25933333",0,0,21,0,21
"cg25933400",71,3,0,0,74
"cg25934629",0,0,2,0,2
"cg25934917",1,0,0,0,1
"cg25935047",1,0,1,0,2
"cg25935281",0,0,2,0,2
"cg25935897",4,18,11,0,33
"cg25936223",4,0,0,0,4
"cg25937155",0,2,0,0,2
"cg25937322",4,0,1,0,5
"cg25937395",0,2,1,0,3
"cg25937978",0,1,0,0,1
"cg25939015",4,0,0,0,4
"cg25939203",178,7,2,0,187
"cg25940606",0,2,1,0,3
"cg25940730",1,0,0,0,1
"cg25941152",8,0,0,0,8
"cg25941274",1,0,0,0,1
"cg25942318",0,0,3,0,3
"cg25942783",1,0,0,0,1
"cg25943406",0,0,1,0,1
"cg25944537",1,4,2,0,7
"cg25944821",0,2,1,0,3
"cg25945370",0,0,1,0,1
"cg25945841",5,1,0,0,6
"cg25945866",1,0,1,0,2
"cg25947607",0,0,1,0,1
"cg25948667",0,0,9,0,9
"cg25950293",4,0,0,0,4
"cg25950564",2,1,0,0,3
"cg25951073",433,280,4,0,717
"cg25951256",0,0,1,0,1
"cg25952037",2,0,0,0,2
"cg25952449",0,1,0,0,1
"cg25953146",0,3,0,0,3
"cg25953395",1,0,0,0,1
"cg25953789",1,0,0,0,1
"cg25954083",11,1,0,0,12
"cg25955005",0,1,0,0,1
"cg25955816",7,2,0,0,9
"cg25956516",111,55,0,0,166
"cg25958261",0,0,4,0,4
"cg25958703",9,1,1,0,11
"cg25958911",0,0,1,0,1
"cg25960577",1,0,1,0,2
"cg25961773",3,2,0,0,5
"cg25961822",1,1,0,0,2
"cg25962639",19,2,0,0,21
"cg25963309",0,0,5,0,5
"cg25963596",35,13,0,0,48
"cg25963628",60,26,12,0,98
"cg25964040",0,2,5,0,7
"cg25964381",0,1,0,0,1
"cg25964908",0,1,0,0,1
"cg25965576",0,0,1,0,1
"cg25968394",2,0,0,0,2
"cg25969791",1,0,0,0,1
"cg25970099",0,3,0,0,3
"cg25971347",1,0,0,0,1
"cg25973369",2,0,0,0,2
"cg25973708",0,0,1,0,1
"cg25974069",1,0,0,0,1
"cg25974476",1,2,0,0,3
"cg25975818",1,0,0,0,1
"cg25976453",0,0,1,0,1
"cg25977056",85,10,2,0,97
"cg25978832",0,1,0,0,1
"cg25980504",1,0,0,0,1
"cg25982920",1,2,11,0,14
"cg25983552",0,1,0,0,1
"cg25984814",1,0,0,0,1
"cg25985347",0,0,1,0,1
"cg25986200",0,0,1,0,1
"cg25987020",2,2,1,0,5
"cg25987082",27,2,0,0,29
"cg25988408",0,0,3,0,3
"cg25988570",0,0,14,0,14
"cg25989623",1,3,0,0,4
"cg25990363",0,1,6,0,7
"cg25990571",0,0,1,0,1
"cg25991631",0,1,0,0,1
"cg25992387",10,1,2,0,13
"cg25992657",1,0,0,0,1
"cg25993111",0,0,2,0,2
"cg25993905",4,0,0,0,4
"cg25994714",5,0,0,0,5
"cg25995724",1,2,2,0,5
"cg25997023",0,1,0,0,1
"cg25997187",1,0,0,0,1
"cg25997868",1,1,0,0,2
"cg25999309",1,0,0,0,1
"cg26001410",29,109,108,0,246
"cg26002634",0,0,1,0,1
"cg26003296",0,0,1,0,1
"cg26003993",0,1,0,0,1
"cg26005980",0,2,1,0,3
"cg26006254",1,0,0,0,1
"cg26007358",12,30,15,0,57
"cg26008390",0,1,0,0,1
"cg26009970",0,1,0,0,1
"cg26012608",2,0,0,0,2
"cg26013057",370,15,1,0,386
"cg26014047",3,1,0,0,4
"cg26014595",1,0,0,0,1
"cg26015025",0,4,0,0,4
"cg26015501",0,0,1,0,1
"cg26015593",1,0,1,0,2
"cg26017043",6,4,0,0,10
"cg26017136",0,2,1,0,3
"cg26017915",0,0,1,0,1
"cg26018312",1,0,0,0,1
"cg26018322",167,6,0,0,173
"cg26022257",4,5,0,0,9
"cg26024202",53,0,0,0,53
"cg26025071",0,0,1,0,1
"cg26025861",0,0,1,0,1
"cg26027022",0,0,1,0,1
"cg26027780",0,1,0,0,1
"cg26028573",4,0,0,0,4
"cg26029345",1,1,0,0,2
"cg26030585",1,0,0,0,1
"cg26031310",1,0,0,0,1
"cg26031538",1,0,0,0,1
"cg26033457",0,1,2,0,3
"cg26035007",0,3,2,0,5
"cg26035889",0,1,0,0,1
"cg26037136",0,1,0,0,1
"cg26037174",0,0,1,0,1
"cg26037686",3,0,0,0,3
"cg26040075",0,0,1,0,1
"cg26041183",1,0,0,0,1
"cg26041882",179,96,26,0,301
"cg26043521",0,1,0,0,1
"cg26043812",1,1,0,0,2
"cg26044128",584,38,0,0,622
"cg26044524",1,0,0,0,1
"cg26044906",1,0,0,0,1
"cg26045149",0,0,1,0,1
"cg26045205",1,0,0,0,1
"cg26046150",0,0,1,0,1
"cg26047345",38,12,1,0,51
"cg26048182",2,0,0,0,2
"cg26048897",0,0,1,0,1
"cg26051293",3,0,0,0,3
"cg26051552",1,3,3,0,7
"cg26051876",0,0,1,0,1
"cg26051937",1,1,0,0,2
"cg26052266",0,1,0,0,1
"cg26053217",0,0,1,0,1
"cg26053786",6,15,1,0,22
"cg26054975",0,0,1,0,1
"cg26055522",4,2,1,0,7
"cg26057168",6,0,0,0,6
"cg26057682",1,2,2,2,7
"cg26058021",4,0,0,0,4
"cg26059397",0,0,0,1,1
"cg26060655",0,1,0,0,1
"cg26061749",0,0,3,0,3
"cg26062116",0,0,1,0,1
"cg26062172",0,1,0,0,1
"cg26063643",0,3,4,1,8
"cg26063841",0,1,0,0,1
"cg26064232",2,0,0,0,2
"cg26064498",0,3,0,0,3
"cg26065642",3,12,6,0,21
"cg26066758",2,0,0,0,2
"cg26067569",0,0,2,0,2
"cg26068283",0,0,1,0,1
"cg26068292",0,2,1,0,3
"cg26068551",1,0,0,0,1
"cg26070081",76,38,2,0,116
"cg26071033",1,1,1,0,3
"cg26071661",0,0,1,0,1
"cg26071680",0,1,0,0,1
"cg26072468",1,4,0,0,5
"cg26074511",0,2,0,0,2
"cg26074723",5,1,1,0,7
"cg26075208",0,0,1,0,1
"cg26075252",235,156,16,0,407
"cg26075747",2,1,0,0,3
"cg26076203",0,0,1,0,1
"cg26076236",43,21,1,0,65
"cg26076619",0,2,0,0,2
"cg26076969",5,0,0,0,5
"cg26078137",0,0,2,0,2
"cg26078665",1,0,0,0,1
"cg26079299",0,2,0,0,2
"cg26080444",0,1,3,0,4
"cg26080526",1,11,1,0,13
"cg26080826",0,1,0,0,1
"cg26081761",0,0,1,0,1
"cg26082797",0,0,3,0,3
"cg26086226",0,1,0,0,1
"cg26087862",0,0,1,0,1
"cg26088294",3,1,2,0,6
"cg26089220",1,0,0,0,1
"cg26089241",0,1,0,0,1
"cg26089997",3,0,0,0,3
"cg26090253",1,1,2,0,4
"cg26090359",0,0,3,0,3
"cg26090660",0,7,9,0,16
"cg26091007",17,1,2,0,20
"cg26091543",0,0,1,0,1
"cg26091965",0,1,1,0,2
"cg26093106",172,12,0,0,184
"cg26094522",1,0,0,0,1
"cg26095581",2,0,0,0,2
"cg26095694",1,0,0,0,1
"cg26096090",0,0,2,0,2
"cg26096317",4,0,0,0,4
"cg26099730",2,0,0,0,2
"cg26099789",0,0,1,0,1
"cg26099876",0,1,0,0,1
"cg26100428",0,0,0,1,1
"cg26101183",0,0,1,0,1
"cg26101278",330,98,1,0,429
"cg26101890",4,1,0,0,5
"cg26102541",6,0,0,0,6
"cg26103331",180,141,25,0,346
"cg26104756",0,1,0,0,1
"cg26104816",1,0,0,0,1
"cg26105115",5,0,0,0,5
"cg26105558",1,0,0,0,1
"cg26105660",0,0,7,0,7
"cg26105731",269,115,0,0,384
"cg26106149",1,0,0,0,1
"cg26106545",0,1,2,0,3
"cg26106803",0,0,1,0,1
"cg26107028",217,8,0,0,225
"cg26107275",0,1,0,0,1
"cg26107538",13,22,6,0,41
"cg26107850",4,6,3,0,13
"cg26108836",107,51,1,0,159
"cg26108973",25,3,2,0,30
"cg26108999",0,1,0,0,1
"cg26109035",2,0,0,0,2
"cg26110572",1,1,0,0,2
"cg26111152",0,0,4,0,4
"cg26111913",7,1,0,0,8
"cg26112390",1,1,0,0,2
"cg26113925",25,25,7,0,57
"cg26113972",0,10,6,0,16
"cg26114143",0,0,1,0,1
"cg26114378",0,1,0,0,1
"cg26114595",0,0,1,0,1
"cg26114878",0,0,15,0,15
"cg26115416",0,1,0,0,1
"cg26116511",1,0,0,0,1
"cg26116747",1,0,0,0,1
"cg26118678",8,0,0,0,8
"cg26119523",29,23,16,0,68
"cg26119796",1,0,0,0,1
"cg26119894",0,0,1,0,1
"cg26120194",16,7,1,0,24
"cg26120431",2,0,0,0,2
"cg26120748",1,1,0,0,2
"cg26122004",0,0,1,0,1
"cg26123975",0,0,2,0,2
"cg26124517",0,0,1,0,1
"cg26124645",0,1,0,0,1
"cg26125864",0,0,1,0,1
"cg26125935",2,0,0,0,2
"cg26126913",0,1,0,0,1
"cg26127080",0,0,1,0,1
"cg26127187",0,1,0,0,1
"cg26127796",166,11,0,0,177
"cg26128383",0,0,2,0,2
"cg26128404",15,3,0,0,18
"cg26130852",0,0,1,0,1
"cg26131114",18,2,0,0,20
"cg26131246",0,0,1,0,1
"cg26131927",24,8,0,0,32
"cg26132588",0,0,2,0,2
"cg26132994",1,0,0,0,1
"cg26133154",1,0,0,0,1
"cg26133418",0,1,0,0,1
"cg26133835",2,0,0,0,2
"cg26134482",1,2,2,0,5
"cg26134629",86,4,0,0,90
"cg26136415",0,1,0,0,1
"cg26136891",0,0,3,0,3
"cg26137393",1,0,0,0,1
"cg26137453",116,19,2,0,137
"cg26137719",1,0,0,0,1
"cg26138447",34,4,0,0,38
"cg26139131",0,0,2,0,2
"cg26139168",80,208,259,0,547
"cg26142165",0,0,1,0,1
"cg26142236",0,1,0,0,1
"cg26142698",1,0,0,0,1
"cg26143153",3,0,0,0,3
"cg26143263",1,0,0,0,1
"cg26143326",0,1,2,0,3
"cg26144486",145,8,0,0,153
"cg26145190",315,12,0,0,327
"cg26145455",713,248,6,0,967
"cg26146184",0,0,1,0,1
"cg26146316",1,1,0,0,2
"cg26147664",0,1,1,0,2
"cg26148154",0,0,16,0,16
"cg26149184",0,0,1,0,1
"cg26149765",0,0,1,0,1
"cg26150004",1,0,0,0,1
"cg26151492",1,0,0,0,1
"cg26152427",0,3,0,0,3
"cg26152686",0,4,1,0,5
"cg26154546",215,263,555,1,1034
"cg26154730",6,0,0,0,6
"cg26154860",0,0,2,0,2
"cg26155504",232,52,2,0,286
"cg26155673",5,4,1,0,10
"cg26156154",0,1,0,0,1
"cg26156423",0,3,0,0,3
"cg26159068",0,0,1,0,1
"cg26159184",0,0,1,0,1
"cg26159922",1,3,0,0,4
"cg26160150",0,5,2,0,7
"cg26160167",3,1,2,0,6
"cg26160235",0,0,1,0,1
"cg26161104",0,0,1,0,1
"cg26161151",1,0,0,0,1
"cg26161282",0,0,1,0,1
"cg26161365",0,0,1,0,1
"cg26161697",1,0,0,0,1
"cg26162147",0,0,1,0,1
"cg26162330",1,0,0,0,1
"cg26162385",0,1,0,0,1
"cg26162794",0,1,2,0,3
"cg26163108",2,0,0,0,2
"cg26163855",0,1,0,0,1
"cg26165639",0,2,0,0,2
"cg26165993",0,0,1,0,1
"cg26166371",0,0,1,0,1
"cg26166637",0,0,0,1,1
"cg26166818",0,0,1,0,1
"cg26167010",2,8,7,0,17
"cg26167029",0,3,0,0,3
"cg26167424",0,1,3,0,4
"cg26167708",1,0,0,0,1
"cg26167910",1,1,0,0,2
"cg26168436",0,0,1,0,1
"cg26169056",1,0,5,0,6
"cg26170548",1,0,0,0,1
"cg26170569",1,1,0,0,2
"cg26170791",2,5,4,0,11
"cg26171454",6,3,6,0,15
"cg26173435",25,5,6,0,36
"cg26174018",23,6,0,0,29
"cg26174329",163,2,0,0,165
"cg26174656",6,0,0,0,6
"cg26175190",0,1,0,0,1
"cg26175583",46,9,0,0,55
"cg26176469",0,1,1,0,2
"cg26176891",2,2,0,0,4
"cg26177807",1,0,0,0,1
"cg26178311",0,1,0,0,1
"cg26180128",1,0,0,0,1
"cg26181583",0,0,1,0,1
"cg26181840",2,0,0,0,2
"cg26182313",1,0,0,0,1
"cg26182712",0,0,1,0,1
"cg26183697",0,1,0,0,1
"cg26184438",192,211,41,0,444
"cg26185411",6,0,0,0,6
"cg26185920",0,0,1,0,1
"cg26186433",0,1,0,0,1
"cg26186545",0,0,1,0,1
"cg26186732",0,0,2,0,2
"cg26186929",0,0,1,0,1
"cg26188131",0,1,0,0,1
"cg26188679",3,0,0,0,3
"cg26188937",7,3,0,0,10
"cg26189427",23,0,0,0,23
"cg26189883",0,1,0,0,1
"cg26190209",0,1,0,0,1
"cg26190375",26,3,1,0,30
"cg26190966",0,0,1,0,1
"cg26191889",0,1,0,0,1
"cg26192815",1,0,0,0,1
"cg26193555",0,1,0,0,1
"cg26195168",43,1,0,0,44
"cg26196415",0,0,1,0,1
"cg26196813",0,0,1,0,1
"cg26199225",190,491,10,0,691
"cg26200001",0,1,0,0,1
"cg26201869",1,0,0,0,1
"cg26203998",0,0,0,1,1
"cg26204267",1,2,8,0,11
"cg26204845",1,0,0,0,1
"cg26206059",0,0,1,0,1
"cg26206981",0,1,0,0,1
"cg26208619",53,17,0,0,70
"cg26209321",1,0,0,0,1
"cg26209913",0,1,5,0,6
"cg26212966",1,10,0,0,11
"cg26213099",0,0,1,0,1
"cg26213309",0,0,1,0,1
"cg26213571",1,0,0,0,1
"cg26213663",7,1,0,0,8
"cg26218101",0,0,0,1,1
"cg26218229",2,0,0,0,2
"cg26218264",69,4,0,0,73
"cg26218342",0,0,1,0,1
"cg26218805",125,21,3,0,149
"cg26220089",2,9,2,0,13
"cg26220722",8,1,0,0,9
"cg26220759",0,1,0,0,1
"cg26221826",0,0,1,0,1
"cg26222132",2,0,1,0,3
"cg26223417",1,0,0,0,1
"cg26223459",3,0,0,0,3
"cg26224339",0,0,1,0,1
"cg26225171",14,0,0,0,14
"cg26225578",0,2,0,0,2
"cg26225655",1,1,0,0,2
"cg26225726",13,0,0,0,13
"cg26226139",1,0,0,0,1
"cg26228329",0,4,3,0,7
"cg26228476",0,0,1,0,1
"cg26229094",0,0,2,0,2
"cg26229350",0,2,0,0,2
"cg26230481",0,1,0,0,1
"cg26230773",1,0,0,0,1
"cg26231397",146,18,0,0,164
"cg26232678",0,2,0,0,2
"cg26233380",0,0,1,0,1
"cg26234795",1,0,0,0,1
"cg26235791",1,1,0,0,2
"cg26235954",1,0,0,0,1
"cg26236809",4,0,0,0,4
"cg26238180",1,1,0,0,2
"cg26238560",0,0,2,0,2
"cg26238727",0,0,1,0,1
"cg26239881",1,0,0,0,1
"cg26240674",1,0,0,0,1
"cg26241694",0,1,0,0,1
"cg26242334",474,496,38,0,1008
"cg26243109",0,1,0,0,1
"cg26243679",129,352,67,0,548
"cg26244600",0,3,0,0,3
"cg26244849",0,0,1,0,1
"cg26246289",3,0,0,0,3
"cg26246880",1,0,0,0,1
"cg26247795",8,0,2,0,10
"cg26247942",0,0,1,0,1
"cg26248669",0,0,1,0,1
"cg26248728",0,0,1,0,1
"cg26248787",2,0,0,0,2
"cg26248899",2,0,0,0,2
"cg26249038",385,133,1,0,519
"cg26252135",173,49,3,0,225
"cg26252151",3,0,0,0,3
"cg26252271",9,1,0,0,10
"cg26252337",0,1,0,0,1
"cg26252651",1,0,0,0,1
"cg26253523",5,0,0,0,5
"cg26254726",0,1,0,0,1
"cg26254839",4,2,0,0,6
"cg26254916",1,1,0,0,2
"cg26256234",0,0,1,0,1
"cg26256420",9,41,113,0,163
"cg26256539",2,13,0,0,15
"cg26256837",32,18,0,0,50
"cg26257163",1,1,3,0,5
"cg26257219",0,1,1,0,2
"cg26259001",3,2,0,0,5
"cg26259736",1,0,0,0,1
"cg26261359",5,6,1,0,12
"cg26261361",0,1,0,0,1
"cg26261559",5,0,0,0,5
"cg26262539",0,0,0,1,1
"cg26262710",502,180,1,0,683
"cg26262746",0,1,0,0,1
"cg26262747",0,2,5,1,8
"cg26263310",2,3,3,0,8
"cg26263421",0,0,0,1,1
"cg26264311",342,203,4,0,549
"cg26265517",0,1,0,0,1
"cg26266412",1,0,0,0,1
"cg26267272",0,0,2,0,2
"cg26269630",892,28,0,0,920
"cg26270066",0,1,0,0,1
"cg26270116",3,3,0,0,6
"cg26271572",0,1,9,0,10
"cg26271652",0,0,1,0,1
"cg26273127",752,840,28,0,1620
"cg26273176",7,0,0,0,7
"cg26275480",1,2,3,0,6
"cg26277023",2,0,0,0,2
"cg26277102",0,1,4,0,5
"cg26278134",1,0,0,0,1
"cg26278611",0,2,0,0,2
"cg26278666",1,0,0,0,1
"cg26278764",6,15,0,0,21
"cg26279082",1,0,1,0,2
"cg26280463",0,2,2,0,4
"cg26280904",0,1,0,0,1
"cg26281528",0,0,1,0,1
"cg26281921",0,0,1,0,1
"cg26281971",5,0,0,0,5
"cg26282123",3,0,0,0,3
"cg26282384",0,0,1,0,1
"cg26283191",0,0,1,0,1
"cg26283202",0,0,0,1,1
"cg26283801",271,189,49,0,509
"cg26283963",0,1,0,0,1
"cg26284905",81,17,1,0,99
"cg26286700",6,0,0,0,6
"cg26286937",0,0,2,0,2
"cg26287988",0,0,1,1,2
"cg26288703",0,1,0,0,1
"cg26288719",0,1,0,0,1
"cg26288779",4,1,0,0,5
"cg26289712",1,1,0,0,2
"cg26290638",0,1,0,0,1
"cg26291044",1,0,0,0,1
"cg26291292",1,0,0,0,1
"cg26293920",7,0,0,0,7
"cg26294168",0,0,2,0,2
"cg26294691",0,5,0,0,5
"cg26295328",0,0,1,0,1
"cg26296069",422,99,0,0,521
"cg26296285",0,1,0,0,1
"cg26296508",1,0,0,0,1
"cg26296762",0,0,1,0,1
"cg26296769",1,0,0,0,1
"cg26296957",23,4,0,0,27
"cg26297115",0,0,0,1,1
"cg26298583",552,45,0,0,597
"cg26299482",0,0,0,1,1
"cg26299763",38,2,2,0,42
"cg26300672",0,0,1,0,1
"cg26301029",0,0,1,0,1
"cg26302178",0,0,1,0,1
"cg26303213",0,1,0,0,1
"cg26304681",0,1,0,0,1
"cg26305034",4,0,0,0,4
"cg26305827",1,0,0,0,1
"cg26305945",0,1,1,0,2
"cg26306424",15,1,0,0,16
"cg26306683",0,1,0,0,1
"cg26307206",0,3,0,0,3
"cg26307624",33,20,3,0,56
"cg26308506",0,2,0,0,2
"cg26308932",0,5,2,0,7
"cg26309715",1,0,0,0,1
"cg26309854",0,0,4,0,4
"cg26310643",0,1,0,0,1
"cg26311179",0,2,2,0,4
"cg26311781",2,2,0,0,4
"cg26312150",1,0,0,0,1
"cg26312897",19,30,19,0,68
"cg26313233",0,1,1,0,2
"cg26313441",0,0,1,0,1
"cg26314406",0,0,1,0,1
"cg26314806",1,0,0,0,1
"cg26315221",1,0,0,0,1
"cg26316111",1,1,1,0,3
"cg26316511",7,106,497,0,610
"cg26317888",2,1,0,0,3
"cg26320140",0,0,6,0,6
"cg26320148",61,45,5,0,111
"cg26320173",0,0,1,0,1
"cg26320701",6,1,0,0,7
"cg26320890",1,0,0,0,1
"cg26321198",1,0,0,0,1
"cg26321609",0,0,1,0,1
"cg26321766",2,0,0,0,2
"cg26321779",1,0,0,0,1
"cg26322285",0,0,3,0,3
"cg26322995",208,317,48,0,573
"cg26324057",0,0,3,0,3
"cg26328058",2,3,0,0,5
"cg26328180",0,1,1,0,2
"cg26328447",43,6,0,0,49
"cg26329816",0,0,1,0,1
"cg26330321",0,0,1,0,1
"cg26330547",4,0,0,0,4
"cg26331067",0,0,2,0,2
"cg26331226",0,2,0,0,2
"cg26332191",0,1,0,0,1
"cg26333224",0,0,1,0,1
"cg26333317",0,1,0,0,1
"cg26334051",742,75,3,0,820
"cg26334195",245,11,0,0,256
"cg26335377",4,2,0,0,6
"cg26335633",0,1,0,0,1
"cg26336783",1,0,0,0,1
"cg26337259",0,0,1,0,1
"cg26337424",0,2,0,0,2
"cg26338386",2,0,0,0,2
"cg26338627",1,0,0,0,1
"cg26338871",0,0,6,0,6
"cg26339062",0,0,2,0,2
"cg26339180",0,0,1,0,1
"cg26339933",0,1,0,0,1
"cg26340088",5,9,5,2,21
"cg26340994",1,6,0,0,7
"cg26341003",1,0,0,0,1
"cg26341086",96,92,3,0,191
"cg26341440",0,0,1,0,1
"cg26341749",1,0,0,0,1
"cg26342214",15,0,0,0,15
"cg26343080",0,1,0,0,1
"cg26343366",1,0,0,0,1
"cg26344004",0,0,2,0,2
"cg26344794",0,0,1,0,1
"cg26345693",2,2,1,0,5
"cg26345762",2,0,0,0,2
"cg26346442",2,0,0,0,2
"cg26346477",0,1,1,0,2
"cg26347562",24,1,0,0,25
"cg26347606",0,0,0,1,1
"cg26348254",2,0,0,0,2
"cg26348684",0,1,0,0,1
"cg26350768",0,0,1,0,1
"cg26350814",153,83,6,0,242
"cg26351468",0,0,2,0,2
"cg26352073",123,377,52,0,552
"cg26352137",1,0,0,0,1
"cg26352373",2,0,1,0,3
"cg26352847",1,0,0,0,1
"cg26353469",0,1,0,0,1
"cg26353507",1,0,0,0,1
"cg26353844",7,1,0,0,8
"cg26354157",1,0,1,0,2
"cg26354349",150,7,0,0,157
"cg26354596",0,1,1,0,2
"cg26355755",0,2,0,0,2
"cg26356169",0,0,1,0,1
"cg26356450",0,0,1,0,1
"cg26356683",3,2,0,0,5
"cg26357054",9,0,0,0,9
"cg26357872",0,0,1,0,1
"cg26359619",0,0,1,0,1
"cg26360088",128,168,10,0,306
"cg26362605",0,0,1,0,1
"cg26364292",0,1,0,0,1
"cg26365705",4,3,3,0,10
"cg26366417",0,0,1,0,1
"cg26366649",4,0,2,0,6
"cg26366958",2,0,0,0,2
"cg26367107",2,3,0,0,5
"cg26367366",0,0,5,0,5
"cg26368430",2,4,0,0,6
"cg26368518",10,2,0,0,12
"cg26369133",1,0,0,0,1
"cg26369269",0,0,0,1,1
"cg26369614",1,0,0,0,1
"cg26370022",1,0,0,0,1
"cg26370226",2,5,5,1,13
"cg26370285",0,0,2,0,2
"cg26371178",5,2,0,0,7
"cg26371320",0,0,1,0,1
"cg26372202",11,0,0,0,11
"cg26374206",4,0,0,0,4
"cg26374294",0,0,1,0,1
"cg26375473",2,3,5,0,10
"cg26376403",4,1,0,0,5
"cg26376705",0,0,3,0,3
"cg26377653",0,0,2,0,2
"cg26378038",0,0,1,0,1
"cg26378065",1,0,0,0,1
"cg26381111",4,1,0,0,5
"cg26381718",1,0,0,0,1
"cg26382080",582,32,0,0,614
"cg26382696",0,1,1,0,2
"cg26383454",2,0,0,0,2
"cg26383935",15,3,0,0,18
"cg26384382",263,307,3,0,573
"cg26385011",91,3,1,0,95
"cg26387176",8,0,0,0,8
"cg26387458",1,0,0,0,1
"cg26387647",0,1,5,0,6
"cg26388351",4,0,0,0,4
"cg26388568",277,192,16,0,485
"cg26388668",1,0,0,0,1
"cg26389232",2,1,1,0,4
"cg26389500",0,2,1,0,3
"cg26391077",4,1,1,0,6
"cg26392771",2,0,0,0,2
"cg26394771",5,4,0,0,9
"cg26396777",1,0,0,0,1
"cg26397607",1,0,0,0,1
"cg26398244",0,0,1,0,1
"cg26398510",7,0,0,0,7
"cg26398555",2,0,0,0,2
"cg26399035",10,10,1,0,21
"cg26399903",0,1,0,0,1
"cg26401437",3,0,0,0,3
"cg26402374",2,1,0,0,3
"cg26403564",1,0,0,0,1
"cg26405253",0,2,0,0,2
"cg26405829",11,8,1,0,20
"cg26406353",617,88,4,0,709
"cg26406475",30,5,0,0,35
"cg26407034",3,1,0,0,4
"cg26407140",209,128,2,0,339
"cg26407147",0,0,1,0,1
"cg26407212",2,0,0,0,2
"cg26407571",1,4,0,0,5
"cg26408599",0,1,0,0,1
"cg26408641",0,1,1,0,2
"cg26409689",23,1,0,0,24
"cg26410030",0,1,0,0,1
"cg26410121",1,4,0,0,5
"cg26410305",0,1,0,0,1
"cg26411409",0,0,1,0,1
"cg26412379",0,0,1,0,1
"cg26413683",1,1,0,0,2
"cg26414564",1,0,0,0,1
"cg26414841",1,6,0,0,7
"cg26415023",99,12,0,0,111
"cg26415938",0,0,1,0,1
"cg26418502",0,0,1,0,1
"cg26418657",1,0,0,0,1
"cg26418690",0,0,1,0,1
"cg26418733",0,0,2,0,2
"cg26419584",1,0,0,0,1
"cg26420906",6,2,0,0,8
"cg26421361",1,0,0,0,1
"cg26422129",155,65,3,0,223
"cg26422456",2,0,0,0,2
"cg26422674",1,0,0,0,1
"cg26423283",0,2,0,0,2
"cg26423466",1,0,0,0,1
"cg26423693",39,60,6,0,105
"cg26424645",1,0,0,0,1
"cg26424817",17,2,0,0,19
"cg26425409",1,1,1,0,3
"cg26425614",3,0,0,0,3
"cg26425766",1,1,0,0,2
"cg26426395",1,0,0,0,1
"cg26429042",1,0,0,0,1
"cg26430420",0,0,2,0,2
"cg26430588",3,3,5,0,11
"cg26430650",0,3,0,0,3
"cg26431505",0,1,0,0,1
"cg26432476",1,0,0,0,1
"cg26433812",0,0,2,0,2
"cg26434290",10,4,2,0,16
"cg26434322",0,1,0,0,1
"cg26435281",0,0,1,0,1
"cg26435928",1,4,0,1,6
"cg26438516",6,0,0,0,6
"cg26438672",621,43,0,0,664
"cg26441097",307,5,0,0,312
"cg26441408",2,0,0,0,2
"cg26441458",0,1,0,0,1
"cg26442238",4,1,1,0,6
"cg26442516",0,1,0,0,1
"cg26442959",9,9,0,0,18
"cg26444097",0,2,3,0,5
"cg26444741",0,0,4,0,4
"cg26445530",2,3,1,0,6
"cg26445710",1,0,0,0,1
"cg26447146",170,6,0,0,176
"cg26447196",0,0,1,0,1
"cg26449450",0,0,1,0,1
"cg26450259",167,14,1,0,182
"cg26451323",0,3,0,0,3
"cg26452868",1,0,1,0,2
"cg26455685",0,0,1,0,1
"cg26456399",0,1,0,0,1
"cg26456677",0,0,1,0,1
"cg26456810",1,0,0,0,1
"cg26457511",0,1,0,0,1
"cg26458287",0,0,1,0,1
"cg26458505",3,4,1,0,8
"cg26458567",0,1,0,0,1
"cg26459312",0,1,2,0,3
"cg26459756",10,17,7,0,34
"cg26459937",0,0,1,0,1
"cg26461449",5,1,0,0,6
"cg26461666",0,0,1,0,1
"cg26462239",0,0,2,0,2
"cg26462556",0,2,2,0,4
"cg26463500",2,4,0,0,6
"cg26463834",538,69,2,0,609
"cg26464207",3,8,0,0,11
"cg26465581",2,5,0,0,7
"cg26467187",5,0,0,0,5
"cg26468374",0,1,0,0,1
"cg26469019",1,6,5,0,12
"cg26469366",0,0,2,0,2
"cg26469379",0,1,1,0,2
"cg26469782",3,0,0,0,3
"cg26469821",400,1134,52,0,1586
"cg26470127",0,0,0,1,1
"cg26470641",0,1,1,0,2
"cg26470670",1,0,0,0,1
"cg26471040",117,571,37,0,725
"cg26471390",6,3,0,0,9
"cg26471469",0,1,0,0,1
"cg26471527",0,0,1,0,1
"cg26474088",0,1,1,0,2
"cg26474445",0,1,1,0,2
"cg26474814",1,1,0,0,2
"cg26475153",0,1,0,0,1
"cg26475369",1,0,0,0,1
"cg26475819",4,0,0,0,4
"cg26475912",0,0,1,0,1
"cg26475999",0,1,10,0,11
"cg26479436",1,0,0,0,1
"cg26480141",1,2,0,0,3
"cg26483512",3,3,0,0,6
"cg26484361",279,30,1,0,310
"cg26484916",741,132,2,0,875
"cg26485262",1,0,0,0,1
"cg26485937",3,0,0,0,3
"cg26486675",1,1,0,0,2
"cg26486919",136,75,6,0,217
"cg26487629",1,1,0,0,2
"cg26487691",4,6,1,0,11
"cg26488871",0,1,0,0,1
"cg26489638",0,0,1,0,1
"cg26489818",8,0,0,0,8
"cg26489837",26,24,0,0,50
"cg26490626",0,0,3,0,3
"cg26492825",4,0,0,0,4
"cg26493145",11,1,0,0,12
"cg26493184",0,0,1,0,1
"cg26493854",1,0,0,0,1
"cg26494390",0,1,2,0,3
"cg26494782",0,0,0,1,1
"cg26495473",390,139,49,0,578
"cg26495786",0,0,1,0,1
"cg26495837",0,1,2,0,3
"cg26496160",2,3,0,0,5
"cg26496307",5,1,0,0,6
"cg26496521",0,0,2,0,2
"cg26496534",0,2,0,0,2
"cg26496604",5,0,0,0,5
"cg26496795",0,1,6,0,7
"cg26497007",3,1,0,0,4
"cg26497631",0,3,6,0,9
"cg26498132",1,0,1,0,2
"cg26498595",0,4,12,0,16
"cg26499232",0,1,0,0,1
"cg26500754",0,0,1,0,1
"cg26501230",367,105,9,0,481
"cg26502070",0,0,1,0,1
"cg26502456",3,4,5,0,12
"cg26502549",9,0,0,0,9
"cg26503379",0,1,2,0,3
"cg26504668",0,0,1,0,1
"cg26504743",9,0,1,0,10
"cg26505052",158,89,4,0,251
"cg26505663",0,0,1,0,1
"cg26506779",1,0,1,0,2
"cg26507521",2,7,2,0,11
"cg26508012",2,0,0,0,2
"cg26511447",0,0,1,0,1
"cg26511804",0,0,2,0,2
"cg26513077",2,1,0,0,3
"cg26513391",0,0,1,0,1
"cg26513634",0,1,0,0,1
"cg26513930",2,4,1,0,7
"cg26515694",7,6,1,0,14
"cg26516882",1,4,3,0,8
"cg26516935",1,0,0,0,1
"cg26517694",0,0,1,0,1
"cg26517847",1,0,0,0,1
"cg26518269",0,2,2,0,4
"cg26518327",0,1,0,0,1
"cg26518898",1,0,1,0,2
"cg26520399",0,1,2,0,3
"cg26520468",0,0,1,0,1
"cg26521011",0,1,0,0,1
"cg26521730",1,0,0,0,1
"cg26523196",0,4,2,0,6
"cg26524387",1,0,0,0,1
"cg26524477",1,5,0,0,6
"cg26526315",0,0,1,0,1
"cg26527349",0,1,0,0,1
"cg26527913",0,2,0,0,2
"cg26528009",8,1,0,0,9
"cg26528154",1,0,0,0,1
"cg26528255",3,6,0,0,9
"cg26528357",0,2,0,0,2
"cg26529371",1,0,0,0,1
"cg26530200",0,0,0,1,1
"cg26530502",2,2,0,0,4
"cg26530553",0,0,2,0,2
"cg26532430",1,0,0,0,1
"cg26533193",0,0,1,0,1
"cg26533368",1,4,1,0,6
"cg26534262",2,0,1,0,3
"cg26534740",0,0,1,0,1
"cg26535723",0,0,2,0,2
"cg26536002",0,0,3,0,3
"cg26536460",1,1,0,0,2
"cg26538667",0,1,0,0,1
"cg26539823",0,1,0,0,1
"cg26542912",359,177,7,0,543
"cg26544028",2,6,12,0,20
"cg26544559",0,1,0,0,1
"cg26546244",1,9,19,0,29
"cg26546435",1,2,0,0,3
"cg26547097",6,0,1,0,7
"cg26547202",0,1,0,0,1
"cg26549527",0,1,4,0,5
"cg26549650",0,0,3,0,3
"cg26549991",0,2,0,0,2
"cg26551822",1,0,0,0,1
"cg26552859",0,1,1,0,2
"cg26552897",1,1,0,0,2
"cg26554302",0,1,0,0,1
"cg26554930",29,17,0,0,46
"cg26555136",0,1,0,0,1
"cg26556078",1,0,1,0,2
"cg26557090",1,0,0,0,1
"cg26557423",0,1,0,0,1
"cg26557819",11,0,0,0,11
"cg26557896",0,1,0,0,1
"cg26558363",127,181,12,0,320
"cg26558417",0,0,3,0,3
"cg26558420",45,11,0,0,56
"cg26558435",0,1,0,0,1
"cg26559055",1,0,0,0,1
"cg26559681",6,2,0,0,8
"cg26559703",1,0,0,0,1
"cg26560020",1,0,0,0,1
"cg26560068",0,1,15,0,16
"cg26560732",796,119,5,0,920
"cg26561309",0,1,0,0,1
"cg26561570",0,0,1,0,1
"cg26561810",1,0,0,0,1
"cg26563242",2,0,0,0,2
"cg26563889",15,0,1,0,16
"cg26564072",235,26,1,0,262
"cg26564117",0,0,0,1,1
"cg26565113",0,0,1,0,1
"cg26566992",43,6,0,0,49
"cg26567423",0,1,5,0,6
"cg26568782",0,0,3,0,3
"cg26568879",1,0,0,0,1
"cg26569349",0,0,1,0,1
"cg26570040",0,1,0,0,1
"cg26570550",0,0,1,0,1
"cg26571183",1,1,0,0,2
"cg26571188",0,0,1,0,1
"cg26572274",0,0,2,0,2
"cg26573772",0,0,1,0,1
"cg26574448",1,0,1,0,2
"cg26574460",229,113,2,0,344
"cg26576353",0,0,1,0,1
"cg26576836",2,0,0,0,2
"cg26577752",2,0,6,0,8
"cg26578072",1,1,0,0,2
"cg26579491",3,0,0,0,3
"cg26579556",1,0,0,0,1
"cg26579678",0,0,1,0,1
"cg26580026",7,0,0,0,7
"cg26580332",0,0,1,0,1
"cg26580465",0,0,2,0,2
"cg26580527",1,0,0,0,1
"cg26580589",0,5,5,0,10
"cg26581191",214,11,0,0,225
"cg26581886",0,1,2,0,3
"cg26582501",0,0,1,0,1
"cg26582677",0,0,1,0,1
"cg26582829",1,1,0,0,2
"cg26583560",1,3,0,0,4
"cg26583619",90,20,1,0,111
"cg26584538",1,0,0,0,1
"cg26585066",0,1,5,0,6
"cg26585202",0,1,0,0,1
"cg26585326",514,13,0,0,527
"cg26585454",9,0,0,0,9
"cg26586669",1,0,0,0,1
"cg26586739",4,0,0,0,4
"cg26588514",0,2,0,0,2
"cg26589132",39,1,0,0,40
"cg26589607",0,0,1,0,1
"cg26590079",91,9,0,0,100
"cg26592036",0,0,1,1,2
"cg26592560",19,3,0,0,22
"cg26594522",0,2,2,0,4
"cg26595362",0,1,0,0,1
"cg26596182",4,0,0,0,4
"cg26596449",3,0,0,0,3
"cg26597115",15,0,0,0,15
"cg26597305",1,4,0,0,5
"cg26597742",1,0,0,0,1
"cg26598006",1,0,0,0,1
"cg26598388",0,1,0,0,1
"cg26598749",53,565,13,0,631
"cg26599002",2,0,0,0,2
"cg26599901",3,0,0,0,3
"cg26601057",0,3,1,0,4
"cg26601609",8,3,0,0,11
"cg26603264",0,0,1,0,1
"cg26604232",1,1,0,0,2
"cg26604625",19,15,2,0,36
"cg26605774",1,0,0,0,1
"cg26606626",0,1,0,0,1
"cg26606904",1,0,0,0,1
"cg26607002",21,4,0,0,25
"cg26607991",0,0,1,0,1
"cg26610542",290,5,0,0,295
"cg26611070",0,0,1,0,1
"cg26611840",1,0,1,0,2
"cg26611926",22,1,0,0,23
"cg26612129",3,0,0,0,3
"cg26612736",127,205,2,0,334
"cg26613586",1,1,3,0,5
"cg26613768",0,1,0,0,1
"cg26614117",54,31,15,0,100
"cg26614950",0,0,3,0,3
"cg26615778",0,1,0,0,1
"cg26616244",3,0,0,0,3
"cg26618010",0,1,0,0,1
"cg26618874",0,0,1,0,1
"cg26619776",5,0,0,0,5
"cg26620288",19,0,0,0,19
"cg26620682",4,0,0,0,4
"cg26620724",3,0,0,0,3
"cg26621014",1,0,0,0,1
"cg26621918",120,16,3,0,139
"cg26622699",2,0,1,0,3
"cg26624031",0,0,1,0,1
"cg26624489",1,0,0,0,1
"cg26624742",0,0,1,0,1
"cg26625571",0,0,1,0,1
"cg26626287",41,2,0,0,43
"cg26627129",0,2,0,0,2
"cg26627665",0,2,0,0,2
"cg26630424",0,0,1,0,1
"cg26630980",1,0,0,0,1
"cg26631044",6,1,0,0,7
"cg26635467",0,0,1,0,1
"cg26635836",0,1,0,0,1
"cg26636061",3,4,0,0,7
"cg26636244",0,0,3,0,3
"cg26636496",0,0,1,0,1
"cg26636806",0,1,0,0,1
"cg26636869",1,1,0,0,2
"cg26637316",3,0,0,0,3
"cg26637826",310,105,3,0,418
"cg26639376",0,1,0,0,1
"cg26639666",10,2,0,0,12
"cg26639730",0,1,0,0,1
"cg26642409",0,0,2,0,2
"cg26642960",0,1,1,0,2
"cg26645084",0,1,0,0,1
"cg26646767",0,0,3,0,3
"cg26647291",0,2,1,0,3
"cg26649140",2,4,1,0,7
"cg26650401",1,0,0,0,1
"cg26650610",1,0,0,0,1
"cg26650701",212,7,0,0,219
"cg26651879",70,43,2,0,115
"cg26651885",1,0,0,0,1
"cg26652054",6,1,1,0,8
"cg26652666",0,0,1,0,1
"cg26653818",10,4,0,0,14
"cg26653879",0,2,3,0,5
"cg26654328",321,38,0,0,359
"cg26655361",1,1,0,0,2
"cg26655790",0,0,1,0,1
"cg26656175",0,6,5,0,11
"cg26657357",0,1,0,0,1
"cg26658736",2,0,0,0,2
"cg26659404",0,1,0,0,1
"cg26659569",0,0,3,0,3
"cg26659958",11,0,0,0,11
"cg26660541",0,0,1,0,1
"cg26662583",35,6,0,0,41
"cg26663147",52,34,5,0,91
"cg26663609",0,0,1,0,1
"cg26663742",132,21,2,0,155
"cg26664737",172,104,19,0,295
"cg26665679",0,0,4,0,4
"cg26665785",11,0,0,0,11
"cg26666555",1,0,0,0,1
"cg26666703",0,0,1,0,1
"cg26667585",180,126,3,0,309
"cg26668000",1,0,0,0,1
"cg26668075",1,4,0,0,5
"cg26668691",1,0,2,0,3
"cg26668744",0,1,0,0,1
"cg26668895",0,0,1,0,1
"cg26669393",1,0,0,0,1
"cg26670578",0,0,1,0,1
"cg26670636",10,0,0,0,10
"cg26671117",0,0,1,0,1
"cg26671120",3,0,0,0,3
"cg26671754",0,0,1,0,1
"cg26672502",18,8,0,0,26
"cg26673019",2,1,2,0,5
"cg26673550",4,1,0,0,5
"cg26673648",0,0,2,0,2
"cg26674331",0,1,0,0,1
"cg26675289",0,0,1,0,1
"cg26675410",598,42,0,0,640
"cg26675682",1,1,0,0,2
"cg26675905",159,248,10,0,417
"cg26678835",0,0,2,0,2
"cg26680765",90,2,0,0,92
"cg26680875",637,333,5,0,975
"cg26682689",2,1,0,0,3
"cg26683794",172,137,17,0,326
"cg26683917",29,4,0,0,33
"cg26685264",1,0,0,0,1
"cg26685726",0,0,1,0,1
"cg26685975",0,0,0,1,1
"cg26686117",1,2,1,0,4
"cg26686339",0,1,0,0,1
"cg26687723",3,0,0,0,3
"cg26687746",41,36,9,0,86
"cg26689682",0,0,2,0,2
"cg26689710",2,0,0,0,2
"cg26689799",1,3,1,0,5
"cg26690142",2,0,0,0,2
"cg26690332",2,0,0,0,2
"cg26690843",1,0,0,0,1
"cg26691059",0,0,2,0,2
"cg26692590",1,0,0,1,2
"cg26692860",0,0,1,0,1
"cg26693293",0,1,1,0,2
"cg26693329",0,0,2,0,2
"cg26693927",5,0,2,0,7
"cg26694605",1,1,0,0,2
"cg26695210",35,3,7,0,45
"cg26695445",0,0,2,0,2
"cg26696855",2,0,0,0,2
"cg26697116",2,0,0,0,2
"cg26697129",0,0,1,0,1
"cg26697334",9,0,0,0,9
"cg26697517",0,0,1,0,1
"cg26699795",7,0,1,0,8
"cg26699832",0,1,0,0,1
"cg26700100",1,0,1,0,2
"cg26701061",0,0,1,0,1
"cg26701510",1,0,0,0,1
"cg26703557",381,5,0,0,386
"cg26703617",0,1,6,0,7
"cg26705188",0,1,1,0,2
"cg26706519",8,11,1,0,20
"cg26706597",1,0,0,0,1
"cg26706859",0,0,1,0,1
"cg26707149",450,112,0,0,562
"cg26710926",0,1,0,0,1
"cg26711592",0,0,1,0,1
"cg26711819",15,2,0,0,17
"cg26712680",2,1,0,0,3
"cg26713796",0,2,0,0,2
"cg26714305",0,2,0,0,2
"cg26715639",0,1,1,0,2
"cg26716323",0,1,0,0,1
"cg26720007",27,8,1,0,36
"cg26720073",11,0,0,0,11
"cg26720401",6,0,0,0,6
"cg26723437",7,4,0,0,11
"cg26723735",0,2,1,0,3
"cg26724830",0,0,1,0,1
"cg26725430",1,16,5,0,22
"cg26726204",1,0,0,0,1
"cg26728141",699,691,11,0,1401
"cg26728522",13,0,0,0,13
"cg26728825",17,7,0,0,24
"cg26728830",0,0,1,0,1
"cg26728980",28,7,0,0,35
"cg26729026",0,1,0,0,1
"cg26730862",1,0,0,0,1
"cg26731834",154,5,0,0,159
"cg26732920",0,0,1,0,1
"cg26733224",0,1,0,0,1
"cg26735886",32,11,0,0,43
"cg26736736",0,0,4,0,4
"cg26737305",0,1,0,0,1
"cg26738106",0,0,1,0,1
"cg26739199",2,0,0,0,2
"cg26739410",1,0,0,0,1
"cg26740119",1,0,0,0,1
"cg26740621",0,1,1,0,2
"cg26741255",10,0,0,0,10
"cg26741380",1,0,0,0,1
"cg26743317",63,28,2,0,93
"cg26744859",0,2,0,0,2
"cg26744928",0,0,3,0,3
"cg26746482",1,0,0,0,1
"cg26746527",2,0,1,0,3
"cg26746659",27,66,0,0,93
"cg26746674",258,24,1,0,283
"cg26747885",1,0,0,0,1
"cg26748425",0,0,1,0,1
"cg26748583",0,1,0,0,1
"cg26750789",0,0,2,0,2
"cg26751406",0,0,1,0,1
"cg26751550",0,0,0,1,1
"cg26751972",4,1,0,0,5
"cg26752450",1,0,0,0,1
"cg26753039",1,0,0,0,1
"cg26753560",0,2,1,0,3
"cg26755102",658,156,2,0,816
"cg26757221",0,0,1,0,1
"cg26758386",174,42,1,0,217
"cg26758403",1,0,1,0,2
"cg26758857",1,0,0,0,1
"cg26760731",779,485,18,0,1282
"cg26761820",2,0,0,0,2
"cg26762625",0,3,0,0,3
"cg26763328",1,0,0,0,1
"cg26763368",406,35,1,0,442
"cg26764239",0,1,3,0,4
"cg26765260",1,0,0,0,1
"cg26765585",2,1,1,0,4
"cg26765712",1,0,0,0,1
"cg26766702",0,0,1,0,1
"cg26766827",1,1,0,0,2
"cg26766985",0,0,6,0,6
"cg26767614",1,0,0,0,1
"cg26768524",2,9,2,0,13
"cg26768546",1,0,0,0,1
"cg26768765",1,0,1,0,2
"cg26769184",0,1,0,0,1
"cg26770043",1200,77,0,0,1277
"cg26770399",0,1,0,0,1
"cg26770818",1,0,0,0,1
"cg26774205",1,1,1,0,3
"cg26775658",0,0,2,0,2
"cg26776327",4,2,0,0,6
"cg26776944",2,0,3,0,5
"cg26777149",142,3,1,0,146
"cg26777482",0,0,2,0,2
"cg26778521",0,0,1,0,1
"cg26779692",1,0,0,0,1
"cg26780333",0,1,0,0,1
"cg26781224",2,2,0,0,4
"cg26781307",0,1,5,0,6
"cg26781886",1,0,0,0,1
"cg26783086",14,15,12,0,41
"cg26785230",0,0,1,0,1
"cg26785447",1,1,3,0,5
"cg26785464",0,1,0,0,1
"cg26786504",33,45,1,0,79
"cg26786960",0,0,3,0,3
"cg26787510",6,3,0,0,9
"cg26788049",0,0,1,0,1
"cg26788570",0,1,1,0,2
"cg26789068",0,1,0,0,1
"cg26789634",1,0,0,0,1
"cg26790897",2,2,0,0,4
"cg26790922",0,0,2,0,2
"cg26791266",1,0,0,0,1
"cg26792398",0,8,1,0,9
"cg26792541",1,0,0,0,1
"cg26794516",0,0,2,0,2
"cg26795179",175,8,1,0,184
"cg26796483",0,0,1,0,1
"cg26796542",0,1,2,0,3
"cg26796990",0,0,1,0,1
"cg26797811",149,55,6,0,210
"cg26797895",0,1,0,0,1
"cg26798772",0,1,0,0,1
"cg26799339",0,0,1,0,1
"cg26800237",2,0,0,0,2
"cg26800414",1,6,1,0,8
"cg26800832",1,3,0,0,4
"cg26801028",0,1,0,0,1
"cg26802968",229,58,1,0,288
"cg26803313",0,1,0,0,1
"cg26803770",72,9,0,0,81
"cg26804577",15,3,7,1,26
"cg26805302",3,1,0,0,4
"cg26805779",1,1,0,0,2
"cg26806919",30,4,0,0,34
"cg26807340",0,0,1,0,1
"cg26807412",2,3,0,0,5
"cg26809965",2,1,5,0,8
"cg26810281",1,0,0,0,1
"cg26810692",0,0,2,0,2
"cg26810966",0,0,1,0,1
"cg26811079",0,1,0,0,1
"cg26811976",0,2,0,0,2
"cg26812506",0,0,1,0,1
"cg26812760",0,0,1,0,1
"cg26814208",8,0,0,0,8
"cg26815404",0,0,1,0,1
"cg26815748",1,0,0,0,1
"cg26815929",1,1,0,0,2
"cg26816491",3,0,0,0,3
"cg26817564",0,0,2,0,2
"cg26817827",0,1,0,0,1
"cg26820061",29,4,0,0,33
"cg26820209",0,0,1,0,1
"cg26821462",3,2,3,0,8
"cg26821762",1,0,0,0,1
"cg26821823",0,0,1,0,1
"cg26821960",0,1,0,0,1
"cg26822476",1,0,0,0,1
"cg26824826",72,23,2,0,97
"cg26824837",0,0,4,0,4
"cg26825216",0,19,9,4,32
"cg26825573",0,0,1,0,1
"cg26825751",0,3,1,0,4
"cg26827041",0,2,0,0,2
"cg26827413",0,0,1,0,1
"cg26827852",0,3,0,0,3
"cg26827874",792,59,0,0,851
"cg26828742",0,0,1,0,1
"cg26829098",3,1,1,0,5
"cg26831077",3,1,0,0,4
"cg26832154",0,0,2,0,2
"cg26833273",158,75,1,0,234
"cg26834051",3,1,4,0,8
"cg26834083",0,1,0,0,1
"cg26834831",0,0,2,0,2
"cg26835222",648,1029,57,0,1734
"cg26835324",0,2,0,0,2
"cg26835440",196,208,12,0,416
"cg26835520",0,0,3,0,3
"cg26835614",2,0,0,0,2
"cg26835798",1,1,0,0,2
"cg26836175",40,15,3,0,58
"cg26836382",4,0,0,0,4
"cg26836717",238,40,0,0,278
"cg26837182",9,2,1,0,12
"cg26837722",7,0,0,0,7
"cg26837870",2,0,0,0,2
"cg26838253",0,1,0,0,1
"cg26840068",0,2,1,0,3
"cg26840162",0,0,1,0,1
"cg26840672",0,1,0,0,1
"cg26841402",0,2,0,0,2
"cg26842096",1,0,0,0,1
"cg26842700",1,0,0,0,1
"cg26842937",0,0,1,0,1
"cg26844020",0,0,1,0,1
"cg26844954",4,4,2,0,10
"cg26847747",2,0,3,0,5
"cg26848963",33,17,0,0,50
"cg26849404",0,1,1,0,2
"cg26850290",0,0,1,0,1
"cg26850451",2,0,0,0,2
"cg26850754",0,0,0,1,1
"cg26852170",2,0,0,0,2
"cg26852750",44,13,5,0,62
"cg26853442",1,1,0,0,2
"cg26853453",1,0,0,0,1
"cg26854096",0,1,0,0,1
"cg26855148",0,2,18,0,20
"cg26855234",4,0,0,0,4
"cg26855398",0,1,0,0,1
"cg26855680",7,0,0,0,7
"cg26856388",0,1,0,0,1
"cg26856658",0,0,1,0,1
"cg26857894",0,1,1,0,2
"cg26858065",0,0,1,0,1
"cg26858343",26,0,0,0,26
"cg26858707",1,0,0,0,1
"cg26859211",2,5,1,0,8
"cg26859878",3,0,0,0,3
"cg26861960",4,2,0,0,6
"cg26862861",1,0,0,0,1
"cg26863013",0,0,2,0,2
"cg26868306",0,0,1,0,1
"cg26868972",1,5,13,0,19
"cg26870536",0,1,0,0,1
"cg26870756",0,1,0,0,1
"cg26870865",0,1,0,0,1
"cg26871769",2,2,0,0,4
"cg26871803",0,2,5,0,7
"cg26872049",0,1,0,0,1
"cg26873329",1,0,0,0,1
"cg26873413",1,0,0,0,1
"cg26874534",0,0,1,0,1
"cg26874753",0,0,1,0,1
"cg26874764",0,0,1,0,1
"cg26876466",0,0,1,0,1
"cg26876637",1,0,0,0,1
"cg26877374",0,0,2,0,2
"cg26877905",22,1,0,0,23
"cg26879084",1,0,0,0,1
"cg26879538",1,0,0,0,1
"cg26879616",5,0,0,0,5
"cg26879951",3,0,0,0,3
"cg26880412",0,0,8,0,8
"cg26880661",148,33,0,0,181
"cg26880961",0,2,2,0,4
"cg26881287",0,1,0,0,1
"cg26886411",0,4,4,0,8
"cg26888284",1,0,0,0,1
"cg26888813",0,1,0,0,1
"cg26889696",0,0,1,0,1
"cg26889774",58,13,0,0,71
"cg26890708",0,0,0,1,1
"cg26890920",1,0,0,0,1
"cg26891645",0,0,1,0,1
"cg26891867",0,0,1,0,1
"cg26892120",1,0,1,0,2
"cg26893137",2,0,0,0,2
"cg26893623",191,19,0,0,210
"cg26894673",0,0,1,0,1
"cg26896434",7,3,0,0,10
"cg26896717",1,0,9,0,10
"cg26897236",10,0,0,0,10
"cg26899591",78,39,1,0,118
"cg26900509",7,2,10,0,19
"cg26901046",0,0,1,0,1
"cg26902504",7,0,0,0,7
"cg26903403",1,0,0,0,1
"cg26904044",0,0,2,0,2
"cg26904210",5,2,0,0,7
"cg26905010",0,1,0,0,1
"cg26906638",1,0,0,0,1
"cg26907438",0,1,0,0,1
"cg26907446",0,0,2,0,2
"cg26907672",175,374,21,0,570
"cg26907768",0,0,2,0,2
"cg26908098",1,0,0,0,1
"cg26908109",0,0,1,0,1
"cg26908932",0,0,2,0,2
"cg26909016",3,0,0,0,3
"cg26909185",0,1,2,0,3
"cg26909864",0,1,0,0,1
"cg26910476",0,0,1,0,1
"cg26911267",2,0,0,0,2
"cg26911611",1,0,0,0,1
"cg26911986",0,0,1,0,1
"cg26913527",1,1,0,0,2
"cg26914004",0,0,5,0,5
"cg26915754",0,0,1,0,1
"cg26916109",433,25,0,0,458
"cg26916871",0,1,0,0,1
"cg26917068",0,4,0,0,4
"cg26917899",0,0,1,0,1
"cg26917965",24,2,0,0,26
"cg26918645",0,1,0,0,1
"cg26919735",0,0,1,0,1
"cg26919940",1,0,0,0,1
"cg26920100",51,0,0,0,51
"cg26920188",0,0,2,0,2
"cg26923014",27,17,0,0,44
"cg26923095",1,0,0,0,1
"cg26924321",0,0,1,0,1
"cg26924400",12,10,0,0,22
"cg26924822",6,2,0,0,8
"cg26924858",666,46,0,0,712
"cg26925554",328,55,1,0,384
"cg26925578",1,0,0,0,1
"cg26926002",0,1,3,0,4
"cg26927544",0,1,0,0,1
"cg26930364",0,0,1,0,1
"cg26930926",0,0,2,0,2
"cg26931872",1,0,0,0,1
"cg26932054",0,0,1,0,1
"cg26932790",0,2,0,0,2
"cg26932860",214,106,17,0,337
"cg26933068",6,4,0,0,10
"cg26933314",1,0,0,0,1
"cg26933865",49,40,1,0,90
"cg26935333",3,0,0,0,3
"cg26935674",1,1,0,0,2
"cg26935757",0,0,1,0,1
"cg26936219",0,1,0,0,1
"cg26937832",0,0,1,0,1
"cg26937912",2,1,0,0,3
"cg26938474",2,0,4,0,6
"cg26939375",0,0,1,0,1
"cg26940109",1,0,0,0,1
"cg26940535",0,1,1,0,2
"cg26940733",0,1,0,0,1
"cg26940751",1,6,3,0,10
"cg26942185",0,0,0,1,1
"cg26942392",0,0,1,0,1
"cg26943187",0,1,1,0,2
"cg26943683",1,0,0,0,1
"cg26944449",0,0,2,0,2
"cg26945039",3,0,0,0,3
"cg26945361",6,3,0,0,9
"cg26945670",1,2,0,0,3
"cg26945684",0,0,3,1,4
"cg26946223",582,629,15,0,1226
"cg26946331",2,0,0,0,2
"cg26946803",1,3,0,0,4
"cg26947060",1,0,0,0,1
"cg26948155",1,0,3,0,4
"cg26948238",1,0,0,0,1
"cg26948949",0,0,5,0,5
"cg26949022",0,3,2,0,5
"cg26950102",1,0,0,0,1
"cg26950876",1,0,0,0,1
"cg26951520",1,0,0,0,1
"cg26951706",0,0,1,0,1
"cg26951763",0,1,3,0,4
"cg26952136",0,1,0,0,1
"cg26952327",2,21,3,0,26
"cg26953096",342,64,1,0,407
"cg26953140",1,0,0,0,1
"cg26953298",0,0,4,0,4
"cg26953478",0,1,0,0,1
"cg26954231",0,1,0,0,1
"cg26954609",30,73,2,0,105
"cg26955455",3,0,0,0,3
"cg26955859",0,0,1,0,1
"cg26956004",0,0,1,1,2
"cg26957425",1,0,0,0,1
"cg26957677",0,1,0,0,1
"cg26959007",3,0,0,0,3
"cg26959300",0,0,1,0,1
"cg26962295",20,0,0,0,20
"cg26962609",0,0,1,0,1
"cg26963002",1,0,0,0,1
"cg26963196",0,0,1,0,1
"cg26965779",0,0,1,0,1
"cg26965832",0,1,0,0,1
"cg26966056",0,3,0,0,3
"cg26966939",223,370,21,0,614
"cg26967343",5,3,3,0,11
"cg26968087",0,0,3,0,3
"cg26968089",0,0,1,0,1
"cg26968804",334,15,0,0,349
"cg26968849",24,1,4,0,29
"cg26968868",2,3,1,0,6
"cg26969054",0,1,0,0,1
"cg26969061",153,10,0,0,163
"cg26969234",1,0,0,0,1
"cg26970316",54,2,0,0,56
"cg26970795",5,23,1,0,29
"cg26971210",18,3,0,0,21
"cg26972881",18,3,1,0,22
"cg26973164",1,0,0,0,1
"cg26973989",0,0,1,1,2
"cg26974276",0,0,1,0,1
"cg26976888",2,3,0,0,5
"cg26977811",0,0,1,0,1
"cg26978381",0,1,0,0,1
"cg26978776",1,0,0,0,1
"cg26979172",0,0,1,0,1
"cg26980124",1,0,0,0,1
"cg26980530",0,0,1,0,1
"cg26980851",0,0,1,0,1
"cg26980987",1,0,0,0,1
"cg26981099",3,0,0,0,3
"cg26981560",0,0,0,2,2
"cg26981675",0,0,1,0,1
"cg26982030",1,0,0,0,1
"cg26982829",0,1,0,0,1
"cg26983014",0,1,1,0,2
"cg26983326",0,0,1,0,1
"cg26983839",15,5,0,0,20
"cg26983991",0,0,5,0,5
"cg26984263",1,0,0,0,1
"cg26984388",471,25,0,0,496
"cg26986610",0,1,0,0,1
"cg26986620",0,1,0,0,1
"cg26987367",0,0,1,0,1
"cg26988585",0,0,1,0,1
"cg26988984",5,1,0,0,6
"cg26989505",0,0,1,0,1
"cg26990332",4,0,0,0,4
"cg26990517",1,0,0,0,1
"cg26991571",0,1,11,0,12
"cg26992104",1,0,0,0,1
"cg26992387",39,0,0,0,39
"cg26992644",0,1,0,0,1
"cg26994270",1,0,0,0,1
"cg26994528",0,0,2,0,2
"cg26995828",0,2,3,0,5
"cg26996603",0,0,1,0,1
"cg26996779",7,23,0,0,30
"cg26997553",0,2,0,0,2
"cg26997596",1,0,1,0,2
"cg26999574",3,0,0,0,3
"cg27001607",0,1,2,0,3
"cg27002186",0,3,0,0,3
"cg27002325",0,1,0,0,1
"cg27002491",0,0,1,0,1
"cg27002529",0,0,1,0,1
"cg27003309",0,0,2,0,2
"cg27003487",7,1,0,0,8
"cg27004015",0,1,0,0,1
"cg27004640",0,1,0,0,1
"cg27004939",1,4,0,0,5
"cg27006785",1,0,0,0,1
"cg27007110",0,0,1,0,1
"cg27008011",0,0,1,0,1
"cg27008780",0,12,3,0,15
"cg27009114",2,2,0,0,4
"cg27009691",0,2,3,0,5
"cg27011577",0,1,3,0,4
"cg27011898",0,1,0,0,1
"cg27012308",0,0,1,0,1
"cg27012994",0,1,0,0,1
"cg27013382",66,19,2,0,87
"cg27014091",0,0,2,0,2
"cg27015493",5,0,0,0,5
"cg27016107",16,0,0,0,16
"cg27018005",55,5,0,0,60
"cg27019424",1,0,0,0,1
"cg27020119",1,0,1,0,2
"cg27021529",218,8,0,0,226
"cg27022372",2,0,0,0,2
"cg27022663",0,1,0,0,1
"cg27022678",0,0,15,0,15
"cg27023144",0,0,0,1,1
"cg27024083",0,0,1,0,1
"cg27024381",0,1,2,0,3
"cg27024862",1,0,0,0,1
"cg27025320",2,0,0,0,2
"cg27025468",0,0,1,0,1
"cg27025758",0,0,1,0,1
"cg27025777",498,95,3,0,596
"cg27026405",0,1,0,0,1
"cg27026935",1,0,0,0,1
"cg27027935",2,1,0,0,3
"cg27028682",0,0,2,0,2
"cg27029380",0,0,1,0,1
"cg27030541",0,0,10,0,10
"cg27031367",0,0,1,0,1
"cg27032352",0,0,1,0,1
"cg27032456",6,3,4,0,13
"cg27032760",1,0,0,0,1
"cg27033716",0,0,1,0,1
"cg27033805",0,0,2,0,2
"cg27034150",1,0,0,0,1
"cg27034606",0,0,1,0,1
"cg27034935",1,0,0,0,1
"cg27036066",2,0,0,0,2
"cg27036598",0,0,1,0,1
"cg27037357",0,1,0,0,1
"cg27037937",0,1,0,0,1
"cg27039610",0,2,2,0,4
"cg27040525",1,0,0,0,1
"cg27040708",1,0,0,0,1
"cg27040884",3,0,0,0,3
"cg27040912",0,1,0,0,1
"cg27040976",1,2,0,0,3
"cg27041022",0,0,1,0,1
"cg27041463",0,1,0,0,1
"cg27042091",0,0,1,0,1
"cg27044356",0,1,0,0,1
"cg27045377",0,1,0,0,1
"cg27045593",0,1,0,0,1
"cg27046079",27,0,0,0,27
"cg27046434",6,0,0,0,6
"cg27047637",0,0,1,0,1
"cg27047923",0,3,8,0,11
"cg27048126",0,0,1,0,1
"cg27048446",21,0,0,0,21
"cg27048719",2,4,0,0,6
"cg27048949",1,0,0,0,1
"cg27049388",14,0,0,0,14
"cg27051502",0,1,0,0,1
"cg27052900",249,88,4,0,341
"cg27053538",111,169,84,0,364
"cg27053644",0,1,0,0,1
"cg27053866",3,0,0,0,3
"cg27054055",421,109,8,0,538
"cg27056259",0,1,1,0,2
"cg27056425",1,2,2,0,5
"cg27056437",1,0,0,0,1
"cg27056864",0,0,1,0,1
"cg27056926",0,0,2,0,2
"cg27057666",10,7,0,0,17
"cg27058136",1,1,0,0,2
"cg27058356",6,0,0,0,6
"cg27058702",0,0,1,0,1
"cg27059713",34,12,0,0,46
"cg27059886",0,0,1,0,1
"cg27060139",404,12,0,0,416
"cg27061115",1,0,0,0,1
"cg27061576",1,1,0,0,2
"cg27062644",0,0,1,0,1
"cg27062705",0,1,0,0,1
"cg27064266",7,5,0,0,12
"cg27064907",0,0,1,0,1
"cg27065309",3,0,0,0,3
"cg27065701",2,0,0,0,2
"cg27066954",6,2,0,0,8
"cg27067234",0,1,0,0,1
"cg27067612",4,3,3,0,10
"cg27069422",0,1,11,0,12
"cg27069753",0,1,0,0,1
"cg27070434",1,3,0,0,4
"cg27071452",0,1,0,0,1
"cg27071517",1,1,0,0,2
"cg27072212",1,0,3,0,4
"cg27072251",8,0,0,0,8
"cg27072545",25,1,0,0,26
"cg27072848",0,0,1,0,1
"cg27072965",0,1,0,0,1
"cg27073500",0,1,0,0,1
"cg27073512",2,0,0,0,2
"cg27074113",191,466,3,0,660
"cg27075492",21,0,0,0,21
"cg27075641",1,6,1,0,8
"cg27076184",0,0,1,0,1
"cg27077132",11,3,0,0,14
"cg27078188",0,0,1,0,1
"cg27078893",10,2,0,0,12
"cg27079556",12,4,0,0,16
"cg27080348",2,7,1,0,10
"cg27080711",0,0,1,0,1
"cg27081049",0,1,1,0,2
"cg27081670",7,0,0,0,7
"cg27081928",1,1,0,0,2
"cg27082454",2,0,0,0,2
"cg27083273",1,0,1,0,2
"cg27084028",0,0,0,1,1
"cg27085350",1,0,0,0,1
"cg27085972",1,1,0,0,2
"cg27086006",1,0,1,0,2
"cg27087192",1,0,0,0,1
"cg27087614",0,0,1,0,1
"cg27087781",1,0,0,0,1
"cg27089330",1,0,0,0,1
"cg27093347",10,6,0,0,16
"cg27093901",1,0,0,0,1
"cg27093912",0,0,3,0,3
"cg27094305",375,194,6,0,575
"cg27095147",63,416,26,0,505
"cg27095983",191,20,0,0,211
"cg27096032",0,0,1,0,1
"cg27096330",0,0,1,0,1
"cg27096534",0,0,1,0,1
"cg27099486",8,12,0,0,20
"cg27100163",19,5,2,0,26
"cg27100436",0,2,1,0,3
"cg27100876",178,4,0,0,182
"cg27100953",0,0,0,1,1
"cg27102117",0,3,0,0,3
"cg27102737",22,7,1,0,30
"cg27102918",11,3,1,0,15
"cg27104356",2,2,1,0,5
"cg27105890",127,7,0,0,134
"cg27107223",1,0,0,0,1
"cg27107955",0,1,0,0,1
"cg27108577",0,0,2,0,2
"cg27110056",0,0,1,0,1
"cg27110108",17,0,0,0,17
"cg27110177",0,2,1,0,3
"cg27110877",0,1,0,0,1
"cg27111461",195,536,11,0,742
"cg27111529",0,1,1,0,2
"cg27111634",0,0,3,0,3
"cg27112809",0,0,1,0,1
"cg27112963",441,56,1,0,498
"cg27113374",0,1,4,0,5
"cg27113665",1,0,0,0,1
"cg27113843",0,1,0,0,1
"cg27115896",6,3,0,0,9
"cg27117179",21,2,2,0,25
"cg27117243",1,0,0,0,1
"cg27117313",0,0,3,0,3
"cg27118457",288,23,0,0,311
"cg27118949",1,0,0,0,1
"cg27119047",0,1,0,0,1
"cg27119063",27,0,0,0,27
"cg27119329",0,3,1,0,4
"cg27120389",2,2,2,0,6
"cg27121316",89,7,0,0,96
"cg27121342",1,0,0,0,1
"cg27122155",0,0,1,0,1
"cg27122449",3,0,0,0,3
"cg27123614",1,0,0,0,1
"cg27123691",0,1,0,0,1
"cg27124406",0,0,1,0,1
"cg27125505",0,0,2,0,2
"cg27126251",2,0,0,0,2
"cg27127056",1,0,0,0,1
"cg27127877",2,0,0,0,2
"cg27128905",0,0,1,0,1
"cg27129076",332,396,55,0,783
"cg27130484",1,0,0,0,1
"cg27130882",1,3,2,0,6
"cg27132253",1,0,0,0,1
"cg27133230",23,3,0,0,26
"cg27133864",1,0,0,0,1
"cg27134365",0,0,1,0,1
"cg27134812",1,1,1,0,3
"cg27134916",0,0,1,0,1
"cg27136295",4,0,0,0,4
"cg27136723",1,0,0,0,1
"cg27137104",0,3,5,0,8
"cg27137108",2,0,0,0,2
"cg27137512",0,1,0,0,1
"cg27140170",0,1,0,0,1
"cg27141788",3,3,4,0,10
"cg27142147",0,0,1,0,1
"cg27142604",36,0,0,0,36
"cg27143300",1,0,0,0,1
"cg27143872",5,1,0,0,6
"cg27144309",1,0,0,0,1
"cg27145134",2,1,6,0,9
"cg27146486",3,1,3,0,7
"cg27147706",243,258,19,0,520
"cg27147762",0,1,0,0,1
"cg27149073",0,1,0,0,1
"cg27149356",2,0,0,0,2
"cg27149471",0,1,1,0,2
"cg27149924",9,13,6,0,28
"cg27150114",1,0,0,0,1
"cg27150460",8,0,0,0,8
"cg27150486",0,0,1,0,1
"cg27150849",195,79,5,0,279
"cg27151023",0,1,1,0,2
"cg27151361",1,0,4,0,5
"cg27151971",0,0,1,0,1
"cg27152219",0,1,0,0,1
"cg27152299",1,0,0,0,1
"cg27152729",0,0,1,0,1
"cg27154143",0,1,1,0,2
"cg27154432",0,0,4,0,4
"cg27155470",0,0,1,0,1
"cg27155483",0,0,1,0,1
"cg27156048",2,1,0,0,3
"cg27157259",0,0,1,0,1
"cg27157834",1,0,0,0,1
"cg27158084",0,0,1,0,1
"cg27158140",1,0,0,0,1
"cg27158573",0,0,1,0,1
"cg27159032",1,0,0,0,1
"cg27159093",0,1,0,0,1
"cg27159714",0,0,1,0,1
"cg27160348",0,1,0,0,1
"cg27160746",0,1,0,0,1
"cg27161044",0,0,1,0,1
"cg27161360",0,0,2,0,2
"cg27161497",10,2,0,0,12
"cg27162757",1,0,0,0,1
"cg27164041",0,0,1,0,1
"cg27164884",0,0,1,0,1
"cg27165252",1,1,3,0,5
"cg27165617",1,2,2,0,5
"cg27165867",1,1,0,0,2
"cg27167195",86,4,3,0,93
"cg27168045",0,1,0,0,1
"cg27168073",0,0,2,0,2
"cg27168716",0,0,1,0,1
"cg27169263",0,0,1,0,1
"cg27169492",0,1,0,0,1
"cg27169713",0,4,0,0,4
"cg27169916",0,0,2,0,2
"cg27172341",0,0,1,0,1
"cg27173976",15,7,1,0,23
"cg27177006",0,1,0,0,1
"cg27178627",0,0,1,0,1
"cg27179375",1,0,6,0,7
"cg27179498",2,0,0,0,2
"cg27180243",0,1,0,0,1
"cg27180412",0,8,1,0,9
"cg27180636",0,0,0,1,1
"cg27181079",0,1,0,0,1
"cg27182047",2,0,0,0,2
"cg27182335",0,0,1,0,1
"cg27186280",63,11,0,0,74
"cg27188282",0,0,1,0,1
"cg27189784",2,0,0,0,2
"cg27190650",4,3,0,0,7
"cg27190859",119,96,10,0,225
"cg27191320",0,0,0,1,1
"cg27191765",0,1,2,0,3
"cg27192635",0,0,1,0,1
"cg27192892",10,0,0,0,10
"cg27192990",0,2,0,0,2
"cg27193005",2,0,0,0,2
"cg27193733",0,0,1,0,1
"cg27193858",0,0,1,0,1
"cg27193969",0,0,1,0,1
"cg27194047",0,0,1,0,1
"cg27194173",6,0,0,0,6
"cg27194210",0,9,9,0,18
"cg27198071",0,1,1,0,2
"cg27199522",340,237,8,0,585
"cg27200388",0,1,0,0,1
"cg27200406",1,3,5,0,9
"cg27200429",0,0,1,0,1
"cg27201670",0,1,1,0,2
"cg27201767",3,0,0,0,3
"cg27202236",0,0,1,0,1
"cg27204432",3,2,0,0,5
"cg27205159",11,10,2,0,23
"cg27205483",0,0,1,0,1
"cg27205609",0,1,0,0,1
"cg27206965",18,1,1,0,20
"cg27207403",162,3,0,0,165
"cg27207907",0,0,1,0,1
"cg27208012",21,97,615,0,733
"cg27208256",1,0,0,0,1
"cg27208903",0,1,1,0,2
"cg27209972",2,0,0,0,2
"cg27210490",2,0,0,0,2
"cg27210565",1,1,3,0,5
"cg27211158",0,1,0,0,1
"cg27211345",0,2,0,0,2
"cg27212576",1,0,0,0,1
"cg27213222",113,243,39,0,395
"cg27213231",75,6,0,0,81
"cg27214365",0,0,2,0,2
"cg27215131",8,11,6,0,25
"cg27215140",10,2,0,0,12
"cg27216597",222,130,1,0,353
"cg27217159",0,2,0,0,2
"cg27219574",0,0,1,0,1
"cg27220153",0,1,1,0,2
"cg27220312",3,2,2,0,7
"cg27222377",0,0,1,0,1
"cg27222884",0,1,0,0,1
"cg27223534",1,0,0,0,1
"cg27224107",130,15,0,0,145
"cg27224816",0,2,0,0,2
"cg27224855",2,0,1,0,3
"cg27225422",1,0,0,0,1
"cg27225995",9,2,0,0,11
"cg27226360",1,0,0,0,1
"cg27226479",2,2,3,0,7
"cg27226831",0,0,1,0,1
"cg27227314",1,0,0,0,1
"cg27227497",0,4,0,0,4
"cg27229366",0,0,2,0,2
"cg27230370",2,4,2,0,8
"cg27230930",87,73,13,0,173
"cg27231215",0,0,4,1,5
"cg27231717",1,5,0,0,6
"cg27233997",137,189,48,0,374
"cg27234230",78,2,0,0,80
"cg27235193",2,0,0,0,2
"cg27235725",108,8,0,0,116
"cg27236377",0,0,1,0,1
"cg27236404",7,1,2,0,10
"cg27236758",0,1,0,0,1
"cg27236859",15,1,0,0,16
"cg27237272",7,13,14,0,34
"cg27238163",0,0,1,0,1
"cg27238739",1,0,0,0,1
"cg27239828",1,0,1,0,2
"cg27240451",1,0,0,0,1
"cg27241677",322,244,5,0,571
"cg27244434",0,1,0,0,1
"cg27244725",1,0,0,0,1
"cg27244971",0,0,3,0,3
"cg27246439",10,4,7,0,21
"cg27246933",139,13,0,0,152
"cg27247830",0,0,1,0,1
"cg27248041",2,0,0,0,2
"cg27248492",2,2,1,0,5
"cg27249906",1,0,0,0,1
"cg27250180",0,4,0,0,4
"cg27250526",2,0,0,0,2
"cg27251236",107,5,0,0,112
"cg27251720",5,0,0,0,5
"cg27252367",5,0,0,0,5
"cg27254546",4,0,0,0,4
"cg27254661",0,1,0,0,1
"cg27254667",1,0,0,0,1
"cg27255072",0,0,1,0,1
"cg27255522",0,0,1,0,1
"cg27257291",0,0,1,0,1
"cg27257566",0,1,0,0,1
"cg27258614",0,0,1,0,1
"cg27258878",2,1,0,0,3
"cg27259100",0,1,0,0,1
"cg27260942",46,11,0,0,57
"cg27264102",0,0,3,0,3
"cg27264311",1,0,0,0,1
"cg27264892",2,0,0,0,2
"cg27265726",0,0,1,0,1
"cg27265812",0,1,0,0,1
"cg27266491",2,0,0,0,2
"cg27266503",0,0,1,0,1
"cg27267635",0,0,1,0,1
"cg27268412",0,2,0,0,2
"cg27268640",3,0,0,0,3
"cg27269936",0,0,1,0,1
"cg27270326",0,0,1,0,1
"cg27270684",0,0,1,0,1
"cg27272252",0,1,0,1,2
"cg27273692",0,1,0,0,1
"cg27274072",0,2,0,0,2
"cg27274706",0,1,0,0,1
"cg27275133",0,8,7,0,15
"cg27275811",1,1,0,0,2
"cg27276180",82,114,2,0,198
"cg27276487",6,5,1,0,12
"cg27276613",25,0,0,0,25
"cg27277381",0,0,1,0,1
"cg27277439",0,3,0,0,3
"cg27277577",0,0,1,0,1
"cg27278300",5,5,2,0,12
"cg27278526",5,0,0,0,5
"cg27279735",1,0,0,0,1
"cg27279860",1,0,0,0,1
"cg27279897",1,0,0,0,1
"cg27279942",0,2,4,0,6
"cg27280205",0,2,1,0,3
"cg27281036",0,0,1,0,1
"cg27282922",0,1,2,0,3
"cg27285815",0,4,0,1,5
"cg27285836",1,5,1,0,7
"cg27286106",0,0,1,0,1
"cg27287586",1,0,0,0,1
"cg27288021",0,0,3,0,3
"cg27288777",0,0,1,0,1
"cg27289306",81,78,4,0,163
"cg27291181",3,4,0,0,7
"cg27293078",0,0,1,0,1
"cg27293107",0,3,4,0,7
"cg27294979",0,0,1,0,1
"cg27295481",44,0,0,0,44
"cg27298394",1,1,5,0,7
"cg27298662",12,13,4,0,29
"cg27299070",0,0,2,0,2
"cg27300841",0,1,0,0,1
"cg27301256",3,0,0,0,3
"cg27306467",0,2,1,0,3
"cg27306537",1,0,0,0,1
"cg27307184",94,5,0,0,99
"cg27307887",3,0,0,0,3
"cg27307932",0,0,3,0,3
"cg27308432",0,1,0,0,1
"cg27308484",3,1,0,0,4
"cg27308967",751,123,4,0,878
"cg27309514",1,1,0,0,2
"cg27311171",1,0,0,0,1
"cg27311654",0,0,1,0,1
"cg27311947",6,2,1,0,9
"cg27312049",1,0,0,0,1
"cg27312474",1,11,14,0,26
"cg27313325",0,2,0,0,2
"cg27313632",1,0,0,0,1
"cg27314760",1,0,0,0,1
"cg27315695",4,1,0,0,5
"cg27315897",9,0,0,0,9
"cg27316453",16,3,0,0,19
"cg27316459",1,0,0,0,1
"cg27316766",0,0,1,0,1
"cg27317524",331,194,3,0,528
"cg27317541",0,0,1,0,1
"cg27317919",1,0,1,0,2
"cg27321309",1,1,0,0,2
"cg27321560",63,7,0,0,70
"cg27322299",8,3,1,0,12
"cg27322435",0,0,1,0,1
"cg27322975",170,316,114,0,600
"cg27323430",0,1,0,0,1
"cg27324000",2,0,0,0,2
"cg27324075",0,0,2,0,2
"cg27324332",1,0,0,0,1
"cg27325096",7,0,0,0,7
"cg27325544",147,47,0,0,194
"cg27325772",0,4,4,0,8
"cg27326570",6,4,0,0,10
"cg27326689",1,0,0,0,1
"cg27328795",0,0,1,0,1
"cg27328797",3,0,2,1,6
"cg27328930",0,0,1,0,1
"cg27329196",17,7,0,0,24
"cg27330553",0,1,0,0,1
"cg27330627",2,0,0,0,2
"cg27331233",0,1,0,0,1
"cg27331837",0,0,1,0,1
"cg27331863",0,1,0,0,1
"cg27332322",0,1,0,0,1
"cg27333441",0,0,1,0,1
"cg27333977",4,0,0,0,4
"cg27336177",1,0,1,0,2
"cg27336331",1,0,0,0,1
"cg27337021",0,1,0,0,1
"cg27337199",2,0,0,0,2
"cg27337752",1,0,0,0,1
"cg27337832",1,0,2,0,3
"cg27337848",11,0,0,0,11
"cg27337976",0,0,1,0,1
"cg27338319",0,0,0,1,1
"cg27338486",0,4,0,0,4
"cg27338653",49,2,2,0,53
"cg27338935",0,0,1,0,1
"cg27339849",0,0,1,0,1
"cg27340784",1,0,1,1,3
"cg27340958",22,1,0,0,23
"cg27341773",10,1,0,0,11
"cg27343672",0,1,0,0,1
"cg27346808",2,0,0,0,2
"cg27346851",0,0,1,0,1
"cg27346937",1,7,4,0,12
"cg27346986",0,1,4,0,5
"cg27347153",1,0,0,0,1
"cg27347309",0,1,0,0,1
"cg27347523",1,0,0,0,1
"cg27348440",1,0,0,0,1
"cg27348863",1,0,0,0,1
"cg27349302",3,0,0,0,3
"cg27349345",1,1,3,0,5
"cg27349883",3,3,3,0,9
"cg27351675",1,0,0,0,1
"cg27351844",0,1,0,0,1
"cg27352712",0,0,1,0,1
"cg27353054",0,1,2,0,3
"cg27353891",2,1,0,0,3
"cg27355005",0,0,1,0,1
"cg27355551",0,1,0,0,1
"cg27355983",0,1,0,0,1
"cg27357791",1,4,1,0,6
"cg27358585",1,0,0,0,1
"cg27358624",0,1,0,0,1
"cg27359111",0,0,1,0,1
"cg27359264",1,0,0,0,1
"cg27359678",14,4,0,0,18
"cg27360593",270,274,24,0,568
"cg27360849",0,1,0,0,1
"cg27362115",1,0,0,0,1
"cg27363310",0,0,0,1,1
"cg27365103",0,0,1,0,1
"cg27365749",0,0,1,0,1
"cg27365866",2,1,0,0,3
"cg27365886",0,0,1,0,1
"cg27366207",1,2,0,0,3
"cg27366810",1,3,0,0,4
"cg27367349",0,1,0,0,1
"cg27367463",0,0,1,0,1
"cg27367582",0,6,1,0,7
"cg27367722",152,89,27,0,268
"cg27368538",0,0,1,0,1
"cg27368651",0,1,0,0,1
"cg27368961",96,173,99,0,368
"cg27369342",4,0,0,0,4
"cg27369604",0,1,0,0,1
"cg27370188",1,0,0,0,1
"cg27371385",5,11,1,0,17
"cg27371734",0,1,0,0,1
"cg27371741",0,0,1,0,1
"cg27372181",239,361,17,0,617
"cg27372994",0,2,0,0,2
"cg27373063",21,1,0,0,22
"cg27374029",0,0,3,0,3
"cg27374314",68,1,0,0,69
"cg27375056",2,1,1,0,4
"cg27375561",14,21,1,0,36
"cg27375966",1,0,0,0,1
"cg27377352",0,2,0,0,2
"cg27377438",4,2,0,0,6
"cg27377517",0,6,5,0,11
"cg27378066",94,480,23,0,597
"cg27378537",1,0,0,0,1
"cg27378869",1,0,0,0,1
"cg27378890",0,1,0,0,1
"cg27379407",0,1,5,0,6
"cg27379603",1,0,10,0,11
"cg27380412",0,0,1,0,1
"cg27382860",0,0,1,0,1
"cg27383020",20,9,1,0,30
"cg27383537",2,0,0,0,2
"cg27383744",35,1,0,0,36
"cg27385734",0,0,1,0,1
"cg27387238",0,3,0,0,3
"cg27387573",0,1,0,0,1
"cg27387705",0,1,0,0,1
"cg27388297",1,0,0,0,1
"cg27388462",0,2,1,0,3
"cg27388587",0,0,1,0,1
"cg27388763",0,0,1,0,1
"cg27389562",1,1,2,0,4
"cg27390255",0,1,2,0,3
"cg27390685",22,27,17,0,66
"cg27390890",646,63,2,0,711
"cg27391650",3,9,5,0,17
"cg27391816",0,0,1,0,1
"cg27392815",172,13,1,0,186
"cg27393162",1,1,0,0,2
"cg27393573",740,106,4,0,850
"cg27394206",0,0,1,0,1
"cg27394814",892,272,3,0,1167
"cg27394845",0,1,0,0,1
"cg27395922",1,0,0,0,1
"cg27397673",4,0,0,0,4
"cg27399297",256,361,51,0,668
"cg27402043",6,0,0,0,6
"cg27402302",6,0,0,0,6
"cg27402713",0,0,4,0,4
"cg27403023",111,85,8,0,204
"cg27407289",0,0,1,0,1
"cg27409478",1,1,7,0,9
"cg27410383",0,0,1,0,1
"cg27411746",0,0,1,0,1
"cg27412613",0,0,1,0,1
"cg27416312",0,0,1,0,1
"cg27419419",181,78,5,0,264
"cg27419551",0,1,0,0,1
"cg27420361",2,4,0,0,6
"cg27420365",1,0,0,0,1
"cg27421994",0,0,1,0,1
"cg27422114",0,1,3,0,4
"cg27422512",1,0,0,0,1
"cg27422721",73,27,15,0,115
"cg27424013",0,4,5,0,9
"cg27424206",145,158,37,0,340
"cg27425250",3,0,0,0,3
"cg27425532",3,0,0,0,3
"cg27426146",0,2,0,0,2
"cg27426882",0,1,0,0,1
"cg27428101",6,7,0,0,13
"cg27428578",0,0,3,0,3
"cg27429663",22,1,0,0,23
"cg27429917",2,0,0,0,2
"cg27429968",8,4,1,0,13
"cg27430235",0,0,1,0,1
"cg27430686",0,1,0,0,1
"cg27431237",687,601,5,0,1293
"cg27431417",8,1,0,0,9
"cg27432331",1,0,0,0,1
"cg27432638",0,0,1,0,1
"cg27432883",96,498,206,0,800
"cg27433856",1,5,0,0,6
"cg27434249",2,2,1,0,5
"cg27434863",0,2,0,0,2
"cg27435943",1,0,1,0,2
"cg27437849",14,0,0,0,14
"cg27438754",0,1,0,0,1
"cg27438854",2,1,6,0,9
"cg27439042",0,0,1,0,1
"cg27439444",77,2,0,0,79
"cg27439480",0,0,2,0,2
"cg27441045",0,1,0,0,1
"cg27442140",3,0,0,0,3
"cg27442432",0,2,0,0,2
"cg27443071",3,0,0,1,4
"cg27443100",31,15,0,0,46
"cg27443694",1,0,0,0,1
"cg27444290",0,0,1,0,1
"cg27444644",0,0,1,0,1
"cg27444683",8,2,0,0,10
"cg27445709",4,0,0,0,4
"cg27446302",0,0,2,0,2
"cg27446832",0,1,0,0,1
"cg27447083",107,3,0,0,110
"cg27447666",4,19,11,0,34
"cg27447696",1,0,0,0,1
"cg27447746",1,0,0,0,1
"cg27448496",100,15,2,0,117
"cg27451114",206,125,1,0,332
"cg27451450",0,0,2,0,2
"cg27451843",1,0,0,0,1
"cg27452035",0,0,1,0,1
"cg27452732",0,0,1,0,1
"cg27455437",47,0,0,0,47
"cg27456137",0,0,1,0,1
"cg27456449",184,55,6,0,245
"cg27458177",0,1,0,0,1
"cg27460915",1,1,2,0,4
"cg27461703",0,0,1,0,1
"cg27461830",1,1,0,0,2
"cg27462867",0,2,0,0,2
"cg27463152",0,0,1,0,1
"cg27463896",0,0,1,0,1
"cg27464062",0,0,1,0,1
"cg27464378",2,0,0,0,2
"cg27464733",1,0,0,0,1
"cg27465275",0,0,1,0,1
"cg27465994",1,0,0,0,1
"cg27468872",0,0,1,0,1
"cg27470263",1,3,0,0,4
"cg27470901",1,0,0,0,1
"cg27471216",6,3,1,0,10
"cg27473606",4,0,0,0,4
"cg27473997",0,3,10,0,13
"cg27474091",0,0,1,0,1
"cg27475729",0,1,0,0,1
"cg27476881",3,0,0,0,3
"cg27477025",0,0,1,0,1
"cg27477067",1,0,0,0,1
"cg27478848",0,3,1,0,4
"cg27479850",0,1,0,0,1
"cg27480148",1,0,0,0,1
"cg27480700",1,1,0,0,2
"cg27482438",1,0,2,0,3
"cg27484456",1,0,1,0,2
"cg27484610",0,5,0,0,5
"cg27485269",16,5,0,0,21
"cg27486617",3,0,0,0,3
"cg27487435",0,1,0,0,1
"cg27487551",0,2,0,0,2
"cg27487745",1,0,0,0,1
"cg27488740",1,0,0,0,1
"cg27491370",1,0,0,0,1
"cg27491609",0,1,0,0,1
"cg27492220",1,0,0,0,1
"cg27492451",0,1,0,0,1
"cg27493417",1,0,0,0,1
"cg27494597",3,0,0,0,3
"cg27494858",1,2,0,0,3
"cg27495054",4,0,0,0,4
"cg27495444",0,0,1,0,1
"cg27495654",1,0,0,0,1
"cg27495669",1,0,0,0,1
"cg27495680",2,1,0,0,3
"cg27496179",416,28,3,0,447
"cg27496267",0,0,1,0,1
"cg27496615",0,3,0,0,3
"cg27497255",0,1,2,0,3
"cg27497699",1,0,0,1,2
"cg27498961",0,1,0,0,1
"cg27499813",0,0,3,0,3
"cg27500067",75,22,0,0,97
"cg27500234",0,0,1,0,1
"cg27500542",22,1,0,0,23
"cg27500784",0,1,1,0,2
"cg27500997",5,1,0,0,6
"cg27501782",2,0,0,0,2
"cg27501997",1,0,0,0,1
"cg27502298",0,0,1,0,1
"cg27503213",0,0,1,0,1
"cg27503469",2,5,2,0,9
"cg27505178",0,4,0,0,4
"cg27505348",14,14,1,0,29
"cg27506139",303,7,0,0,310
"cg27506886",1,0,0,0,1
"cg27507055",0,0,1,0,1
"cg27507725",17,1,0,0,18
"cg27508408",0,1,0,0,1
"cg27508812",0,0,1,0,1
"cg27509125",3,0,3,0,6
"cg27510512",86,5,0,0,91
"cg27511528",0,0,3,0,3
"cg27511990",1,0,0,0,1
"cg27512510",0,0,2,0,2
"cg27513195",0,0,1,0,1
"cg27513365",1,1,0,0,2
"cg27514530",8,1,0,0,9
"cg27515201",0,1,0,0,1
"cg27515255",0,0,2,0,2
"cg27515548",12,21,0,0,33
"cg27515846",0,0,1,0,1
"cg27517281",0,0,6,0,6
"cg27518051",0,0,1,0,1
"cg27518314",1,0,0,0,1
"cg27518602",1,8,14,0,23
"cg27519014",0,0,1,0,1
"cg27519910",50,4,0,0,54
"cg27520474",0,1,0,0,1
"cg27520716",0,1,1,0,2
"cg27521160",2,3,0,0,5
"cg27521356",0,1,0,0,1
"cg27522470",76,36,1,0,113
"cg27523141",0,1,0,0,1
"cg27524003",1,0,0,0,1
"cg27524192",1,0,16,0,17
"cg27524697",3,0,0,0,3
"cg27525155",0,0,1,0,1
"cg27525189",9,10,3,0,22
"cg27525397",1,0,0,0,1
"cg27525438",0,0,6,0,6
"cg27525446",1,0,0,0,1
"cg27525520",9,0,0,0,9
"cg27525614",3,2,7,0,12
"cg27526429",222,306,7,0,535
"cg27526465",0,0,2,0,2
"cg27526660",1,0,9,0,10
"cg27527338",1,0,0,0,1
"cg27527479",2,1,1,0,4
"cg27527783",0,0,1,0,1
"cg27528541",0,1,1,0,2
"cg27529998",0,1,0,0,1
"cg27530298",170,163,244,0,577
"cg27530443",0,1,1,0,2
"cg27532244",0,0,1,0,1
"cg27532560",0,0,22,0,22
"cg27532758",1,2,1,0,4
"cg27533080",5,1,0,0,6
"cg27533454",1,0,0,0,1
"cg27533859",2,0,0,0,2
"cg27534158",0,0,1,0,1
"cg27534225",5,0,0,0,5
"cg27534567",0,0,2,0,2
"cg27536084",0,1,0,0,1
"cg27536122",0,0,1,0,1
"cg27537046",0,0,1,0,1
"cg27537048",5,0,0,0,5
"cg27537306",1,0,2,0,3
"cg27538091",0,0,1,0,1
"cg27538694",9,2,0,0,11
"cg27538751",574,29,0,0,603
"cg27539472",268,22,1,0,291
"cg27539833",0,0,1,0,1
"cg27539858",0,0,2,0,2
"cg27540506",1,0,0,0,1
"cg27540743",0,0,1,0,1
"cg27540865",0,0,1,0,1
"cg27541226",0,0,1,0,1
"cg27541892",0,0,1,0,1
"cg27542017",0,0,1,0,1
"cg27542314",7,5,3,0,15
"cg27543064",1,1,0,0,2
"cg27544294",1,0,0,0,1
"cg27545300",0,0,1,0,1
"cg27546718",0,0,1,0,1
"cg27546834",2,0,2,0,4
"cg27546911",0,0,1,0,1
"cg27546949",0,1,0,0,1
"cg27547375",0,1,0,0,1
"cg27547967",133,92,3,0,228
"cg27548142",0,0,1,0,1
"cg27548270",0,1,1,0,2
"cg27548735",5,4,0,0,9
"cg27549075",0,0,2,0,2
"cg27549476",0,1,1,0,2
"cg27549874",1,5,0,0,6
"cg27550060",1,0,0,0,1
"cg27550441",0,0,1,0,1
"cg27550663",1,0,0,0,1
"cg27551618",0,0,3,0,3
"cg27552113",0,1,0,0,1
"cg27552127",2,0,0,0,2
"cg27552461",24,18,1,0,43
"cg27553564",654,725,30,0,1409
"cg27553638",0,1,2,0,3
"cg27554342",0,2,6,0,8
"cg27555063",2,0,0,0,2
"cg27555099",0,0,1,0,1
"cg27558133",3,0,1,0,4
"cg27558666",7,1,0,0,8
"cg27559372",23,3,0,0,26
"cg27559706",0,1,2,0,3
"cg27560229",1,2,0,0,3
"cg27560291",0,1,0,0,1
"cg27560831",0,0,1,0,1
"cg27561335",1,0,1,0,2
"cg27561365",0,0,2,0,2
"cg27562682",0,1,0,0,1
"cg27563032",1,0,2,0,3
"cg27564040",1,0,0,0,1
"cg27564108",5,3,0,0,8
"cg27564386",0,0,1,0,1
"cg27564445",122,116,52,0,290
"cg27565550",1,0,0,0,1
"cg27565971",0,1,0,0,1
"cg27566812",0,0,3,0,3
"cg27567076",0,0,1,0,1
"cg27567167",0,0,1,0,1
"cg27567838",1,0,0,0,1
"cg27568307",0,1,0,0,1
"cg27568983",32,0,1,0,33
"cg27569097",0,0,1,0,1
"cg27569328",1,0,1,0,2
"cg27571079",0,1,0,0,1
"cg27571351",0,1,0,0,1
"cg27571411",1,0,0,0,1
"cg27571676",0,1,0,0,1
"cg27571763",0,0,2,0,2
"cg27572029",0,0,2,0,2
"cg27572269",73,90,2,0,165
"cg27572826",0,1,0,0,1
"cg27573471",1,1,1,0,3
"cg27573720",0,1,1,0,2
"cg27573735",0,1,0,0,1
"cg27574287",2,0,0,0,2
"cg27574817",0,2,0,0,2
"cg27576136",338,89,0,0,427
"cg27576218",2,0,0,0,2
"cg27577149",0,2,4,0,6
"cg27577234",0,0,1,0,1
"cg27577554",0,1,0,0,1
"cg27577760",0,2,2,0,4
"cg27578129",0,0,1,0,1
"cg27578391",2,0,0,0,2
"cg27578974",5,5,8,0,18
"cg27580261",0,1,0,0,1
"cg27581118",0,2,6,0,8
"cg27581191",2,0,0,0,2
"cg27581473",3,1,0,0,4
"cg27581762",0,1,0,0,1
"cg27581767",32,1,0,0,33
"cg27582435",0,1,0,0,1
"cg27584409",11,4,2,0,17
"cg27587141",0,0,1,0,1
"cg27587223",1,4,11,0,16
"cg27587310",1,0,0,0,1
"cg27588657",2,1,0,0,3
"cg27591407",1,1,0,0,2
"cg27592126",1,0,0,0,1
"cg27592424",2,0,0,0,2
"cg27592568",0,1,1,0,2
"cg27594854",1,0,0,0,1
"cg27597118",1,5,6,0,12
"cg27599129",0,3,0,0,3
"cg27599461",12,2,0,0,14
"cg27599792",1,2,0,0,3
"cg27600072",1,0,0,0,1
"cg27600084",2,4,4,0,10
"cg27601182",0,0,1,0,1
"cg27603055",6,6,1,0,13
"cg27604249",0,0,1,0,1
"cg27604841",2,0,0,0,2
"cg27604944",5,0,0,0,5
"cg27605379",0,0,1,0,1
"cg27605603",18,0,0,0,18
"cg27607520",1,0,0,0,1
"cg27607838",0,0,3,0,3
"cg27607885",1,0,0,0,1
"cg27608095",9,0,0,0,9
"cg27609223",2,0,0,0,2
"cg27610521",66,5,1,0,72
"cg27611177",1,0,0,0,1
"cg27612695",0,0,1,0,1
"cg27613473",4,2,3,0,9
"cg27614704",0,1,0,0,1
"cg27614959",0,1,0,0,1
"cg27615293",0,0,2,0,2
"cg27615368",0,0,1,0,1
"cg27615378",0,2,4,0,6
"cg27616595",4,0,0,0,4
"cg27619489",0,1,8,0,9
"cg27619828",0,1,0,0,1
"cg27620135",112,12,14,0,138
"cg27621471",1,0,0,0,1
"cg27622515",1,0,1,0,2
"cg27622876",1,4,0,0,5
"cg27622900",166,262,15,0,443
"cg27623867",7,1,0,0,8
"cg27623884",0,0,0,1,1
"cg27623914",0,0,1,0,1
"cg27624074",0,0,2,0,2
"cg27624721",0,2,0,0,2
"cg27624769",2,0,0,0,2
"cg27624826",0,1,0,0,1
"cg27625887",4,1,0,0,5
"cg27626023",4,0,0,0,4
"cg27626185",0,0,1,0,1
"cg27626240",0,1,0,0,1
"cg27628003",1,0,0,0,1
"cg27628881",0,0,4,0,4
"cg27629311",134,2,0,0,136
"cg27629513",0,1,0,0,1
"cg27629934",10,25,0,0,35
"cg27630202",1,0,0,0,1
"cg27632594",3,2,1,0,6
"cg27632740",1,0,0,0,1
"cg27633139",0,3,1,0,4
"cg27633306",1,0,0,0,1
"cg27633463",0,1,0,0,1
"cg27633688",1,0,0,0,1
"cg27633877",1,0,0,0,1
"cg27635845",0,1,0,0,1
"cg27637326",0,1,0,0,1
"cg27637597",0,1,1,0,2
"cg27638415",133,727,20,0,880
"cg27638509",11,1,0,0,12
"cg27639046",0,0,1,0,1
"cg27639583",2,3,5,0,10
"cg27640712",4,0,0,0,4
"cg27641104",1,0,0,0,1
"cg27641419",1,0,0,0,1
"cg27642166",0,1,2,0,3
"cg27642328",0,1,0,0,1
"cg27642588",1,0,0,0,1
"cg27642618",0,1,0,0,1
"cg27642883",3,5,0,0,8
"cg27643182",1,0,0,0,1
"cg27643205",0,1,1,0,2
"cg27644672",0,0,1,0,1
"cg27646221",0,1,0,0,1
"cg27646791",0,0,5,0,5
"cg27647395",0,2,0,0,2
"cg27647681",1,0,0,0,1
"cg27649620",0,1,7,0,8
"cg27649653",8,0,0,0,8
"cg27649838",0,1,0,0,1
"cg27650123",1,0,0,0,1
"cg27650198",256,334,79,0,669
"cg27655206",0,1,0,0,1
"cg27656070",23,5,0,0,28
"cg27657226",0,1,0,0,1
"cg27657233",1,0,0,0,1
"cg27657326",1,1,0,0,2
"cg27657378",1,0,0,0,1
"cg27658460",6,0,0,0,6
"cg27660038",0,1,1,0,2
"cg27660087",0,1,1,0,2
"cg27660192",0,0,1,0,1
"cg27660372",33,3,0,0,36
"cg27660825",6,18,6,0,30
"cg27661571",0,1,1,0,2
"cg27662204",2,0,0,0,2
"cg27662284",3,0,4,0,7
"cg27663733",0,0,1,0,1
"cg27663936",1,0,0,0,1
"cg27665449",11,5,0,0,16
"cg27665769",0,1,0,0,1
"ch.10.116792202R",200,398,20,0,618
"ch.10.118622095R",195,30,0,0,225
"ch.10.1432102R",3,0,0,0,3
"ch.10.1748644R",1,0,0,0,1
"ch.10.1922786R",47,3,0,0,50
"ch.10.19309820R",45,0,0,0,45
"ch.10.25135601F",0,0,0,1,1
"ch.10.33343282R",16,7,0,0,23
"ch.10.47925130F",29,0,0,0,29
"ch.10.503573F",0,0,1,0,1
"ch.10.58771679R",2,0,0,0,2
"ch.10.72059822F",64,34,8,0,106
"ch.10.819441R",0,1,0,0,1
"ch.10.82591910R",31,2,0,0,33
"ch.10.89216809R",0,0,2,0,2
"ch.10.983355R",21,15,0,0,36
"ch.11.1000958R",26,3,0,0,29
"ch.11.1767550R",3,0,0,0,3
"ch.11.1854895F",0,0,0,1,1
"ch.1.119678825R",7,0,0,0,7
"ch.11.2015773F",1,1,0,0,2
"ch.1.1224902R",2,0,0,0,2
"ch.11.23898073R",1,0,0,0,1
"ch.11.24196551F",140,40,2,1,183
"ch.1.1337107R",34,1,0,0,35
"ch.11.41625527F",404,35,1,1,441
"ch.11.50107818R",2,0,0,0,2
"ch.11.535384R",0,1,0,0,1
"ch.1.155481287R",1,0,2,0,3
"ch.1.156669547F",50,27,0,0,77
"ch.1.169608016R",97,26,6,0,129
"ch.1.1854513R",83,76,0,0,159
"ch.1.189720737F",1,0,0,0,1
"ch.11.91717525F",3,1,0,0,4
"ch.1.194336624R",22,2,0,0,24
"ch.11.96117892F",0,0,0,1,1
"ch.1.196707923R",11,10,1,0,22
"ch.11.97728705F",2,0,0,0,2
"ch.12.1048628F",2,0,0,0,2
"ch.1.212120986F",1,0,0,0,1
"ch.1.213506027F",444,623,17,0,1084
"ch.12.1531371R",25,16,1,0,42
"ch.12.1667570F",8,0,0,0,8
"ch.12.1700408R",1,0,0,0,1
"ch.12.1878964R",335,27,1,0,363
"ch.12.1940337R",0,1,0,0,1
"ch.12.19627204F",68,41,11,0,120
"ch.12.2010372R",28,2,0,0,30
"ch.1.222606050F",228,49,10,0,287
"ch.12.2586863F",1,1,0,0,2
"ch.1.231737468F",42,34,8,0,84
"ch.12.49617489F",0,1,0,0,1
"ch.12.602695F",43,2,0,0,45
"ch.12.71498574F",2,1,0,0,3
"ch.12.71928151F",284,94,6,0,384
"ch.12.78471492F",80,511,77,1,669
"ch.1.2799699R",0,0,2,0,2
"ch.1.2840814R",0,0,2,0,2
"ch.12.902977F",8,1,0,0,9
"ch.1.2988748F",1,0,0,0,1
"ch.1.3036304F",1,0,0,0,1
"ch.1.3042365R",2,1,0,0,3
"ch.1.3188690F",0,0,1,0,1
"ch.1.3319557F",4,0,0,0,4
"ch.13.33087556F",0,0,0,1,1
"ch.13.37580793F",1,0,0,0,1
"ch.13.557053R",2,0,0,0,2
"ch.13.67938274F",3,0,0,0,3
"ch.13.76200044F",1,0,0,0,1
"ch.13.81021746R",51,2,0,0,53
"ch.13.84760847R",1,0,0,0,1
"ch.13.914371F",3,0,0,0,3
"ch.13.929593F",1,0,0,0,1
"ch.14.1292508R",162,286,81,0,529
"ch.14.1558261F",4,0,0,0,4
"ch.14.25380211R",1,0,0,0,1
"ch.14.50884044F",299,276,16,0,591
"ch.14.71046539R",3,1,0,0,4
"ch.14.769589F",0,0,0,1,1
"ch.1.4784808F",10,5,0,0,15
"ch.14.809850R",1,0,0,0,1
"ch.1.4812384F",1,1,0,0,2
"ch.14.85271447F",282,158,5,0,445
"ch.15.1310449F",1,2,0,0,3
"ch.15.1428207F",0,0,0,1,1
"ch.15.1458091R",21,5,0,0,26
"ch.15.1538350R",1,0,0,0,1
"ch.15.1582754F",25,5,1,0,31
"ch.15.23362502F",0,0,1,1,2
"ch.15.23774000R",222,6,0,0,228
"ch.1.55181547R",1,0,0,0,1
"ch.15.92028544F",11,9,1,0,21
"ch.16.1684049R",0,1,0,0,1
"ch.16.2068605F",1,2,0,0,3
"ch.16.440507F",0,0,1,0,1
"ch.16.612655R",0,0,7,0,7
"ch.16.64814095R",22,3,0,0,25
"ch.16.700349R",0,0,1,0,1
"ch.16.723901F",0,0,0,1,1
"ch.16.726563F",12,1,0,0,13
"ch.1.69277142F",3,1,0,0,4
"ch.17.12041704R",1,0,0,0,1
"ch.17.1406968R",30,4,0,0,34
"ch.17.1542746R",0,1,0,0,1
"ch.17.16529697F",0,0,1,0,1
"ch.17.41650897R",0,0,1,0,1
"ch.17.51385210R",29,17,0,0,46
"ch.17.69555766F",0,0,0,1,1
"ch.17.72133F",0,0,0,1,1
"ch.17.75301806F",0,0,0,1,1
"ch.17.828578F",0,0,1,0,1
"ch.18.164884R",23,588,179,0,790
"ch.18.773216R",15,712,77,0,804
"ch.1.90405031F",33,2,0,0,35
"ch.19.1024848R",57,9,1,0,67
"ch.19.1200890F",0,1,0,0,1
"ch.19.1906967F",1,1,0,0,2
"ch.19.21460585R",1,0,0,0,1
"ch.19.23069863R",0,1,0,0,1
"ch.19.23069876R",1,1,0,0,2
"ch.1.928723R",1,0,0,0,1
"ch.1.933676F",0,0,0,1,1
"ch.19.476355R",245,68,7,0,320
"ch.1.95642235F",2,1,0,0,3
"ch.19.57789982R",0,2,0,0,2
"ch.19.777701F",1,1,0,0,2
"ch.19.848927R",80,8,0,0,88
"ch.19.931598F",1,2,0,0,3
"ch.19.931611R",1,1,0,0,2
"ch.19.931767R",1,1,1,0,3
"ch.20.18164830R",30,2,0,0,32
"ch.20.4648144R",2,1,0,0,3
"ch.20.661824R",0,1,2,0,3
"ch.20.804375F",7,3,1,0,11
"ch.2.107376196R",1,0,0,0,1
"ch.2.111833563R",0,1,0,0,1
"ch.21.17404405R",85,26,9,0,120
"ch.21.20879148R",1,0,0,0,1
"ch.2.1222844F",1,0,0,0,1
"ch.21.39853023F",1,0,0,0,1
"ch.2.147017622F",2,3,0,0,5
"ch.2.147354665R",3,0,0,0,3
"ch.2.154234353F",105,15,0,0,120
"ch.2.16021824F",0,0,0,1,1
"ch.2.164393752R",62,19,0,0,81
"ch.2.165639268R",1,0,0,0,1
"ch.2.171877258F",1,0,0,0,1
"ch.2.172936443R",1,0,0,0,1
"ch.2.184722192F",1,0,0,0,1
"ch.2.195648145F",240,596,16,1,853
"ch.22.107403R",0,0,1,0,1
"ch.22.11243R",0,0,0,1,1
"ch.22.137888R",1,0,0,0,1
"ch.22.22597277R",7,4,0,0,11
"ch.22.23746271F",0,0,0,1,1
"ch.2.224872986R",44,185,296,0,525
"ch.2.233013039R",0,2,0,0,2
"ch.22.40657F",5,1,0,0,6
"ch.2.2578847R",82,39,3,0,124
"ch.2.2660550F",35,1,0,0,36
"ch.2.3048096R",4,0,0,0,4
"ch.2.39602547R",3,0,0,0,3
"ch.2.4116732R",16,2,1,0,19
"ch.2.41439940R",259,228,2,0,489
"ch.2.42814419F",0,1,0,0,1
"ch.2.47844995F",0,0,0,1,1
"ch.2.4817431F",0,0,0,1,1
"ch.2.4917873F",16,1,0,0,17
"ch.2.5127303R",1,0,0,0,1
"ch.2.52173332R",33,4,0,0,37
"ch.2.747167F",1,0,0,0,1
"ch.3.1121988R",18,5,2,0,25
"ch.3.1132748F",1,0,0,0,1
"ch.3.12948F",4,5,0,0,9
"ch.3.16805090R",1,0,0,0,1
"ch.3.2096467F",0,1,1,0,2
"ch.3.21287957F",19,5,0,0,24
"ch.3.2372016F",1,0,0,0,1
"ch.3.2523607F",0,0,0,1,1
"ch.3.2567129F",0,1,0,0,1
"ch.3.3021133F",89,20,0,0,109
"ch.3.30723819R",12,4,0,0,16
"ch.3.3414728R",1,0,0,0,1
"ch.3.3451078R",12,2,0,0,14
"ch.3.37390721F",1,0,0,0,1
"ch.3.39794766R",72,9,0,0,81
"ch.3.43988081F",1,0,0,0,1
"ch.3.6830780F",1,0,0,0,1
"ch.3.69086826R",1,0,0,0,1
"ch.3.76029796F",0,0,1,0,1
"ch.4.109582151R",52,6,0,0,58
"ch.4.11419765R",29,77,177,0,283
"ch.4.11486815R",47,10,0,0,57
"ch.4.116818530F",1,0,0,0,1
"ch.4.1172045R",2,1,0,0,3
"ch.4.12333187F",19,0,0,1,20
"ch.4.129498779F",0,0,0,1,1
"ch.4.133369014F",1,0,0,0,1
"ch.4.134247547R",2,0,0,0,2
"ch.4.135914028F",0,0,1,0,1
"ch.4.137381452F",4,1,0,0,5
"ch.4.138875280R",349,280,1,0,630
"ch.4.150648562F",10,3,0,0,13
"ch.4.15214191R",4,1,0,0,5
"ch.4.152491566R",205,143,35,0,383
"ch.4.165600943F",26,2,0,0,28
"ch.4.166959540F",124,4,0,0,128
"ch.4.179430345R",10,4,1,0,15
"ch.4.2693560R",13,0,0,0,13
"ch.4.27623090R",2,2,4,0,8
"ch.4.2824859R",23,2,0,0,25
"ch.4.38162960R",1,0,0,0,1
"ch.4.43738163F",24,2,0,0,26
"ch.4.586044R",19,1,0,0,20
"ch.4.60646130F",6,0,0,0,6
"ch.4.66343068R",95,9,0,0,104
"ch.4.69646068F",13,1,0,0,14
"ch.4.72691992R",6,2,1,0,9
"ch.4.77087090F",6,0,0,0,6
"ch.4.83718914R",1,1,1,0,3
"ch.4.91104449F",91,10,1,0,102
"ch.5.1607347F",1,0,0,0,1
"ch.5.1870083F",0,0,0,1,1
"ch.5.18883716R",1,0,0,0,1
"ch.5.1906008F",24,5,0,0,29
"ch.5.2306836F",335,210,43,0,588
"ch.5.23338039R",1,1,0,0,2
"ch.5.2389603F",1,1,0,0,2
"ch.5.2925238F",289,3,0,0,292
"ch.5.3165702R",1,0,0,0,1
"ch.5.3276032R",1,1,0,0,2
"ch.5.634030F",65,34,5,0,104
"ch.5.79606571R",64,4,0,0,68
"ch.5.838196R",1,0,0,0,1
"ch.5.83977780R",1,1,0,0,2
"ch.5.87268879R",4,0,0,0,4
"ch.5.942599F",1,1,0,0,2
"ch.6.113116714F",16,6,0,0,22
"ch.6.1196585F",160,44,1,0,205
"ch.6.134515066F",337,34,1,0,372
"ch.6.1385876F",0,0,2,0,2
"ch.6.139021151R",0,1,0,0,1
"ch.6.140551910F",135,57,4,0,196
"ch.6.141403409F",157,13,0,0,170
"ch.6.1433484F",19,1,1,0,21
"ch.6.149019574R",18,19,0,0,37
"ch.6.164862012R",1,0,0,0,1
"ch.6.169233872R",64,3,0,0,67
"ch.6.169577133F",57,9,1,0,67
"ch.6.1795380F",2,2,1,0,5
"ch.6.197209F",0,0,0,1,1
"ch.6.57776846F",0,0,0,1,1
"ch.6.66830957F",296,33,2,0,331
"ch.6.77755434R",18,6,1,0,25
"ch.6.79339589F",54,13,0,0,67
"ch.6.79620741R",7,16,1,0,24
"ch.6.92327598R",6,4,0,0,10
"ch.6.949970F",4,18,10,0,32
"ch.6.99782119R",8,0,0,0,8
"ch.7.102590751F",0,1,0,0,1
"ch.7.118285014F",125,64,13,1,203
"ch.7.122480889F",13,4,0,0,17
"ch.7.1415213R",3,0,0,0,3
"ch.7.1427355R",0,0,1,0,1
"ch.7.149841082R",0,0,2,0,2
"ch.7.1578169F",2,0,0,0,2
"ch.7.1637031F",1,0,0,0,1
"ch.7.1710114F",92,46,2,0,140
"ch.7.2194789F",0,0,0,1,1
"ch.7.2660938R",13,0,0,0,13
"ch.7.2986028F",1,1,2,1,5
"ch.7.3038064F",12,0,0,0,12
"ch.7.318201F",103,72,13,0,188
"ch.7.41324965F",5,0,0,0,5
"ch.7.453032F",13,0,0,0,13
"ch.7.50621990F",0,0,1,0,1
"ch.7.51839018F",0,0,0,1,1
"ch.7.67314344F",0,1,0,0,1
"ch.7.88141140F",9,5,1,0,15
"ch.8.123133581F",1,0,0,0,1
"ch.8.140049216F",1,1,0,0,2
"ch.8.153539F",1,1,0,0,2
"ch.8.1681415R",1,0,0,0,1
"ch.8.1742370R",4,0,0,0,4
"ch.8.1852347F",5,0,0,0,5
"ch.8.1993893R",0,1,1,0,2
"ch.8.2353618R",0,1,0,0,1
"ch.8.24555156R",478,121,0,0,599
"ch.8.31295111R",2,1,0,0,3
"ch.8.31582255R",79,23,1,0,103
"ch.8.40958873F",14,21,8,0,43
"ch.8.419879R",0,2,0,0,2
"ch.8.49582343R",39,2,0,0,41
"ch.8.65240324F",0,0,0,1,1
"ch.8.90327161R",8,6,0,0,14
"ch.8.9051069F",6,0,0,0,6
"ch.8.969355F",0,0,0,1,1
"ch.9.106992904R",0,1,0,0,1
"ch.9.1152820R",8,0,0,0,8
"ch.9.116081R",5,2,0,0,7
"ch.9.120878154R",141,13,1,0,155
"ch.9.1352789F",52,21,3,0,76
"ch.9.138894394R",9,0,0,0,9
"ch.9.1449587R",5,2,0,0,7
"ch.9.1539394R",2,0,0,0,2
"ch.9.1872490F",29,2,1,0,32
"ch.9.2042397F",8,0,0,0,8
"ch.9.22352682F",108,9,0,0,117
"ch.9.30972590F",10,5,0,0,15
"ch.9.691424R",0,0,1,0,1
"ch.9.750163F",7,0,0,0,7
"ch.9.7776528F",1,2,0,0,3
"ch.9.79515146F",2,0,0,0,2
"ch.9.96055087R",0,1,0,0,1
"ch.9.98936572R",6,16,1,0,23
"ch.9.98937537R",9,4,0,0,13
"ch.9.98957343R",1,1,0,0,2
"ch.9.98989607R",0,0,1,0,1
"ch.X.107997386R",24,1,0,0,25
"ch.X.108232304R",4,0,0,0,4
"ch.X.108369489R",25,2,0,0,27
"ch.X.1126021R",45,21,2,0,68
"ch.X.1158406R",2,2,1,0,5
"ch.X.116673198R",175,45,5,0,225
"ch.X.13187220R",1,0,0,0,1
"ch.X.1388524F",5,1,0,0,6
"ch.X.1485219F",0,0,0,1,1
"ch.X.1851142F",3,1,0,1,5
"ch.X.772253F",1,0,1,0,2
"ch.X.79027977R",28,23,10,0,61
"ch.X.88220680F",17,18,9,0,44
"ch.X.89171221R",255,333,18,0,606
"ch.X.90223523F",4,0,0,0,4
"ch.X.92148261F",12,1,0,0,13
"ch.X.93511680F",3,0,0,0,3
"ch.X.967194F",4,0,0,0,4
"ch.X.97737721F",5,1,0,0,6
